"survey_id","nb_species","aesthe_survey_pres","aesthe_survey_abund","aesthe_SR_survey","nb_sp_pos_survey","nb_sp_neg_survey","prop_biom_aesth","prop_abund_aesth"
"1003278",38,2834.62498779447,2984.39188646285,2491.71993967651,16,22,1,1
"1003281",26,2348.3955330821,2250.29239314686,2305.75108410937,16,10,1,1
"1003282",26,2582.84382574892,2595.2179253324,2305.75108410937,16,10,1,1
"1003283",32,2460.43063861493,2154.34839337096,2405.71569249515,19,13,1,1
"1003284",34,2718.18188826785,2772.81567528987,2435.71163614839,20,14,1,1
"1003285",35,2743.3359848579,2925.72263508677,2450.1860183293,17,18,1,1
"1003286",41,2744.97789181164,2820.32614757251,2530.72175773865,20,21,1,1
"1003287",34,2567.22400641361,2552.4506467328,2435.71163614839,18,16,1,1
"1003288",46,3040.40736146516,3196.17243909475,2590.94954296761,25,21,1,1
"1003289",32,2547.41485879721,2522.36053220385,2405.71569249515,17,15,1,1
"1003291",30,2677.64758321902,3093.16840575927,2374.18906024059,20,10,1,1
"1003292",31,2639.41341153123,2681.62417831756,2390.15469389133,16,15,1,1
"1003629",28,2675.94667683624,2836.40510897246,2340.94327947849,17,11,1,1
"1003630",19,2280.70103687933,2504.407326021,2162.56636020013,12,7,1,1
"1003631",24,2462.410105185,2759.0000898729,2268.33468283819,16,8,1,1
"1003632",15,2183.26897049085,2430.13983474754,2060.56118614118,11,4,1,1
"1003633",31,2411.3331940583,2252.6220787043,2390.15469389133,19,12,1,1
"1003635",26,2481.96394900766,1946.77896321616,2305.75108410937,16,10,1,1
"1003636",36,2432.49383145624,2101.97566635588,2464.33502634194,20,16,1,1
"1003637",30,2541.68509720342,3001.97282623397,2374.18906024059,18,12,1,1
"1003638",28,2452.26260165818,2955.6154826318,2340.94327947849,16,12,1,1
"1003639",30,2501.42868359301,3184.01351976187,2374.18906024059,15,15,1,1
"1003640",30,2582.6435756512,2853.10223611499,2374.18906024059,15,15,1,1
"1003641",28,2445.9438538225,2523.81713762691,2340.94327947849,18,10,1,1
"1003642",38,2701.04012002581,3376.22752408988,2491.71993967651,23,15,1,1
"1003643",34,2514.65199497595,2779.36903663531,2435.71163614839,20,14,1,1
"1003644",25,2355.35119102894,2811.37234869177,2287.34065519221,14,11,1,1
"1003645",25,2480.40059982553,2991.2853068603,2287.34065519221,11,14,1,1
"1003646",38,2583.44275929517,2107.97557487449,2491.71993967651,16,22,1,1
"1003647",34,2359.26935431048,2268.89345096935,2435.71163614839,18,16,1,1
"1003648",32,2461.70219496895,2587.71697971017,2405.71569249515,16,16,1,1
"1003649",36,2533.32020116572,2201.5151280387,2464.33502634194,17,19,1,1
"1003650",33,2598.28841553419,3035.50793504226,2420.89448855093,18,15,1,1
"1003651",36,2287.12217380148,2561.19264107095,2464.33502634194,18,18,1,1
"1003652",30,2564.81528603248,2869.29705964897,2374.18906024059,15,15,1,1
"1003653",29,2456.29951076635,2698.46062562841,2357.79423966008,18,11,1,1
"1003654",26,2619.06051317686,3078.60473441954,2305.75108410937,15,11,1,1
"1003655",21,2312.81312920448,2762.81112925503,2207.26116887512,12,9,1,1
"1003656",19,2219.95727478835,2519.62376161876,2162.56636020013,12,7,1,1
"1003657",17,2225.89681257859,2329.0906238308,2113.95669457394,9,8,1,1
"1003658",36,2661.18799603537,2584.15165771925,2464.33502634194,20,16,1,1
"1003659",21,2601.4612787235,2694.09778738462,2207.26116887512,11,10,1,1
"1003660",24,2604.08930968113,2818.59651042252,2268.33468283819,13,11,1,1
"1003661",29,2667.47897551775,2956.15804318955,2357.79423966008,19,10,1,1
"1003662",29,2732.79012799436,3236.90685114484,2357.79423966008,17,12,1,1
"1003663",26,2670.03554075029,3610.58168728232,2305.75108410937,13,13,1,1
"1003664",27,2595.3425584543,3063.86663400402,2323.60649590586,15,12,1,1
"1003665",29,2537.95551978844,2562.20594230632,2357.79423966008,15,14,1,1
"1003666",34,2592.88070751434,3159.38396416053,2435.71163614839,18,16,1,1
"1003667",35,2809.69410757413,2665.99217828797,2450.1860183293,18,17,1,1
"1003668",30,2641.57232972808,2971.9160089732,2374.18906024059,18,12,1,1
"1003669",34,2855.92895277798,3198.11363479512,2435.71163614839,21,13,1,1
"1003670",35,2548.30479362694,2945.16091301482,2450.1860183293,16,19,1,1
"1003671",28,2636.39402594309,3124.73559573044,2340.94327947849,13,15,1,1
"1003672",31,2588.87312930491,3307.36040854503,2390.15469389133,16,15,1,1
"1003673",33,2687.8487434851,2773.01955471159,2420.89448855093,22,11,1,1
"1003674",30,2492.02543977643,2384.87053761138,2374.18906024059,19,11,1,1
"1003675",43,2776.19279041084,2606.89521438805,2555.47878346624,21,22,1,1
"1003676",30,2634.91753364299,2874.95012597945,2374.18906024059,20,10,1,1
"1003677",36,2586.64954443629,2878.37798666013,2464.33502634194,19,17,1,1
"1003678",34,2484.69075512989,2493.80948766383,2435.71163614839,19,15,1,1
"1003679",42,2780.82741913713,2823.03244795318,2543.21752514954,22,20,1,1
"1003680",39,2604.11114199515,2340.01067574602,2504.98447234734,19,20,1,1
"1003681",22,2438.28347379958,2554.11990008462,2228.3491786518,14,8,1,1
"1003682",31,2797.47383699023,2748.71410894213,2390.15469389133,15,16,1,1
"1003683",34,2633.45083639672,2795.93285802019,2435.71163614839,18,16,1,1
"1003684",42,2736.76117114097,3294.84449866469,2543.21752514954,21,21,1,1
"1003685",34,2817.05288094377,3178.56706676079,2435.71163614839,18,16,1,1
"1003686",33,2777.05759604396,3492.70882517643,2420.89448855093,14,19,1,1
"1003687",28,2548.93297717956,2590.1125254231,2340.94327947849,18,10,1,1
"1003688",39,2846.24637602979,2701.46628669724,2504.98447234734,24,15,1,1
"1003689",30,2527.42524841231,2577.71927651981,2374.18906024059,17,13,1,1
"1003690",33,2730.40402086587,3096.37116700411,2420.89448855093,18,15,1,1
"1003691",22,2421.32715584385,2732.92371372079,2228.3491786518,14,8,1,1
"1003692",22,2299.381811228,2191.51154861036,2228.3491786518,11,11,1,1
"1003693",25,2193.53471855977,2312.31802108134,2287.34065519221,14,11,1,1
"1003694",28,2481.07868958504,3089.17982238488,2340.94327947849,14,14,1,1
"1003695",28,2658.35733098227,3522.49994807355,2340.94327947849,14,14,1,1
"1003696",29,2606.43727260059,2621.51775743916,2357.79423966008,14,15,1,1
"1003697",31,2337.08270283158,2808.00142496071,2390.15469389133,16,15,1,1
"1003698",33,2679.08070832042,3041.69698533319,2420.89448855093,17,16,1,1
"1003699",27,2413.60555809978,2943.00018553904,2323.60649590586,15,12,1,1
"1003777",49,2831.15167862134,2525.83430430582,2624.62502504328,24,25,1,1
"1003778",51,2630.45235189563,2486.72087480234,2646.17454577679,25,26,1,1
"1003779",31,2735.23511969869,3201.97586540114,2390.15469389133,16,15,1,1
"1003780",21,2366.81256531015,2244.82442306057,2207.26116887512,12,9,1,1
"1003781",24,2423.9309805067,2474.08806777097,2268.33468283819,13,11,1,1
"1003782",36,2875.97397009262,2735.73496747775,2464.33502634194,22,14,1,1
"1003783",29,2730.63173973315,3041.17271842269,2357.79423966008,17,12,1,1
"1003784",44,2664.74611657279,2673.76730120415,2567.51523707907,21,23,1,1
"1003785",41,2629.61449942577,2596.98960832487,2530.72175773865,21,20,1,1
"1003786",43,2763.73899615362,2518.10970612542,2555.47878346624,23,20,1,1
"1003787",31,2658.45220989632,2538.7502304787,2390.15469389133,19,12,1,1
"1003793",44,2826.34643286085,2301.3948078341,2567.51523707907,19,25,1,1
"20003005",40,3324.0995538429,4184.17855518414,2517.98110851286,16,24,1,1
"20003006",47,3332.27209125963,3691.30914753345,2602.36394728806,18,29,1,1
"20003008",46,3298.22359630829,3677.5240457422,2590.94954296761,13,33,1,1
"20003009",48,3664.88636577173,4008.40530799907,2613.58673801098,17,31,1,1
"20003010",49,3251.52629745817,3761.2082324707,2624.62502504328,19,30,1,1
"20003011",42,3065.10445921299,3030.12149972547,2543.21752514954,14,28,1,1
"20003012",53,3646.71144962608,3591.09549792939,2667.061866114,21,32,1,1
"20003013",48,3427.61052281821,3701.85973289358,2613.58673801098,21,27,1,1
"20003014",60,3413.00366780833,4025.46700219081,2735.5526890818,21,39,1,1
"20003015",45,3456.28799862037,3594.23519493683,2579.33597919865,19,26,1,1
"20003016",50,3623.63217364735,4061.85606477481,2635.48551585152,17,33,1,1
"20003017",38,3005.31784256612,2845.35868936547,2491.71993967651,12,26,1,1
"2000937",21,2028.85815665794,2207.04386604925,2207.26116887512,1,20,1,1
"2000938",23,2359.26253393524,2483.44270832883,2248.68783741607,4,19,1,1
"2000939",18,2139.86997126847,2264.43329003973,2138.79896507223,3,15,1,1
"2000947",38,2346.66364428562,2145.20598428211,2491.71993967651,14,24,1,1
"2000948",25,2081.1584255493,2033.81363590011,2287.34065519221,11,14,1,1
"2000949",39,2616.27965689284,2579.52130109257,2504.98447234734,22,17,1,1
"2001049",24,2331.37903661541,2724.44041009517,2268.33468283819,9,15,1,1
"2001050",24,2202.71254275316,2354.36927372019,2268.33468283819,12,12,1,1
"2001051",36,2559.21651367958,2472.87922678919,2464.33502634194,14,22,1,1
"2001052",28,2444.37262272357,2749.40153111754,2340.94327947849,10,18,1,1
"2001053",38,2614.29584986469,3033.63571059269,2491.71993967651,17,21,1,1
"2001054",25,2453.05550431888,2488.27506339417,2287.34065519221,10,15,1,1
"2001055",36,2599.82982212037,3172.83687154313,2464.33502634194,17,19,1,1
"2001056",31,2611.85504796245,3010.87224056355,2390.15469389133,11,20,1,1
"2001057",26,2428.99583344858,2632.98115351677,2305.75108410937,15,11,1,1
"2001133",27,2390.13354035093,2694.15563540333,2323.60649590586,13,14,1,1
"2001134",36,2688.17874671735,3073.6389225399,2464.33502634194,23,13,1,1
"2001135",23,2409.02248030612,2694.91634553904,2248.68783741607,13,10,1,1
"2001136",35,2599.27790147041,3174.32696906036,2450.1860183293,17,18,1,1
"2001137",17,2197.46342312394,2344.39433127436,2113.95669457394,6,11,1,1
"2001138",35,2311.6749691139,2761.96864194141,2450.1860183293,18,17,1,1
"2001139",27,2328.88817684734,2672.60416517765,2323.60649590586,11,16,1,1
"2001140",24,2323.14859847725,2601.60857709969,2268.33468283819,12,12,1,1
"2001398",55,2635.80152890205,2445.4090459887,2687.33120998132,33,22,1,1
"2001400",43,2208.48351473994,1863.22198465381,2555.47878346624,20,23,1,1
"2001401",41,2406.18855778121,1921.09144014047,2530.72175773865,29,12,1,1
"2001402",10,1705.13139868383,1426.30243600771,1896.67490607898,4,6,1,1
"2001589",14,2241.28487582665,2393.57631295788,2031.70713799962,9,5,1,1
"2001803",18,2054.02051203019,1736.35158804729,2138.79896507223,8,10,1,1
"2001804",10,1729.82938505451,1547.40079137624,1896.67490607898,4,6,1,1
"2001805",15,2134.10778471234,2067.27722762256,2060.56118614118,11,4,1,1
"2001806",12,2015.7212409227,1949.00234255272,1968.69006049611,8,4,1,1
"2001807",25,2393.69734404422,2493.55233130627,2287.34065519221,17,8,1,1
"2001808",13,2034.35904618216,1970.27803608688,2001.16379457045,9,4,1,1
"2001809",15,2039.46466562871,1952.64516274742,2060.56118614118,9,6,1,1
"2001810",19,2218.90189762662,2085.3213618985,2162.56636020013,10,9,1,1
"2001811",11,1896.38159601978,1839.20530119368,1933.98659929558,7,4,1,1
"2001812",16,2094.17749714537,2120.16334535054,2087.92318348224,10,6,1,1
"2001813",8,1787.96454794621,1686.20858991457,1812.11073017574,2,6,1,1
"2001814",9,1847.69845723534,1742.16487109336,1856.26587460569,4,5,1,1
"2001815",12,1838.98151221517,1600.78410875329,1968.69006049611,5,7,1,1
"2001816",12,1853.40283955381,1616.23965753808,1968.69006049611,5,7,1,1
"2001817",15,1990.99419165286,1791.44799351851,2060.56118614118,7,8,1,1
"2001818",11,1858.54986384923,1702.39513514379,1933.98659929558,3,8,1,1
"2001819",10,1816.68342012049,1716.00761551563,1896.67490607898,5,5,1,1
"2001820",11,1843.78135922556,1599.7059004932,1933.98659929558,6,5,1,1
"2001821",12,1912.26469969288,1556.29384291605,1968.69006049611,5,7,1,1
"2001822",15,1915.82292245126,1653.56612549641,2060.56118614118,7,8,1,1
"2001823",13,1909.4165277014,1592.88622733668,2001.16379457045,5,8,1,1
"2001824",14,1940.18354564436,1842.34195115806,2031.70713799962,6,8,1,1
"2001825",19,2017.63936522416,1837.86549770969,2162.56636020013,9,10,1,1
"2001826",15,1968.79233198726,1679.20136388372,2060.56118614118,6,9,1,1
"2001827",20,2104.20147240521,1891.53624413922,2185.35845629437,8,12,1,1
"2001828",17,1946.18848453394,1593.05772994737,2113.95669457394,6,11,1,1
"2001829",14,1859.41213534795,1523.44522301739,2031.70713799962,8,6,1,1
"2001830",15,2022.5916786886,1738.25260289034,2060.56118614118,7,8,1,1
"2001831",21,2064.15160091279,1610.03225069235,2207.26116887512,11,10,1,1
"2001832",16,2165.53046936271,2118.32895145514,2087.92318348224,9,7,1,1
"2001833",14,2035.71991909811,2021.52485060437,2031.70713799962,8,6,1,1
"2001836",11,1795.22979572148,1953.0317161381,1933.98659929558,4,7,1,1
"2001837",8,1733.26800831205,1817.72952866749,1812.11073017574,3,5,1,1
"2002627",35,2620.19677918659,3273.98772122992,2450.1860183293,15,20,1,1
"2002628",43,2725.88532273135,3279.57377130164,2555.47878346624,21,22,1,1
"2002629",17,1993.63522492389,1645.86908293764,2113.95669457394,6,11,1,1
"2002630",19,2039.97214568395,1613.61593246759,2162.56636020013,7,12,1,1
"34003023",9,1808.10099530742,1880.12602829452,1856.26587460569,1,8,1,1
"34003024",9,1867.44897213749,2147.10337839316,1856.26587460569,1,8,1,1
"34003025",12,1804.92486865922,1584.4971327794,1968.69006049611,3,9,1,1
"34003026",13,2063.94331799144,2310.07906292861,2001.16379457045,3,10,1,1
"34003027",14,1931.05106186539,1977.53063137959,2031.70713799962,4,10,1,1
"34003028",18,1970.08049232677,1703.34600419088,2138.79896507223,5,13,1,1
"34003029",12,1828.32834696806,1640.20900489556,1968.69006049611,1,11,1,1
"34003030",9,1743.62050284292,2093.17554214862,1856.26587460569,0,9,1,1
"34003031",11,1819.430887132,1911.28112229432,1933.98659929558,1,10,1,1
"34003032",17,1821.95268447975,2159.75845211558,2113.95669457394,3,14,1,1
"34003949",8,1751.9808982029,1931.96248671993,1812.11073017574,2,6,1,1
"34003950",12,1872.32467972822,1802.62433840758,1968.69006049611,2,10,1,1
"34003951",12,1886.38907072356,2147.60435220932,1968.69006049611,1,11,1,1
"34003952",10,1835.44778156629,1667.78123470002,1896.67490607898,3,7,1,1
"34003953",12,1840.00696416031,1647.83585112459,1968.69006049611,3,9,1,1
"34003954",19,2025.70626655349,2122.96155914697,2162.56636020013,6,13,1,1
"34003955",9,1910.92994005712,1996.98797400669,1856.26587460569,3,6,1,1
"34003956",11,1833.77076226637,2024.53904139671,1933.98659929558,4,7,1,1
"34003957",12,1889.87498053508,1915.91956979347,1968.69006049611,3,9,1,1
"34003958",11,1909.28979376428,2050.5607618278,1933.98659929558,2,9,1,1
"34003959",17,1970.23822134552,2082.88443901875,2113.95669457394,6,11,1,1
"34003960",14,1812.33655071369,1653.76141123912,2031.70713799962,1,13,1,1
"34003961",12,1814.70667154732,1849.7291213108,1968.69006049611,1,11,1,1
"34003962",8,1719.00145946379,2045.70054144105,1812.11073017574,1,7,1,1
"34003963",15,1774.00910849377,1417.44470983581,2060.56118614118,4,11,1,1
"4000676",51,2838.97373446788,2906.00964242999,2646.17454577679,35,16,1,1
"4000677",43,2957.45454910646,2748.62157194136,2555.47878346624,31,12,1,1
"4000678",58,3803.02696441624,4482.17258779364,2716.66249357165,35,23,1,1
"4000679",53,3398.95200993357,3633.38316434093,2667.061866114,34,19,1,1
"4000680",62,3270.55072754752,3115.72597342923,2753.94837323248,41,21,1,1
"4000681",50,2863.64165943155,2609.59125514047,2635.48551585152,35,15,1,1
"4000682",40,2965.10288052632,2986.80107213626,2517.98110851286,23,17,1,1
"4000683",56,3333.24205809306,3581.96546730117,2697.24673169728,37,19,1,1
"4000684",61,3409.59200818289,3154.50730300186,2744.81051624266,43,18,1,1
"4000685",63,3313.79563162932,2796.80024313666,2762.96971264875,36,27,1,1
"4000686",59,3383.95374675793,3711.5214486132,2726.17127719361,38,21,1,1
"4000687",65,3841.87092131542,4225.26227554217,2780.67589681985,39,26,1,1
"4000688",51,3295.47194670539,3972.00278886422,2646.17454577679,30,21,1,1
"4000689",53,3271.37747703959,3307.1175274891,2667.061866114,28,25,1,1
"4000690",33,2552.14638085486,2656.0172047172,2420.89448855093,18,15,1,1
"4000691",51,2920.82945346857,3527.98425061806,2646.17454577679,32,19,1,1
"4000692",65,3617.63971569543,3884.75320148317,2780.67589681985,34,31,1,1
"4000693",57,2956.13413358554,3604.789703862,2707.02236739438,37,20,1,1
"4000694",61,3307.95302647243,3731.88619204217,2744.81051624266,28,33,1,1
"4000695",44,3159.76676744579,3554.79407970258,2567.51523707907,29,15,1,1
"4000696",52,3215.53666931168,3438.7591559122,2656.6981055205,33,19,1,1
"4000697",65,3589.64052602984,3760.88807615803,2780.67589681985,34,31,1,1
"4000698",61,3188.32779197544,3179.52447962028,2744.81051624266,26,35,1,1
"4000699",67,3381.26663660316,3852.62805096769,2797.95380131742,37,30,1,1
"4000700",68,3448.16086004132,3350.04909872808,2806.43931339586,42,26,1,1
"4000701",81,3803.23352482605,4716.39736699775,2908.60658576875,48,33,1,1
"4000702",77,4020.79472241304,4193.14977468396,2878.65357631343,40,37,1,1
"4000703",78,3682.83600265447,3960.16054312953,2886.25582696583,39,39,1,1
"4000704",79,3703.94447271522,4135.47739344785,2893.78092561085,40,39,1,1
"4000705",78,3348.6113974196,3227.44368217704,2886.25582696583,38,40,1,1
"4000706",75,3728.50856247415,3751.45486401584,2863.21031780169,35,40,1,1
"4000707",29,2447.76515609753,2213.60780221457,2357.79423966008,18,11,1,1
"4000708",30,2313.09712725386,2017.6495029132,2374.18906024059,18,12,1,1
"4000709",38,2946.98478878107,3166.42547154401,2491.71993967651,21,17,1,1
"4000710",40,2878.19409315176,2950.19625298956,2517.98110851286,24,16,1,1
"4000711",30,2574.66126808553,2621.76692010949,2374.18906024059,20,10,1,1
"4000712",33,2785.12398916148,2780.74742822242,2420.89448855093,22,11,1,1
"4000713",45,2818.372492883,2880.12145631711,2579.33597919865,25,20,1,1
"4000714",28,2432.88608918238,2683.38015281251,2340.94327947849,16,12,1,1
"4000715",59,3565.59695426965,3210.07544993628,2726.17127719361,33,26,1,1
"4000717",82,3678.74386852482,3220.6282755134,2915.91045786314,45,37,1,1
"4000718",5,1655.31085269617,1599.37179167147,1646.12614877363,4,1,1,1
"4000719",5,1678.44084857242,1572.83166412961,1646.12614877363,3,2,1,1
"4000720",74,3423.75406685944,3274.21489899942,2855.36548874306,42,32,1,1
"4000721",68,3503.18543375585,3414.18543409216,2806.43931339586,45,23,1,1
"4000722",60,3338.74205569643,3877.74837781959,2735.5526890818,38,22,1,1
"4000723",70,3000.93346340142,3260.41675661842,2823.11677003184,41,29,1,1
"4000724",40,2486.65214505205,2321.71745812653,2517.98110851286,23,17,1,1
"4000725",58,2844.96396903092,2475.36476231666,2716.66249357165,36,22,1,1
"4000726",49,2808.88553814535,2910.8790598911,2624.62502504328,27,22,1,1
"4000728",76,3891.75195479251,3847.91581753405,2870.97236507783,45,31,1,1
"4000729",48,2727.2497319768,2542.23557651143,2613.58673801098,31,17,1,1
"4000730",67,3462.44662661138,3946.48496328776,2797.95380131742,42,25,1,1
"4000731",56,3032.98634000228,3279.68289660261,2697.24673169728,29,27,1,1
"4000732",89,3504.83104025609,4373.54416009478,2965.14449011489,52,37,1,1
"4000734",50,2907.7236913652,2576.22983658422,2635.48551585152,27,23,1,1
"4000735",45,2772.58971438039,2305.68836679567,2579.33597919865,25,20,1,1
"4000736",66,3481.81012945347,2914.89342091795,2789.3669207067,41,25,1,1
"4000737",52,2769.66073101013,2705.5155434428,2656.6981055205,31,21,1,1
"4000738",41,2694.13259390713,2678.23658709892,2530.72175773865,31,10,1,1
"4000739",40,2683.99685593164,2911.45665654005,2517.98110851286,25,15,1,1
"4000740",45,2938.1856890486,3047.28058877786,2579.33597919865,24,21,1,1
"4000741",39,2247.31135268909,1971.57335221752,2504.98447234734,26,13,1,1
"4000742",52,3048.77890848786,3633.70761341511,2656.6981055205,32,20,1,1
"4000743",43,3106.55061885539,4060.08706117734,2555.47878346624,28,15,1,1
"4000744",54,3398.50491734729,4133.46196230759,2677.2712016452,37,17,1,1
"4000745",43,2754.75327517648,3315.59800760897,2555.47878346624,31,12,1,1
"4000746",53,2604.90998809626,2360.48771808675,2667.061866114,32,21,1,1
"4000747",40,2521.84002100799,2549.77560093777,2517.98110851286,22,18,1,1
"4000748",51,2891.10856558403,2501.63849483936,2646.17454577679,37,14,1,1
"4000749",33,2487.40615822125,2249.00001031033,2420.89448855093,19,14,1,1
"4000750",54,2862.83616658186,2939.712185785,2677.2712016452,30,24,1,1
"4000751",55,3205.77096581072,3065.68313333085,2687.33120998132,35,20,1,1
"4000752",62,2586.21980613006,2234.72399492944,2753.94837323248,33,29,1,1
"4000753",61,2471.43740083515,1902.56606717768,2744.81051624266,32,29,1,1
"4000754",63,2567.9583659293,2031.06580984768,2762.96971264875,33,30,1,1
"4000755",21,2247.48598041427,2276.21153593116,2207.26116887512,12,9,1,1
"4000756",26,2288.14594372439,2299.57606244391,2305.75108410937,12,14,1,1
"4000757",39,2182.21794608879,1848.40348620109,2504.98447234734,23,16,1,1
"4000758",29,2393.81693148576,2631.42162238992,2357.79423966008,16,13,1,1
"4000759",31,2526.23195321211,2643.30036725405,2390.15469389133,18,13,1,1
"4000760",18,2203.45376643352,2390.60616677696,2138.79896507223,12,6,1,1
"4000761",24,2076.27081372403,1810.97088793634,2268.33468283819,12,12,1,1
"4000762",16,2012.60779622151,1921.42355639366,2087.92318348224,10,6,1,1
"4000763",13,1975.87497581097,1959.30638973122,2001.16379457045,7,6,1,1
"4000764",20,2166.07370479253,2291.90169577564,2185.35845629437,11,9,1,1
"4000765",26,2298.04334897869,2434.39356603989,2305.75108410937,15,11,1,1
"4000766",16,2156.25045842833,2230.68550791148,2087.92318348224,9,7,1,1
"4000767",36,2347.2085287568,2351.12810942262,2464.33502634194,21,15,1,1
"4000768",29,2538.24730569101,2767.98416220122,2357.79423966008,19,10,1,1
"4000769",25,2008.79058823987,1967.81896114312,2287.34065519221,13,12,1,1
"4000770",20,2090.34368884549,2051.90082997336,2185.35845629437,13,7,1,1
"4000771",21,2080.23111181513,1983.9050312547,2207.26116887512,11,10,1,1
"4000772",22,2026.42341137504,1636.21950139438,2228.3491786518,13,9,1,1
"4000773",34,2136.57989522122,1766.84441581841,2435.71163614839,19,15,1,1
"4000774",34,2217.96331541978,1834.78522426134,2435.71163614839,14,20,1,1
"4000775",39,2585.78270983515,2780.3230073545,2504.98447234734,25,14,1,1
"4000776",43,2745.09979298867,2946.87615099427,2555.47878346624,27,16,1,1
"4000777",28,2358.25098844486,2427.23798802392,2340.94327947849,18,10,1,1
"4000778",44,2656.86097270482,2612.64771952408,2567.51523707907,27,17,1,1
"4000779",36,2541.47445568856,2364.03621925103,2464.33502634194,17,19,1,1
"4000781",24,2272.36953733295,2161.16946950479,2268.33468283819,18,6,1,1
"4000782",26,2282.41743201092,2103.91881419976,2305.75108410937,16,10,1,1
"4000783",26,2299.57268667946,2050.25325359592,2305.75108410937,16,10,1,1
"4000784",27,2477.34213020172,2569.13445131882,2323.60649590586,16,11,1,1
"4000785",25,2239.10561479252,2323.62248138457,2287.34065519221,17,8,1,1
"4000786",32,2404.39779640438,2422.68555562066,2405.71569249515,21,11,1,1
"4000787",34,2470.3738567433,2217.21670880087,2435.71163614839,17,17,1,1
"4000789",29,2436.14434443222,2256.64201685139,2357.79423966008,13,16,1,1
"4000790",52,2541.97510027713,2136.06139327263,2656.6981055205,27,25,1,1
"4000791",21,2253.61839874286,2003.82179563571,2207.26116887512,11,10,1,1
"4000792",22,2147.04711035856,2103.54676057976,2228.3491786518,11,11,1,1
"4000793",30,2432.44247293475,2255.73990065211,2374.18906024059,16,14,1,1
"4000794",24,2230.7502765124,2347.54954123417,2268.33468283819,13,11,1,1
"4000795",21,2262.68448754295,2125.57643609173,2207.26116887512,10,11,1,1
"4000797",53,2805.21893173181,2809.32885263973,2667.061866114,34,19,1,1
"4000798",42,2769.05575453328,2826.56522191348,2543.21752514954,26,16,1,1
"4000799",75,3186.32272022233,2650.12177594714,2863.21031780169,46,29,1,1
"4000800",52,2688.06059339506,2122.71921391471,2656.6981055205,30,22,1,1
"4000801",49,2598.5387553862,2880.19550280181,2624.62502504328,26,23,1,1
"4000802",35,2561.5301924251,2701.51792228607,2450.1860183293,14,21,1,1
"4000803",27,2164.8629610007,1734.32608840355,2323.60649590586,15,12,1,1
"4000804",22,2037.95117490153,1736.5265987915,2228.3491786518,13,9,1,1
"4000805",52,2379.67417322641,1699.0995179828,2656.6981055205,28,24,1,1
"4000806",54,2708.99736088694,2159.28103462771,2677.2712016452,30,24,1,1
"4000807",64,2369.75629590649,1527.34684927554,2771.87783482774,37,27,1,1
"4000808",62,2506.85137114732,1818.63185450822,2753.94837323248,37,25,1,1
"4000809",20,1989.36955988761,1707.26478028193,2185.35845629437,10,10,1,1
"4000810",8,1679.66106448818,1441.95417248629,1812.11073017574,5,3,1,1
"4000811",37,2314.14072709694,2159.75407347326,2478.17471526668,16,21,1,1
"4000814",36,2468.65774323012,2499.80686989346,2464.33502634194,19,17,1,1
"4000815",42,2908.35039482764,2696.62152914417,2543.21752514954,27,15,1,1
"4000816",13,1938.53891623808,1915.92892353057,2001.16379457045,7,6,1,1
"4000817",13,1851.79019980864,1632.38813926443,2001.16379457045,8,5,1,1
"4000818",23,2206.34921741014,2162.70096935529,2248.68783741607,12,11,1,1
"4000819",18,2205.27205174198,2150.14338501421,2138.79896507223,9,9,1,1
"4000820",25,2152.70628640934,1886.05827508479,2287.34065519221,13,12,1,1
"4000821",32,2404.10819820835,2073.11331647907,2405.71569249515,17,15,1,1
"4000822",26,2471.78734533863,2217.62758381205,2305.75108410937,10,16,1,1
"4000823",24,2327.00551396492,2361.18817604969,2268.33468283819,12,12,1,1
"4000824",22,2186.88783918688,2050.38563347932,2228.3491786518,9,13,1,1
"4000825",22,2320.75699839122,2360.8273182514,2228.3491786518,10,12,1,1
"4000826",19,2015.73059578381,1894.59271223002,2162.56636020013,10,9,1,1
"4000827",21,2203.4996462242,2060.45055022995,2207.26116887512,8,13,1,1
"4000828",17,2006.40697732692,1948.97897618986,2113.95669457394,8,9,1,1
"4000829",15,2109.57882856652,1955.7649066434,2060.56118614118,7,8,1,1
"4000830",33,2439.0174816841,2358.41211216015,2420.89448855093,16,17,1,1
"4000831",29,2279.85346780535,2405.34265476117,2357.79423966008,12,17,1,1
"4000832",35,2442.4626731828,2236.40087418218,2450.1860183293,21,14,1,1
"4000833",39,2497.71104950275,2234.97961011134,2504.98447234734,21,18,1,1
"4000834",22,2187.00073716091,1883.01413183251,2228.3491786518,12,10,1,1
"4000835",21,2206.91368311757,1911.98955762875,2207.26116887512,10,11,1,1
"4000836",27,2095.20530219985,1349.95410576272,2323.60649590586,13,14,1,1
"4000837",21,2199.49563363744,2127.39394208328,2207.26116887512,12,9,1,1
"4000838",22,2277.11717826787,2221.60867513696,2228.3491786518,13,9,1,1
"4000839",27,2119.50536522352,2267.55511872785,2323.60649590586,13,14,1,1
"4000840",17,1924.34518613862,1916.63208980063,2113.95669457394,10,7,1,1
"4000841",18,1932.67784348059,1594.40916997644,2138.79896507223,11,7,1,1
"4000842",24,1811.26570758289,1352.01900060638,2268.33468283819,16,8,1,1
"4000843",18,1854.06287296908,1521.96071361364,2138.79896507223,11,7,1,1
"4000844",32,2612.82924564158,2597.6683721434,2405.71569249515,21,11,1,1
"4000845",46,2402.98725208151,1854.6652713047,2590.94954296761,26,20,1,1
"4000846",40,2569.631989664,2955.27962463332,2517.98110851286,24,16,1,1
"4000847",38,2694.71377689059,3080.00853509502,2491.71993967651,17,21,1,1
"4000848",43,2673.47321899797,2735.09169703475,2555.47878346624,26,17,1,1
"4000849",40,2728.94156390808,2460.657164557,2517.98110851286,23,17,1,1
"4000850",36,2478.11409410845,2384.21299596625,2464.33502634194,21,15,1,1
"4000851",39,2631.77019230314,1905.52384032671,2504.98447234734,23,16,1,1
"4000852",42,2557.69346054107,2283.52592689183,2543.21752514954,24,18,1,1
"4000853",35,2467.31419698903,1857.51898041838,2450.1860183293,21,14,1,1
"506002951",36,2046.20806196969,1396.39950272999,2464.33502634194,16,20,1,1
"506002952",24,2319.42728204573,2281.4263521109,2268.33468283819,14,10,1,1
"506002953",27,2584.75123585933,2913.68203159478,2323.60649590586,17,10,1,1
"506002954",32,2463.8044185157,2301.33030391773,2405.71569249515,19,13,1,1
"506002955",12,1871.5389428377,1984.78720472732,1968.69006049611,6,6,1,1
"506002956",27,2433.1027349047,2685.59865402598,2323.60649590586,14,13,1,1
"506002957",28,2458.77625134812,2697.57353869429,2340.94327947849,15,13,1,1
"506002958",23,2432.81609908715,2711.6944121403,2248.68783741607,12,11,1,1
"506002959",26,2404.033875477,2713.45384854714,2305.75108410937,13,13,1,1
"506002960",30,2440.47311894707,2581.33340023395,2374.18906024059,15,15,1,1
"506002961",31,2202.94707188968,1933.87669584682,2390.15469389133,13,18,1,1
"506002962",26,2376.95182394045,2313.87325478511,2305.75108410937,10,16,1,1
"506002963",29,2530.04320360724,2580.725121566,2357.79423966008,15,14,1,1
"506002964",27,2281.97191822897,1930.55861924595,2323.60649590586,12,15,1,1
"506002965",21,2175.41577083148,2290.67176379081,2207.26116887512,11,10,1,1
"506002966",18,2250.43155180938,2190.9364783498,2138.79896507223,8,10,1,1
"506002967",31,2424.66551647047,2061.42415785466,2390.15469389133,14,17,1,1
"506002968",30,2413.66671574287,2472.41098601479,2374.18906024059,14,16,1,1
"506002969",29,2529.37586837388,2696.88978368827,2357.79423966008,17,12,1,1
"506002970",22,2180.37045958567,2246.0418026889,2228.3491786518,11,11,1,1
"506002971",28,2505.25533956159,2401.80992769809,2340.94327947849,15,13,1,1
"506002972",30,2245.91127406445,2353.31025608881,2374.18906024059,17,13,1,1
"506002973",25,2216.95699101291,2074.84567393708,2287.34065519221,13,12,1,1
"506002975",31,2464.24757555703,2350.1849924145,2390.15469389133,16,15,1,1
"506002976",33,2527.17137945003,2777.17128516235,2420.89448855093,17,16,1,1
"506002977",19,2182.03305833342,2095.136334606,2162.56636020013,10,9,1,1
"506002979",11,1902.08772745515,1786.97933039139,1933.98659929558,3,8,1,1
"506002980",16,2008.61063003792,2018.83227312396,2087.92318348224,6,10,1,1
"506002981",15,1955.63136559859,1854.81498655312,2060.56118614118,5,10,1,1
"506002982",20,2010.18644630441,2112.1951240431,2185.35845629437,8,12,1,1
"506002983",8,1764.1632345173,1798.21578492183,1812.11073017574,3,5,1,1
"506002984",13,1905.23343480211,2040.40943923405,2001.16379457045,5,8,1,1
"506002985",6,1673.0448577904,1708.30845462771,1708.62817714657,3,3,1,1
"506002986",12,1926.14720097264,1931.73773542016,1968.69006049611,5,7,1,1
"506002987",21,2118.58419618038,2002.81442475515,2207.26116887512,9,12,1,1
"506002988",14,1960.5231354411,2030.0142481704,2031.70713799962,7,7,1,1
"506002989",14,1814.05302771633,1728.67460268402,2031.70713799962,4,10,1,1
"506002991",21,2070.31453541412,1679.25503509612,2207.26116887512,7,14,1,1
"506002993",14,1981.91514786739,1816.84096588758,2031.70713799962,6,8,1,1
"506002994",32,2283.66022398438,1866.89132517892,2405.71569249515,13,19,1,1
"506002995",31,2378.03934378408,2184.538212101,2390.15469389133,12,19,1,1
"506002996",28,2218.76229472498,1786.74739581732,2340.94327947849,13,15,1,1
"506002997",22,2183.34454056055,1828.66971509408,2228.3491786518,11,11,1,1
"506002998",20,2238.48977164884,2144.75585725937,2185.35845629437,9,11,1,1
"506002999",31,2340.27290408579,1801.75087395604,2390.15469389133,15,16,1,1
"506003000",33,2312.52145312993,1968.47904061429,2420.89448855093,18,15,1,1
"506003002",24,2142.85154715042,1671.60077575316,2268.33468283819,10,14,1,1
"506003003",27,2248.74299191477,2027.85596809142,2323.60649590586,13,14,1,1
"506003004",29,2119.68916989021,1671.42846912155,2357.79423966008,16,13,1,1
"506003331",28,2445.68948350173,2370.0282305794,2340.94327947849,15,13,1,1
"506003332",17,2140.4480304032,2361.43647805691,2113.95669457394,8,9,1,1
"506003333",24,2517.81992552839,2951.34915172072,2268.33468283819,12,12,1,1
"506003335",25,2507.73723297566,2843.38409425786,2287.34065519221,14,11,1,1
"506003336",27,2547.24489336807,2677.3609021696,2323.60649590586,16,11,1,1
"506003337",30,2468.83888346621,2711.30284007333,2374.18906024059,17,13,1,1
"506003338",26,2493.23645825615,2543.9852973732,2305.75108410937,14,12,1,1
"506003339",28,2487.58069859858,2954.72380000421,2340.94327947849,15,13,1,1
"506003340",28,2472.95348092428,2873.31389408055,2340.94327947849,17,11,1,1
"506003341",18,2304.80848581155,2404.2018865651,2138.79896507223,11,7,1,1
"506003342",29,2675.72618298288,3129.00689971668,2357.79423966008,16,13,1,1
"506003343",18,2233.95672324488,2489.1665068168,2138.79896507223,13,5,1,1
"506003344",27,2530.13012452812,2847.13717049746,2323.60649590586,16,11,1,1
"506003346",28,2473.670595837,2686.15020045004,2340.94327947849,18,10,1,1
"506003348",29,2570.78669734975,2722.48090676358,2357.79423966008,18,11,1,1
"506003349",31,2499.05851806213,2539.40277263162,2390.15469389133,17,14,1,1
"506003351",26,2439.71853231181,2651.47708723905,2305.75108410937,16,10,1,1
"506003352",29,2427.64743538355,2433.30236203672,2357.79423966008,15,14,1,1
"506003353",31,2311.29213898832,2043.79662197515,2390.15469389133,18,13,1,1
"506003355",26,2390.09322450449,2629.20020444248,2305.75108410937,13,13,1,1
"506003356",31,2656.03299188518,3251.22004580769,2390.15469389133,16,15,1,1
"506003357",27,2513.9459282376,2778.48019252041,2323.60649590586,15,12,1,1
"506003358",31,2518.90742827731,2740.92602779796,2390.15469389133,18,13,1,1
"506003359",32,2469.41362386338,2617.19949581783,2405.71569249515,19,13,1,1
"506003360",38,2505.2306243658,2817.04134319908,2491.71993967651,19,19,1,1
"506003361",27,2444.61474231696,2856.24121570764,2323.60649590586,16,11,1,1
"506003362",26,2425.03334515255,2469.42191701063,2305.75108410937,14,12,1,1
"506003363",28,2428.48196258624,2517.09243274087,2340.94327947849,16,12,1,1
"506003364",14,2054.35283348887,2081.19204132317,2031.70713799962,10,4,1,1
"506003700",31,2534.25265706353,2639.56364938289,2390.15469389133,18,13,1,1
"506003704",28,2531.0332983362,2869.47145517808,2340.94327947849,14,14,1,1
"506003705",27,2427.10821814824,2765.55551214249,2323.60649590586,14,13,1,1
"506003707",27,2332.28247868926,2428.02921535609,2323.60649590586,14,13,1,1
"506003708",23,2459.81675162248,2737.16637380992,2248.68783741607,10,13,1,1
"506003709",30,2567.06580041077,2881.91516791767,2374.18906024059,15,15,1,1
"506003710",25,2508.20215718779,2684.11103774413,2287.34065519221,15,10,1,1
"506003711",30,2597.07653883739,2899.99862873746,2374.18906024059,15,15,1,1
"506003712",31,2463.17362502272,2883.98577791969,2390.15469389133,16,15,1,1
"506003805",29,2480.55589430642,2724.90892054844,2357.79423966008,12,17,1,1
"506003807",32,2639.27604863904,2775.62967619449,2405.71569249515,18,14,1,1
"506003808",28,2578.99058822686,2646.47327690175,2340.94327947849,15,13,1,1
"506003809",32,2778.72971640015,3036.0575009899,2405.71569249515,17,15,1,1
"506003810",27,2392.87795902157,2653.42275949632,2323.60649590586,15,12,1,1
"506003811",28,2418.35069913712,2180.55395051787,2340.94327947849,16,12,1,1
"506003812",26,2294.52392737907,2408.6152523039,2305.75108410937,14,12,1,1
"506003815",22,2273.51349330658,2268.34074773855,2228.3491786518,13,9,1,1
"506003816",24,2396.62942684247,2673.35352535898,2268.33468283819,14,10,1,1
"506003817",22,2394.18160769387,2614.86932829272,2228.3491786518,13,9,1,1
"506003818",28,2381.16103827076,2590.38163397916,2340.94327947849,15,13,1,1
"506003820",28,2472.03733257801,2406.76282864954,2340.94327947849,14,14,1,1
"506003821",33,2466.79222214429,2411.93244193561,2420.89448855093,17,16,1,1
"506003822",30,2067.35957499874,1796.99918398876,2374.18906024059,12,18,1,1
"506003823",12,1906.82313968172,1862.61216076026,1968.69006049611,5,7,1,1
"506003824",15,2023.27393140089,2034.56076615539,2060.56118614118,6,9,1,1
"506003825",11,1905.27334320762,1972.94434455463,1933.98659929558,5,6,1,1
"506003826",15,1903.63708959423,1819.97369778991,2060.56118614118,6,9,1,1
"506003827",18,2030.90800930726,1836.32943380708,2138.79896507223,8,10,1,1
"506003828",12,1885.33204130552,1832.07912365422,1968.69006049611,5,7,1,1
"506003829",15,2081.72803051315,2067.23541820358,2060.56118614118,7,8,1,1
"506003831",11,1895.25629761039,1918.22078360684,1933.98659929558,6,5,1,1
"506003832",13,1836.90851898589,1908.981959539,2001.16379457045,4,9,1,1
"506003833",11,1830.23295065836,1817.08559977554,1933.98659929558,7,4,1,1
"506003834",29,2072.88731465556,1649.44528071275,2357.79423966008,12,17,1,1
"506003835",15,2093.17951000867,2145.77342524874,2060.56118614118,6,9,1,1
"506003836",15,2149.95106055979,2166.67988886842,2060.56118614118,8,7,1,1
"506003837",12,1856.1557954602,1603.13651839924,1968.69006049611,4,8,1,1
"506003838",20,2155.35751126558,2184.218240801,2185.35845629437,10,10,1,1
"506003839",24,2406.69695296908,2155.44655776661,2268.33468283819,12,12,1,1
"506003840",25,2222.38517603563,1859.10463298099,2287.34065519221,12,13,1,1
"506003841",25,2324.78176199598,2143.63275411959,2287.34065519221,12,13,1,1
"506003842",27,2446.38775897951,2009.0873416815,2323.60649590586,14,13,1,1
"506003843",22,2267.24312143746,2108.84251445499,2228.3491786518,9,13,1,1
"506003844",30,2588.07356648457,2605.34378367199,2374.18906024059,17,13,1,1
"506003846",21,2027.23111739262,1739.21383172765,2207.26116887512,11,10,1,1
"507003166",33,2342.74415066433,2254.85693581663,2420.89448855093,17,16,1,1
"507003167",34,2379.45368019413,2024.86059511031,2435.71163614839,14,20,1,1
"507003168",24,2311.34719604146,2432.93424978652,2268.33468283819,12,12,1,1
"507003169",23,2416.04614190917,2320.59094458851,2248.68783741607,9,14,1,1
"507003170",30,2205.85849124785,1888.11232322812,2374.18906024059,13,17,1,1
"507003171",27,2116.94357913478,1703.76369373682,2323.60649590586,9,18,1,1
"507003172",34,2146.77282077856,1754.025718073,2435.71163614839,15,19,1,1
"507003173",21,2224.61383111824,2254.97880395308,2207.26116887512,9,12,1,1
"507003174",25,2058.9756055214,1716.27074765381,2287.34065519221,10,15,1,1
"507003176",32,2135.58297202715,1663.37237761699,2405.71569249515,14,18,1,1
"507003177",39,2051.72619498421,1731.70907531833,2504.98447234734,16,23,1,1
"507003178",29,2358.3294509905,2285.41945480912,2357.79423966008,14,15,1,1
"507003179",25,2303.3103848073,2038.61623252085,2287.34065519221,10,15,1,1
"507003180",30,2211.23491984021,1856.03695882231,2374.18906024059,14,16,1,1
"507003181",23,2365.53255333767,2022.09997568216,2248.68783741607,11,12,1,1
"507003182",27,2196.5616902422,1943.00690646443,2323.60649590586,13,14,1,1
"507003183",22,2114.87843874536,1844.03705139572,2228.3491786518,11,11,1,1
"507003184",22,2101.41143859003,1980.18267394409,2228.3491786518,7,15,1,1
"507003185",20,2146.12582714041,2043.55439187101,2185.35845629437,10,10,1,1
"507003186",12,1851.19780089252,1770.17588255865,1968.69006049611,5,7,1,1
"507003187",23,2312.63341008003,2350.77487276589,2248.68783741607,11,12,1,1
"507003189",15,2076.95397214658,1954.48658299926,2060.56118614118,5,10,1,1
"507003190",29,2361.71870953771,2160.07323733653,2357.79423966008,15,14,1,1
"507003191",30,2289.0461780485,2068.19942902468,2374.18906024059,15,15,1,1
"507003192",16,2194.31823744272,2212.37642322073,2087.92318348224,8,8,1,1
"507003193",24,2284.46017507149,2368.06706393018,2268.33468283819,14,10,1,1
"507003194",27,2312.38704541544,2089.8308332563,2323.60649590586,13,14,1,1
"507003195",36,2282.0672185194,1905.14308993327,2464.33502634194,16,20,1,1
"507003196",29,2251.11403845776,2011.35696086726,2357.79423966008,15,14,1,1
"507003198",26,2371.05008673086,2010.22137429636,2305.75108410937,13,13,1,1
"507003199",27,2341.26438247548,1984.963319162,2323.60649590586,13,14,1,1
"507003200",22,2260.67552003031,2213.81343582403,2228.3491786518,10,12,1,1
"507003201",29,2266.35593981256,2076.99963111028,2357.79423966008,13,16,1,1
"507003202",23,2109.20155781293,1736.45411500583,2248.68783741607,13,10,1,1
"507003203",30,2314.78933737968,1914.72561281966,2374.18906024059,15,15,1,1
"507003204",20,2130.11528642578,1782.14159844696,2185.35845629437,10,10,1,1
"507003205",31,2277.17686830558,1774.98423169958,2390.15469389133,14,17,1,1
"507003206",25,2314.21665695027,2344.7353369665,2287.34065519221,12,13,1,1
"507003207",39,2090.77595792413,1884.53035816392,2504.98447234734,20,19,1,1
"507003208",31,2390.54769641933,2093.12110076989,2390.15469389133,14,17,1,1
"507003209",10,1912.76075586253,1893.4415603207,1896.67490607898,3,7,1,1
"507003210",26,2372.48157228172,2179.49238776764,2305.75108410937,11,15,1,1
"507003211",26,2424.58151521473,2142.89971811612,2305.75108410937,14,12,1,1
"507003212",17,2140.75408119703,1964.99916788282,2113.95669457394,10,7,1,1
"507003213",25,2346.58727593473,2351.22639824438,2287.34065519221,13,12,1,1
"507003214",37,2245.77503106768,1930.78128171904,2478.17471526668,16,21,1,1
"507003215",31,2397.27316819639,2543.82365405894,2390.15469389133,17,14,1,1
"507003216",20,2332.88194580118,2219.466823926,2185.35845629437,12,8,1,1
"507003217",24,2248.81803804564,2203.98158821548,2268.33468283819,11,13,1,1
"507003218",31,2293.97727812119,1737.53020393984,2390.15469389133,13,18,1,1
"507003219",33,2591.17907229307,2621.4475032386,2420.89448855093,17,16,1,1
"507003220",33,2344.89037266576,2100.57266757315,2420.89448855093,17,16,1,1
"507003221",29,2355.61084956937,2200.39919230678,2357.79423966008,14,15,1,1
"507003222",23,2344.25457159623,2173.47971813133,2248.68783741607,10,13,1,1
"507003223",18,2276.60128753032,2187.00217401275,2138.79896507223,8,10,1,1
"507003224",37,1966.03547112528,1502.85203581239,2478.17471526668,14,23,1,1
"507003225",26,2245.38976377059,2207.83684974592,2305.75108410937,11,15,1,1
"507003226",32,2423.19990874436,2286.49728934777,2405.71569249515,12,20,1,1
"507003227",31,2107.11133902027,1896.07711388069,2390.15469389133,13,18,1,1
"507003228",24,2277.50727185543,2277.37254416006,2268.33468283819,11,13,1,1
"507003229",28,2346.46098051103,2344.77669599159,2340.94327947849,15,13,1,1
"507003230",28,2282.3633164529,2047.93699785043,2340.94327947849,14,14,1,1
"507003231",22,2104.32044252417,1923.74761202067,2228.3491786518,10,12,1,1
"507003232",35,2122.89561488248,1637.74552838089,2450.1860183293,13,22,1,1
"507003233",22,2099.6856361504,1998.17870391555,2228.3491786518,8,14,1,1
"507003234",26,2296.04522204895,2220.51971079845,2305.75108410937,16,10,1,1
"507003235",21,2109.2204000657,2090.53512907573,2207.26116887512,9,12,1,1
"507003236",32,2174.72458312593,1791.16227643633,2405.71569249515,14,18,1,1
"507003237",27,2154.23424022858,2197.57401469456,2323.60649590586,13,14,1,1
"507003238",31,2068.1137994746,1497.12588224,2390.15469389133,12,19,1,1
"507003524",20,2137.72296658383,1928.78046224461,2185.35845629437,9,11,1,1
"507003525",35,2576.91706489187,2374.60713204209,2450.1860183293,19,16,1,1
"507003526",27,2439.41363353072,2515.32310505198,2323.60649590586,12,15,1,1
"507003527",21,2302.66310814207,2205.5469882839,2207.26116887512,11,10,1,1
"507003528",19,2190.78825197271,2205.28224638231,2162.56636020013,9,10,1,1
"507003529",22,2274.81205707427,2423.96378705949,2228.3491786518,12,10,1,1
"507003530",23,2384.19068037739,2343.51869086047,2248.68783741607,12,11,1,1
"507003531",19,2148.89953338623,2150.5069044861,2162.56636020013,10,9,1,1
"507003532",25,2534.98651313842,2283.40432136769,2287.34065519221,11,14,1,1
"507003533",26,2497.38609052352,2619.1772159124,2305.75108410937,14,12,1,1
"507003534",22,2362.43730479699,2642.75599976382,2228.3491786518,10,12,1,1
"507003535",23,2219.18487446282,2086.62276559789,2248.68783741607,13,10,1,1
"507003536",26,2562.4542735594,2707.49259158368,2305.75108410937,12,14,1,1
"507003537",30,2217.45415989586,2003.73545397498,2374.18906024059,14,16,1,1
"507003538",20,2241.12249953623,2190.13977805574,2185.35845629437,11,9,1,1
"507003539",24,2350.30191942643,2349.6654546582,2268.33468283819,14,10,1,1
"507003540",24,2334.64331589993,2113.27133113076,2268.33468283819,12,12,1,1
"507003541",23,2288.71631036413,2190.3173923345,2248.68783741607,11,12,1,1
"507003542",21,2379.44480850509,2541.29552312338,2207.26116887512,11,10,1,1
"507003543",21,2264.43783801785,2501.88916614029,2207.26116887512,12,9,1,1
"507003545",23,2416.91872543795,2551.70564183092,2248.68783741607,10,13,1,1
"507003546",25,2361.37519848145,2032.00331356877,2287.34065519221,11,14,1,1
"507003547",25,2363.12279723598,2046.74446261248,2287.34065519221,13,12,1,1
"507003548",19,2276.6816769551,2406.59520849327,2162.56636020013,9,10,1,1
"507003549",30,2295.9036997507,2192.98570747064,2374.18906024059,15,15,1,1
"507003550",28,2475.95889007782,2522.97559994059,2340.94327947849,17,11,1,1
"507003551",25,2284.71954337594,2171.87070265001,2287.34065519221,13,12,1,1
"507003552",23,2403.00068858584,2472.70146555822,2248.68783741607,12,11,1,1
"507003553",22,2342.57488589157,2337.19672654767,2228.3491786518,13,9,1,1
"507003555",29,2283.61478473365,1856.4955666151,2357.79423966008,13,16,1,1
"507003556",22,2336.75430111673,2434.35414374014,2228.3491786518,10,12,1,1
"507003557",26,2429.11290681364,2587.38751680179,2305.75108410937,12,14,1,1
"507003558",23,2377.02670013243,2380.01710218883,2248.68783741607,11,12,1,1
"507003559",25,2286.65379379079,2109.96058789618,2287.34065519221,8,17,1,1
"507003560",17,2270.36032117853,2365.23369382311,2113.95669457394,10,7,1,1
"507003561",27,2330.17166042308,2216.30177360216,2323.60649590586,12,15,1,1
"507003562",27,2380.76300510683,2137.95957706441,2323.60649590586,13,14,1,1
"507003563",19,2289.22256128223,2408.32980282119,2162.56636020013,9,10,1,1
"507003564",28,2175.55686616995,1537.28900294133,2340.94327947849,16,12,1,1
"507003565",28,2292.67492398286,1984.83078710264,2340.94327947849,16,12,1,1
"507003566",31,2409.93409958757,1953.66592080773,2390.15469389133,16,15,1,1
"507003567",23,2321.15326714981,2302.4657840116,2248.68783741607,11,12,1,1
"507003568",27,2298.82050309365,2186.89071069387,2323.60649590586,13,14,1,1
"507003569",19,2359.1343431946,2354.46824665461,2162.56636020013,11,8,1,1
"507003570",23,2193.88804278359,2312.22129264567,2248.68783741607,12,11,1,1
"507003571",18,2275.16406463432,2501.3872128188,2138.79896507223,9,9,1,1
"507003572",20,2284.70389483844,2140.42940983796,2185.35845629437,9,11,1,1
"507003573",16,2235.01481665176,2406.25961474372,2087.92318348224,8,8,1,1
"507003574",23,2391.4467206548,2332.78837899782,2248.68783741607,12,11,1,1
"507003575",17,2244.03978579429,2306.31975316928,2113.95669457394,9,8,1,1
"507003576",24,2349.2741672682,2169.35886390025,2268.33468283819,11,13,1,1
"507003577",21,2198.83766577348,1987.50491835769,2207.26116887512,13,8,1,1
"507003578",35,2219.05968386389,1924.4877441584,2450.1860183293,17,18,1,1
"507003579",22,2221.04196591236,2421.06215870633,2228.3491786518,12,10,1,1
"507003580",30,2315.23271734226,2074.91541557734,2374.18906024059,14,16,1,1
"507003581",25,2169.2943498306,2150.47942192389,2287.34065519221,14,11,1,1
"507003582",15,2181.01921718296,2165.89631740753,2060.56118614118,6,9,1,1
"507003583",27,2230.23855561984,2233.67483340082,2323.60649590586,11,16,1,1
"507003584",24,2349.72767898506,2295.64536151434,2268.33468283819,11,13,1,1
"507003585",14,2006.98653489769,1790.63656297845,2031.70713799962,6,8,1,1
"507003586",17,2180.39935338105,2431.45946116425,2113.95669457394,9,8,1,1
"507003587",26,2296.6384166974,1991.70562964333,2305.75108410937,13,13,1,1
"507003588",27,2318.41331715024,2120.32947806514,2323.60649590586,14,13,1,1
"507003589",22,2376.24520493406,2231.28349117593,2228.3491786518,14,8,1,1
"507003590",22,2173.64513061672,2152.55409670704,2228.3491786518,11,11,1,1
"507003591",29,2278.88293541458,1838.58471429312,2357.79423966008,14,15,1,1
"507003592",14,2069.14142942113,1934.86598198703,2031.70713799962,8,6,1,1
"507003593",23,2284.38113872935,2330.82982685579,2248.68783741607,12,11,1,1
"507003594",18,2326.19867973249,2274.78919136843,2138.79896507223,8,10,1,1
"507003595",29,2439.86184398061,2071.0775626665,2357.79423966008,14,15,1,1
"507003596",17,2074.55709707599,1843.63794103009,2113.95669457394,9,8,1,1
"507003597",25,2331.29726537753,2226.12953514204,2287.34065519221,13,12,1,1
"507003598",17,2264.14958592069,2173.44311511137,2113.95669457394,8,9,1,1
"507003599",20,2243.99617443829,2252.84274002441,2185.35845629437,12,8,1,1
"507003600",19,2258.99742289763,2120.39094577933,2162.56636020013,11,8,1,1
"507003601",19,2206.00199818472,2264.24334061136,2162.56636020013,10,9,1,1
"507003602",20,2084.68184098651,1877.16643451757,2185.35845629437,11,9,1,1
"507003603",25,2148.44793433365,2248.9398125344,2287.34065519221,13,12,1,1
"507003604",26,2187.31131700153,2025.65252512459,2305.75108410937,16,10,1,1
"507003605",22,2221.9206142951,2083.521266886,2228.3491786518,10,12,1,1
"507003606",20,2212.03882473021,2297.88789033149,2185.35845629437,8,12,1,1
"507003607",29,2478.99421844264,2374.39864910974,2357.79423966008,14,15,1,1
"507003608",27,2485.00544252981,2270.79839503374,2323.60649590586,12,15,1,1
"507003609",24,2319.58021075808,2134.15308818152,2268.33468283819,13,11,1,1
"507003610",22,2365.97908444906,2284.26267912563,2228.3491786518,13,9,1,1
"507003611",21,2189.14255854564,1937.90952305828,2207.26116887512,9,12,1,1
"507003612",29,2447.10916671696,2129.26895260427,2357.79423966008,14,15,1,1
"507003613",28,2192.55083572198,1892.04230080396,2340.94327947849,15,13,1,1
"507003614",22,2216.9912275749,2019.65442389496,2228.3491786518,13,9,1,1
"507003615",31,2504.64491173443,2406.66663146443,2390.15469389133,13,18,1,1
"507003616",16,2081.69492130494,2091.76774013441,2087.92318348224,6,10,1,1
"507003617",25,2334.275977672,2449.75133806491,2287.34065519221,12,13,1,1
"507003618",20,2319.7974688168,2274.89244795764,2185.35845629437,9,11,1,1
"507003619",36,2509.39364720317,2462.81915403718,2464.33502634194,18,18,1,1
"507003620",30,2336.41721705412,2287.19634039983,2374.18906024059,15,15,1,1
"507003621",22,2249.21584346334,2096.8695201184,2228.3491786518,8,14,1,1
"507003622",35,2409.82298183449,2396.94097178476,2450.1860183293,18,17,1,1
"507003623",30,2430.42400810638,2213.74122311653,2374.18906024059,16,14,1,1
"507003624",26,2359.4006056846,2042.66758886256,2305.75108410937,15,11,1,1
"507003627",36,2455.54638009974,2556.81514183789,2464.33502634194,18,18,1,1
"507003628",23,2260.44294758562,2074.63552861536,2248.68783741607,9,14,1,1
"507003794",17,2022.32868031583,2196.39719507245,2113.95669457394,8,9,1,1
"507003795",20,2059.4289539606,2181.67864559758,2185.35845629437,8,12,1,1
"507003798",21,2345.44686936719,2207.00469253415,2207.26116887512,11,10,1,1
"507003799",23,2387.81094359955,2315.8310268123,2248.68783741607,11,12,1,1
"507003801",32,2207.94015239376,1914.9609479366,2405.71569249515,12,20,1,1
"507003802",32,2470.79556451497,2459.80513099719,2405.71569249515,14,18,1,1
"507003803",25,2431.54359332801,2517.82134560011,2287.34065519221,11,14,1,1
"507003804",29,2453.87689435826,2379.15744276481,2357.79423966008,15,14,1,1
"507003847",25,2445.5482282584,2496.17968146538,2287.34065519221,13,12,1,1
"507003848",20,2021.47861558272,1679.87451117471,2185.35845629437,9,11,1,1
"507003849",24,2272.23907958624,2111.41160719192,2268.33468283819,10,14,1,1
"507003850",19,2094.17922152125,2136.94459386661,2162.56636020013,7,12,1,1
"507003851",18,2146.52152420787,2282.4955196097,2138.79896507223,7,11,1,1
"507003852",25,2335.0850294717,2348.25575181945,2287.34065519221,11,14,1,1
"507003854",24,2368.54541642638,2276.92164450763,2268.33468283819,11,13,1,1
"507003855",30,2311.03888949463,2259.35914410446,2374.18906024059,15,15,1,1
"507003856",26,2423.36307409941,2569.2125408434,2305.75108410937,12,14,1,1
"507003857",24,2434.33594610817,2520.99864958818,2268.33468283819,11,13,1,1
"507003858",22,2362.05840289253,2405.7260749731,2228.3491786518,11,11,1,1
"507003859",28,2445.04198471396,2242.43875003838,2340.94327947849,14,14,1,1
"507003860",27,2439.65943947853,2315.05301064187,2323.60649590586,12,15,1,1
"507003861",21,2356.69689655376,2504.49566189381,2207.26116887512,11,10,1,1
"507003862",24,2192.4508168981,1806.86645872864,2268.33468283819,13,11,1,1
"507003863",25,2423.27351729072,2373.67471522214,2287.34065519221,12,13,1,1
"507003864",29,2427.86615396389,2216.50640610228,2357.79423966008,13,16,1,1
"507003865",26,2248.15866406236,2051.4913943258,2305.75108410937,12,14,1,1
"507003866",24,2313.25817068061,2234.90860344365,2268.33468283819,13,11,1,1
"507003867",24,2033.99669996403,1820.82366827352,2268.33468283819,13,11,1,1
"507003868",25,2506.84542556771,2523.56238108788,2287.34065519221,12,13,1,1
"507003869",20,2299.97754704161,2284.38914310681,2185.35845629437,12,8,1,1
"507003870",22,2261.51317560464,2207.96647891231,2228.3491786518,11,11,1,1
"507003871",22,2383.75282504365,2471.49963750602,2228.3491786518,12,10,1,1
"507003872",46,2273.39939843322,1917.92216033291,2590.94954296761,21,25,1,1
"507003873",29,2409.91941698104,2380.0681149297,2357.79423966008,14,15,1,1
"507003874",6,1764.97896283994,1707.91949633711,1708.62817714657,2,4,1,1
"507003875",10,1956.02822938319,1810.55068816202,1896.67490607898,4,6,1,1
"507003876",29,2407.95204992845,2435.06897133294,2357.79423966008,13,16,1,1
"507003877",29,2393.26497593926,2294.55443131832,2357.79423966008,15,14,1,1
"507003878",13,2029.49709125056,1827.30956057357,2001.16379457045,6,7,1,1
"507003879",22,2298.15281082495,2232.75793364643,2228.3491786518,11,11,1,1
"507003880",30,2150.89574663002,1749.26416163768,2374.18906024059,14,16,1,1
"507003881",23,2389.60987255065,2473.58212195183,2248.68783741607,13,10,1,1
"507003882",26,2327.51173263381,2077.88531452826,2305.75108410937,16,10,1,1
"507003883",27,2349.63108868451,2037.62241364584,2323.60649590586,14,13,1,1
"507003884",25,2241.03105899695,1755.67082760981,2287.34065519221,10,15,1,1
"507003885",22,2371.09072016696,2660.10746940517,2228.3491786518,13,9,1,1
"507003886",25,2431.12195555712,2447.07960325362,2287.34065519221,13,12,1,1
"507003887",15,2117.21424581443,2195.00963676248,2060.56118614118,8,7,1,1
"507003888",40,2211.72831576266,1814.98824661401,2517.98110851286,18,22,1,1
"507003889",21,2303.51289874544,2189.50595596974,2207.26116887512,9,12,1,1
"507003890",22,2157.00542764736,2307.62146962512,2228.3491786518,8,14,1,1
"507003891",23,2252.05696808143,2318.198467376,2248.68783741607,9,14,1,1
"507003892",26,2202.73532778118,1873.79139852786,2305.75108410937,11,15,1,1
"507003893",28,2253.83496446022,2107.0812587363,2340.94327947849,12,16,1,1
"507003894",26,2352.9105563665,2289.50887809008,2305.75108410937,15,11,1,1
"507003895",32,2428.38410438846,1845.26227299915,2405.71569249515,14,18,1,1
"507003896",29,2209.27763766363,1820.2280503305,2357.79423966008,13,16,1,1
"507003897",25,2254.75317864376,2568.85935809765,2287.34065519221,12,13,1,1
"507003898",12,2031.78672382575,2140.81092907263,1968.69006049611,4,8,1,1
"507003899",24,2261.66080723597,2067.0836087886,2268.33468283819,10,14,1,1
"507003900",16,2076.96610976421,2058.74482524897,2087.92318348224,6,10,1,1
"507003901",31,2182.62209693827,1932.17454928192,2390.15469389133,16,15,1,1
"507003902",24,2298.68906098077,2162.28738780448,2268.33468283819,13,11,1,1
"507003903",28,2160.73663407546,1777.39019658893,2340.94327947849,12,16,1,1
"507003904",25,2185.30204522184,1949.24973616124,2287.34065519221,14,11,1,1
"507003905",16,1943.05925288885,1926.8222229254,2087.92318348224,8,8,1,1
"507003906",25,2123.81116333876,1833.53423981521,2287.34065519221,14,11,1,1
"507003907",34,2012.49458952356,1372.92874238851,2435.71163614839,13,21,1,1
"57003305",18,2280.99350499666,2349.7057522592,2138.79896507223,11,7,1,1
"57003306",17,2209.13042333456,2249.33920156652,2113.95669457394,11,6,1,1
"57003307",18,2141.59076907762,2583.52980654664,2138.79896507223,11,7,1,1
"57003308",15,2084.86133382223,2011.37218593682,2060.56118614118,8,7,1,1
"57003309",20,2102.13005662588,1988.3351219865,2185.35845629437,11,9,1,1
"57003310",19,2191.49751481817,1972.85240885857,2162.56636020013,10,9,1,1
"57003311",18,2234.02710598499,2277.83107889837,2138.79896507223,10,8,1,1
"57003312",19,2112.42678606329,2029.64329402979,2162.56636020013,10,9,1,1
"57003313",13,2018.7715270662,1780.60697918419,2001.16379457045,8,5,1,1
"57003314",14,1997.7693457557,1936.1743271688,2031.70713799962,7,7,1,1
"57003315",18,2261.72256552117,2304.88914414897,2138.79896507223,10,8,1,1
"57003316",22,2295.44325355482,2271.83241864447,2228.3491786518,14,8,1,1
"57003317",19,2178.81303251183,2520.03330483363,2162.56636020013,11,8,1,1
"57003319",21,2316.62654931956,2298.60307883843,2207.26116887512,12,9,1,1
"57003320",18,2099.88775241917,2236.48638634847,2138.79896507223,9,9,1,1
"57003321",18,2049.54773010014,1763.76187833662,2138.79896507223,9,9,1,1
"57003322",16,2208.34745204319,2372.02645236909,2087.92318348224,8,8,1,1
"57003323",15,2129.17723177292,2163.84021428959,2060.56118614118,8,7,1,1
"57003325",19,2240.90098986228,2256.56720233563,2162.56636020013,10,9,1,1
"57003326",19,2380.19461786154,2742.56090277427,2162.56636020013,11,8,1,1
"57003327",15,2061.40129619515,1882.28625311365,2060.56118614118,8,7,1,1
"57003328",23,2300.62089891788,2038.01119243459,2248.68783741607,12,11,1,1
"593003373",13,1843.43819178516,1750.13815926242,2001.16379457045,6,7,1,1
"593003374",13,1933.81457726046,1689.80229972819,2001.16379457045,5,8,1,1
"593003377",16,2019.453161029,1702.11652752386,2087.92318348224,6,10,1,1
"593003378",15,1902.5679498231,1417.92656985547,2060.56118614118,5,10,1,1
"593003379",18,2022.86650309514,1440.5504185085,2138.79896507223,4,14,1,1
"593003383",15,1912.26347065746,1876.22988796914,2060.56118614118,6,9,1,1
"593003384",12,1873.01118448724,1578.41131230555,1968.69006049611,5,7,1,1
"593003385",14,1899.00313274996,2028.8926553141,2031.70713799962,4,10,1,1
"593003386",10,1927.25507802579,2013.21732041256,1896.67490607898,5,5,1,1
"593003387",14,1969.89690058383,1890.41040783968,2031.70713799962,5,9,1,1
"593003388",14,1955.76272137633,1608.35704696299,2031.70713799962,6,8,1,1
"593003389",15,1972.0955908285,1996.80039873318,2060.56118614118,4,11,1,1
"593003390",11,1913.29016836903,1901.05310113482,1933.98659929558,5,6,1,1
"593003391",12,1793.33923164056,1637.87170587969,1968.69006049611,2,10,1,1
"593003392",14,1949.10698595651,1913.74341607981,2031.70713799962,5,9,1,1
"593003393",18,2040.86657067279,1804.05750101205,2138.79896507223,5,13,1,1
"593003394",19,2059.9556889973,1783.44474797325,2162.56636020013,7,12,1,1
"593003395",21,1887.19223851144,1840.25223260506,2207.26116887512,4,17,1,1
"593003396",14,2034.45228761881,1880.14464331172,2031.70713799962,4,10,1,1
"593003397",11,1896.97621257655,1837.10585737186,1933.98659929558,4,7,1,1
"593003398",10,1868.70330379259,1644.3860368753,1896.67490607898,3,7,1,1
"593003399",15,2070.52024183046,1951.31685562178,2060.56118614118,6,9,1,1
"593003400",18,1969.77257655354,1305.96794879734,2138.79896507223,5,13,1,1
"593003401",18,2031.3477313793,1964.642981009,2138.79896507223,5,13,1,1
"593003402",18,1930.10320132307,1725.85619466492,2138.79896507223,5,13,1,1
"593003403",13,1996.48686468998,1909.81213039679,2001.16379457045,4,9,1,1
"593003404",20,1969.77593422651,1618.0045137034,2185.35845629437,5,15,1,1
"593003405",18,2033.409233538,1852.37519363974,2138.79896507223,5,13,1,1
"593003406",16,2031.1157335249,1680.86473601592,2087.92318348224,5,11,1,1
"593003407",10,1969.9889185291,2070.26972609224,1896.67490607898,4,6,1,1
"593003408",15,1911.97489925675,1992.72017087901,2060.56118614118,4,11,1,1
"593003409",14,1942.83942765065,1774.02426101988,2031.70713799962,4,10,1,1
"593003410",5,1608.16461373379,1516.60468078159,1646.12614877363,1,4,1,1
"593003411",12,1890.98050601602,2021.49049297393,1968.69006049611,4,8,1,1
"593003412",10,1861.28360590645,1893.13737336892,1896.67490607898,4,6,1,1
"593003413",11,1884.9372661916,1943.40980482656,1933.98659929558,3,8,1,1
"593003415",13,1997.09002272507,1828.11027340461,2001.16379457045,5,8,1,1
"593003416",10,1865.04267968037,1693.46564494592,1896.67490607898,3,7,1,1
"593003417",12,2032.81999038331,1952.85109532777,1968.69006049611,5,7,1,1
"593003418",12,1937.43241736947,1949.29607849422,1968.69006049611,4,8,1,1
"593003419",12,1848.5006267704,1659.21318584237,1968.69006049611,3,9,1,1
"593003420",17,1930.62353632154,1798.68938591471,2113.95669457394,4,13,1,1
"593003421",9,1789.50933050387,1491.60725479948,1856.26587460569,2,7,1,1
"593003422",11,1957.46573401627,1985.20040467474,1933.98659929558,6,5,1,1
"593003423",21,2247.91745305084,2238.22482266359,2207.26116887512,9,12,1,1
"593003424",20,2301.68000487512,2332.28243018254,2185.35845629437,10,10,1,1
"593003425",15,2116.05777532133,2196.17119006133,2060.56118614118,10,5,1,1
"593003426",15,2100.07740942526,2035.29707571789,2060.56118614118,7,8,1,1
"593003427",9,1844.84191922719,1840.49603349988,1856.26587460569,4,5,1,1
"593003428",17,2125.30352758269,2193.98698428561,2113.95669457394,8,9,1,1
"593003429",25,2150.39757460685,2240.34522243051,2287.34065519221,8,17,1,1
"593003431",16,2094.78668564887,2175.98349490982,2087.92318348224,6,10,1,1
"593003432",12,1943.29918621866,1959.29908008516,1968.69006049611,6,6,1,1
"593003433",18,1923.40950724253,1778.63463672241,2138.79896507223,6,12,1,1
"593003434",22,2110.61106473479,1724.43553435844,2228.3491786518,8,14,1,1
"593003447",21,2240.58136130614,2043.16301606831,2207.26116887512,8,13,1,1
"593003448",26,2251.53002557583,2204.5790877419,2305.75108410937,12,14,1,1
"593003449",19,2168.35428719283,2184.36617938364,2162.56636020013,8,11,1,1
"593003454",26,2065.57954820137,1996.21070167659,2305.75108410937,11,15,1,1
"593003455",18,2138.1871063256,2109.33686204743,2138.79896507223,10,8,1,1
"593003456",13,2040.00619778406,2118.8824411166,2001.16379457045,6,7,1,1
"593003457",28,2374.78946978638,2410.83386858624,2340.94327947849,15,13,1,1
"593003464",18,2334.4183208199,2319.81301125058,2138.79896507223,11,7,1,1
"593003465",23,2391.73529137595,2548.64907826911,2248.68783741607,14,9,1,1
"593003466",23,2401.54216920161,2385.73841047018,2248.68783741607,12,11,1,1
"593003467",22,2240.13317399719,2338.39980488998,2228.3491786518,11,11,1,1
"593003468",23,2393.47027692408,2485.38114435983,2248.68783741607,12,11,1,1
"593003469",21,2342.992034631,2188.24427526944,2207.26116887512,11,10,1,1
"593003470",20,2352.15141362522,2308.69362367446,2185.35845629437,11,9,1,1
"593003471",23,2403.0581132811,2414.25776299405,2248.68783741607,12,11,1,1
"593003472",23,2170.55940957126,2362.14590735244,2248.68783741607,11,12,1,1
"593003473",27,2329.51846555075,2598.83704422859,2323.60649590586,17,10,1,1
"593003474",27,2312.27149420927,2469.99013356895,2323.60649590586,15,12,1,1
"593003475",23,2315.38316831879,2546.65780343158,2248.68783741607,13,10,1,1
"593003476",34,2331.44222881382,2814.94033308699,2435.71163614839,17,17,1,1
"593003478",15,2233.03569787869,2143.09870865882,2060.56118614118,5,10,1,1
"593003479",21,2405.06135717318,2545.52782002946,2207.26116887512,11,10,1,1
"593003482",17,2196.81081281427,2269.98758343228,2113.95669457394,6,11,1,1
"593003483",23,2261.91612913636,2647.75821908553,2248.68783741607,12,11,1,1
"593003484",18,2383.86845998563,2540.44840236488,2138.79896507223,7,11,1,1
"593003485",21,2148.25342970161,2091.36409902514,2207.26116887512,11,10,1,1
"593003487",18,2201.79783867646,2107.6361520694,2138.79896507223,9,9,1,1
"593003488",16,2087.87851623604,2101.18597524651,2087.92318348224,7,9,1,1
"593003490",22,2358.42138553151,2480.14052145482,2228.3491786518,10,12,1,1
"593003491",19,2190.29272476416,2134.88048919336,2162.56636020013,9,10,1,1
"593003492",17,2179.56229897191,2287.79924327303,2113.95669457394,10,7,1,1
"593003493",20,2380.14142871877,2573.11092293966,2185.35845629437,11,9,1,1
"593003494",22,2422.00227368772,2739.72695183631,2228.3491786518,12,10,1,1
"593003495",26,2112.6066468841,2036.43988270534,2305.75108410937,14,12,1,1
"593003496",17,1998.13009292036,1884.59025356767,2113.95669457394,9,8,1,1
"593003497",27,2153.44975090611,1836.65213272895,2323.60649590586,15,12,1,1
"593003498",18,2111.78182718583,1982.9509457387,2138.79896507223,9,9,1,1
"593003503",22,2227.31502263104,2142.5608454797,2228.3491786518,10,12,1,1
"593003505",16,2026.24779272014,1980.10506557693,2087.92318348224,7,9,1,1
"593003507",21,1996.92297959245,1733.53762967481,2207.26116887512,10,11,1,1
"593003508",12,1972.64326418567,1942.87623204199,1968.69006049611,5,7,1,1
"593003509",25,2176.89198023756,1790.11110764874,2287.34065519221,11,14,1,1
"593003510",15,2139.46565287206,1993.16956468581,2060.56118614118,8,7,1,1
"593003511",15,2248.02653570121,2084.58002144866,2060.56118614118,8,7,1,1
"593003512",16,2077.24374656199,1899.20645621625,2087.92318348224,8,8,1,1
"593003513",19,2090.71112081279,1990.15829155284,2162.56636020013,10,9,1,1
"593003514",23,2196.2528236628,2051.13853559644,2248.68783741607,11,12,1,1
"593003515",24,2258.61057057909,1982.50751007469,2268.33468283819,9,15,1,1
"593003516",13,2060.90392056512,2159.93038662136,2001.16379457045,7,6,1,1
"593003517",26,2069.54891523393,1790.09173485259,2305.75108410937,10,16,1,1
"593003518",16,2099.55531708028,2012.64442536413,2087.92318348224,7,9,1,1
"593003519",16,2086.98708393174,2072.86701649836,2087.92318348224,7,9,1,1
"593003520",25,2162.38265753077,2006.34373792671,2287.34065519221,11,14,1,1
"593003521",23,2109.22529959787,1952.11715498442,2248.68783741607,10,13,1,1
"593003522",23,2210.13677882468,1935.4102350106,2248.68783741607,9,14,1,1
"593003523",7,1717.30700238848,1735.56287934787,1763.32076508842,2,5,1,1
"6001977",23,1932.8611559621,1450.39033209936,2248.68783741607,3,20,1,1
"6001989",42,3017.37516191922,4421.81395629473,2543.21752514954,20,22,1,1
"6001993",18,1832.401587319,1591.01648121498,2138.79896507223,4,14,1,1
"6002003",28,2792.27718860694,3552.41823182189,2340.94327947849,17,11,1,1
"6002004",26,2499.72588019809,2766.33988893435,2305.75108410937,15,11,1,1
"6002009",15,1859.60753311404,1548.4407231773,2060.56118614118,1,14,1,1
"6002081",20,2264.2416459557,1986.66138325765,2185.35845629437,9,11,1,1
"6002082",22,2218.05240599652,1939.96350256473,2228.3491786518,11,11,1,1
"6002083",12,1842.86805034666,1911.9327731721,1968.69006049611,4,8,1,1
"6002084",11,1997.90617496502,2032.8746750964,1933.98659929558,6,5,1,1
"6002085",9,1874.45590346793,1922.40530730333,1856.26587460569,3,6,1,1
"6002108",47,3313.21153560477,4424.31677453994,2602.36394728806,25,22,1,1
"6002109",37,2931.04107222029,3557.49777820269,2478.17471526668,19,18,1,1
"6002110",25,2387.1168383293,2863.75153405995,2287.34065519221,15,10,1,1
"6002116",37,2576.8441238582,2643.50180585683,2478.17471526668,17,20,1,1
"6002117",37,2418.73586294559,2493.09501203936,2478.17471526668,24,13,1,1
"6002118",46,2627.71683546088,1935.02542457984,2590.94954296761,28,18,1,1
"6002119",23,2229.43031348111,1918.51100132877,2248.68783741607,13,10,1,1
"6002121",20,2112.44116335457,2061.38612375841,2185.35845629437,8,12,1,1
"6002122",32,2410.46673303082,2118.02333537175,2405.71569249515,19,13,1,1
"6002123",21,2014.06616084157,1973.43469084109,2207.26116887512,10,11,1,1
"6002124",32,2356.19995784493,1998.02888618418,2405.71569249515,20,12,1,1
"6002125",25,2270.13545157417,2071.87246449215,2287.34065519221,16,9,1,1
"6002126",28,2349.65090851192,2372.1379958726,2340.94327947849,19,9,1,1
"6002127",32,2414.37047229042,2240.78442067295,2405.71569249515,22,10,1,1
"6002128",22,1963.293204136,1710.0619519735,2228.3491786518,9,13,1,1
"6002129",23,1941.91334533838,1760.72495310186,2248.68783741607,10,13,1,1
"6002130",38,2387.66456495181,1764.02844412094,2491.71993967651,20,18,1,1
"6002131",32,2406.19798153381,1966.19745388529,2405.71569249515,17,15,1,1
"6002132",27,2158.40331761057,1932.25389876982,2323.60649590586,18,9,1,1
"6002133",35,2396.59905773859,1999.24893250034,2450.1860183293,18,17,1,1
"6002134",36,2621.99276763985,2298.44874512213,2464.33502634194,19,17,1,1
"6002135",34,2185.04026045151,1749.25832187593,2435.71163614839,18,16,1,1
"6002136",18,1957.04013090868,1691.00531053529,2138.79896507223,9,9,1,1
"6002137",18,1849.22118720321,1618.94602802356,2138.79896507223,8,10,1,1
"6002138",36,2325.30752341217,1823.63137217527,2464.33502634194,19,17,1,1
"6002139",35,2251.38785026342,1675.73530244602,2450.1860183293,19,16,1,1
"6002140",25,2201.79194944964,2174.04545627677,2287.34065519221,16,9,1,1
"6002141",23,1960.41264973666,2104.99859987903,2248.68783741607,12,11,1,1
"6002142",25,2268.06559336439,2022.31201294847,2287.34065519221,14,11,1,1
"6002143",34,2450.02245068727,2013.01564992454,2435.71163614839,19,15,1,1
"6002144",23,2057.62826523199,1770.97710914569,2248.68783741607,11,12,1,1
"6002145",16,1948.07273592582,1747.53589860147,2087.92318348224,6,10,1,1
"6002146",19,2052.29133696954,1787.48639472893,2162.56636020013,9,10,1,1
"6002147",30,2197.2320446932,1982.68153665384,2374.18906024059,17,13,1,1
"6002148",30,2017.22117290222,1726.22830767048,2374.18906024059,14,16,1,1
"6002154",26,2352.48644576318,2496.28506299349,2305.75108410937,17,9,1,1
"6002155",23,2383.18140390651,2514.33978224318,2248.68783741607,16,7,1,1
"6002156",23,2307.20142442168,2264.75568352449,2248.68783741607,14,9,1,1
"6002157",30,2552.36169366317,2796.50692226315,2374.18906024059,18,12,1,1
"6002158",16,2153.45306763437,2236.21068204697,2087.92318348224,8,8,1,1
"6002159",22,2336.36303962982,2203.33593999941,2228.3491786518,14,8,1,1
"6002160",21,2292.18176010137,2257.66596060052,2207.26116887512,11,10,1,1
"6002161",21,2263.04486790562,2178.54209537299,2207.26116887512,15,6,1,1
"6002162",23,2412.29771788303,2347.222946316,2248.68783741607,16,7,1,1
"6002163",13,1976.16162214672,1873.28745392506,2001.16379457045,8,5,1,1
"6002164",14,2154.63950571731,2102.7280713206,2031.70713799962,6,8,1,1
"6002165",50,3067.94145121164,3400.43994300488,2635.48551585152,28,22,1,1
"6002166",36,2832.25679795433,3567.67594428965,2464.33502634194,21,15,1,1
"6002167",39,3027.14811301169,3660.34990145352,2504.98447234734,19,20,1,1
"6002168",42,3196.64573605247,3370.65006463247,2543.21752514954,26,16,1,1
"6002169",40,2871.02027659377,3697.40291510361,2517.98110851286,19,21,1,1
"6002170",44,2981.66793871449,4113.15072443267,2567.51523707907,20,24,1,1
"6002171",37,3110.6722841166,4745.81025387774,2478.17471526668,19,18,1,1
"6002172",30,2604.81494936923,3259.936868594,2374.18906024059,15,15,1,1
"6002173",48,2762.99124623455,2095.71424691447,2613.58673801098,25,23,1,1
"6002174",67,3290.25503641079,3165.77733648921,2797.95380131742,33,34,1,1
"6002175",65,3184.37739700401,2803.26337350956,2780.67589681985,35,30,1,1
"6002176",58,2994.06059193279,2542.97936050975,2716.66249357165,29,29,1,1
"6002177",61,3399.92512889305,4341.18094361837,2744.81051624266,34,27,1,1
"6002178",59,3394.97177946043,4545.43068083893,2726.17127719361,30,29,1,1
"6002179",43,3107.28848950461,3219.62897748727,2555.47878346624,24,19,1,1
"6002180",40,3142.62283281789,4004.99002792112,2517.98110851286,22,18,1,1
"6002181",56,3141.59114811913,4579.42784495635,2697.24673169728,27,29,1,1
"6002182",31,2817.16632266192,3563.51819334334,2390.15469389133,17,14,1,1
"6002183",35,3030.53514380615,3401.39334046551,2450.1860183293,17,18,1,1
"6002184",45,3330.47500579827,4228.05660539416,2579.33597919865,20,25,1,1
"6002185",34,2494.17710566603,3420.54569512701,2435.71163614839,19,15,1,1
"6002186",33,2747.72588344987,3123.8554028001,2420.89448855093,18,15,1,1
"6002187",48,3091.79086970685,3527.39032061038,2613.58673801098,25,23,1,1
"6002188",40,3159.79620778671,3588.17666219625,2517.98110851286,22,18,1,1
"6002189",55,3406.20291477179,4262.06784199814,2687.33120998132,29,26,1,1
"6002190",35,2892.38733587077,3613.03658134561,2450.1860183293,19,16,1,1
"6002191",38,3125.83924631876,3670.65044274438,2491.71993967651,19,19,1,1
"6002192",39,2895.97800239033,3579.10937795537,2504.98447234734,24,15,1,1
"6002193",50,3110.35310529045,4015.85898584157,2635.48551585152,30,20,1,1
"6002228",38,2795.63697889331,2683.83083231266,2491.71993967651,18,20,1,1
"6002242",36,2661.53091954311,2878.09355329111,2464.33502634194,16,20,1,1
"6002243",38,2580.15587794759,2544.13198101399,2491.71993967651,20,18,1,1
"6002244",7,1776.14275922425,1865.31734661231,1763.32076508842,3,4,1,1
"6002245",8,1702.59427218793,1768.19197011106,1812.11073017574,3,5,1,1
"6002246",19,2168.82533713898,1977.23929567413,2162.56636020013,10,9,1,1
"6002247",13,1889.87259146477,1569.15486722826,2001.16379457045,7,6,1,1
"6002248",12,1931.92201617497,1756.95486891103,1968.69006049611,7,5,1,1
"6002255",12,1959.37250695072,1674.61297631534,1968.69006049611,6,6,1,1
"6002256",10,1835.70515536607,1516.84556190054,1896.67490607898,4,6,1,1
"6002258",22,1975.67152049115,1876.17929282143,2228.3491786518,8,14,1,1
"6002269",20,2106.40500501495,1916.72370725959,2185.35845629437,10,10,1,1
"6002270",17,2123.01027610073,1993.59791770668,2113.95669457394,6,11,1,1
"6002282",27,2397.72321999468,2072.79908273047,2323.60649590586,15,12,1,1
"6002289",24,1984.42442772789,1541.43201670757,2268.33468283819,9,15,1,1
"6002290",22,1801.38080959217,1390.66146375757,2228.3491786518,12,10,1,1
"6002291",8,1809.12375077361,1926.14086076712,1812.11073017574,5,3,1,1
"6002292",15,2034.68155719622,2097.60765951745,2060.56118614118,6,9,1,1
"6002293",12,2021.66050559941,2107.91447482555,1968.69006049611,5,7,1,1
"6002294",15,2150.75975892259,2263.40967399136,2060.56118614118,6,9,1,1
"6002295",21,2218.80105813998,2312.16568819718,2207.26116887512,7,14,1,1
"6002296",15,2027.43835126787,2016.84924543268,2060.56118614118,7,8,1,1
"6002297",31,2322.73676753839,2346.29375189327,2390.15469389133,10,21,1,1
"6002298",41,2142.13298515524,1569.16978751996,2530.72175773865,18,23,1,1
"6002299",36,2565.35241709383,2922.61608515168,2464.33502634194,16,20,1,1
"6002300",25,2530.78210892746,2581.24607218238,2287.34065519221,11,14,1,1
"6002301",28,2436.06565695169,2384.73793762982,2340.94327947849,9,19,1,1
"6002302",18,2118.25843517256,2075.11519116352,2138.79896507223,6,12,1,1
"6003293",66,3403.99434225514,3118.23687786744,2789.3669207067,29,37,1,1
"6003294",65,3506.59350043129,2651.46507616247,2780.67589681985,25,40,1,1
"6003295",77,3408.49523520377,2771.50040093825,2878.65357631343,29,48,1,1
"6003296",50,3181.90596180034,3364.10108722639,2635.48551585152,24,26,1,1
"6003297",68,3415.16281657134,3346.65160176247,2806.43931339586,27,41,1,1
"6003298",68,3576.48173382618,3771.40310947937,2806.43931339586,28,40,1,1
"6003299",64,3622.86214582054,3543.66615980791,2771.87783482774,21,43,1,1
"6003300",73,3184.46836498062,2942.65416202893,2847.4358582506,23,50,1,1
"6003302",53,3020.58861274977,2812.40991345445,2667.061866114,21,32,1,1
"6003303",55,3306.98128653887,3883.00026290655,2687.33120998132,24,31,1,1
"6003304",64,3319.54500645309,3262.17987641091,2771.87783482774,25,39,1,1
"6003757",50,3359.32942235651,2962.42441512293,2635.48551585152,20,30,1,1
"6003758",67,2913.74246342445,2824.58216887619,2797.95380131742,27,40,1,1
"62003086",79,4026.08235879878,4738.46364343151,2893.78092561085,38,41,1,1
"62003087",41,3249.30716176156,3642.77233825995,2530.72175773865,16,25,1,1
"62003088",53,3608.71286476177,4177.49427195725,2667.061866114,22,31,1,1
"62003089",59,3589.53978249344,3947.81307045684,2726.17127719361,25,34,1,1
"62003090",57,3368.20820186958,3493.03275382097,2707.02236739438,23,34,1,1
"62003091",36,2542.74095610706,2425.43531754336,2464.33502634194,22,14,1,1
"62003092",45,3046.86999162396,2776.14995538277,2579.33597919865,16,29,1,1
"62003093",62,3366.96536696691,3333.88550687385,2753.94837323248,23,39,1,1
"62003094",48,3448.66473115039,4070.6034216093,2613.58673801098,20,28,1,1
"62003095",59,3461.25522571016,4613.02596596028,2726.17127719361,26,33,1,1
"62003096",50,3464.59027738875,3672.80370751349,2635.48551585152,21,29,1,1
"62003097",68,3623.00880448611,3594.22508648618,2806.43931339586,34,34,1,1
"62003098",55,3607.15924914863,3757.12978658858,2687.33120998132,22,33,1,1
"62003099",38,2879.64669763355,2922.68884713774,2491.71993967651,13,25,1,1
"62003100",47,2579.27867382896,2076.98859998399,2602.36394728806,18,29,1,1
"62003101",66,3568.95953033727,4561.0274865367,2789.3669207067,28,38,1,1
"62003102",68,3960.16760677183,4086.34649547283,2806.43931339586,28,40,1,1
"62003103",71,3938.39334791255,3865.31745982151,2831.31372136695,28,43,1,1
"62003104",68,3601.8255877694,3086.65026670118,2806.43931339586,24,44,1,1
"62003105",51,3224.45386717523,2959.13282863301,2646.17454577679,21,30,1,1
"62003106",65,3725.2720396584,4291.78266302429,2780.67589681985,25,40,1,1
"62003107",95,4453.04623114744,3704.60302455786,3004.94950458202,40,55,1,1
"62003108",67,3985.20254884791,3291.85431330533,2797.95380131742,30,37,1,1
"62003109",67,3839.32538213168,4511.37100726773,2797.95380131742,29,38,1,1
"62003110",59,3488.57050420496,3500.63094396055,2726.17127719361,26,33,1,1
"62003111",76,3798.82625174202,4336.43566659038,2870.97236507783,28,48,1,1
"62003112",65,4011.91777989463,3708.83189991731,2780.67589681985,28,37,1,1
"62003113",61,3660.6870350389,4055.59444477021,2744.81051624266,25,36,1,1
"62003114",85,3937.32440582743,4421.94524235199,2937.40494579778,30,55,1,1
"62003115",73,3978.77198984793,3866.89196815735,2847.4358582506,24,49,1,1
"62003116",59,2804.94030282795,2563.11723586924,2726.17127719361,27,32,1,1
"62003117",68,3371.41373982214,3376.26234224643,2806.43931339586,40,28,1,1
"62003118",63,3179.32825262469,3218.84960703851,2762.96971264875,33,30,1,1
"62003119",76,3360.88339913969,3413.43763831156,2870.97236507783,32,44,1,1
"62003120",57,2903.93139759955,2486.36459214348,2707.02236739438,27,30,1,1
"62003121",83,3314.43401515769,3254.0298884837,2923.1438046077,36,47,1,1
"62003122",87,3364.08079425035,2895.3841093731,2951.40156710974,39,48,1,1
"62003123",67,3023.50344918032,2483.58995920156,2797.95380131742,29,38,1,1
"62003124",78,3693.28291247047,3672.68179712282,2886.25582696583,31,47,1,1
"62003125",68,3348.82124779088,3523.49818915481,2806.43931339586,28,40,1,1
"62003126",97,4444.58914938679,4479.7323550824,3017.77317381863,36,61,1,1
"62003713",45,3467.76740928201,4162.45381500029,2579.33597919865,21,24,1,1
"62003714",66,3782.86381448486,4632.60347058109,2789.3669207067,29,37,1,1
"62003715",50,3306.45758987587,4129.31971705284,2635.48551585152,19,31,1,1
"62003716",51,3599.47711088975,3863.66511450974,2646.17454577679,22,29,1,1
"62003717",67,3977.82396128507,4001.27534755296,2797.95380131742,29,38,1,1
"62003718",57,3218.86471483032,2600.11195448852,2707.02236739438,24,33,1,1
"62003719",52,3536.32269480789,4498.58971349088,2656.6981055205,21,31,1,1
"62003720",64,4131.71194671171,4965.95442607458,2771.87783482774,26,38,1,1
"62003721",70,3960.56189661136,3711.44997245564,2823.11677003184,26,44,1,1
"62003722",80,3958.42461766957,3997.72300323918,2901.2306171403,30,50,1,1
"62003723",73,3933.31519093843,4371.10554022023,2847.4358582506,35,38,1,1
"62003724",82,3687.65214389726,4067.89181391331,2915.91045786314,30,52,1,1
"62003725",56,3130.07341092817,2971.73420657577,2697.24673169728,23,33,1,1
"62003726",69,3758.53778578596,4753.4605689683,2814.82611826518,28,41,1,1
"62003727",35,2780.33670976102,3385.33692277155,2450.1860183293,12,23,1,1
"62003728",59,3453.16792125105,3315.22537204599,2726.17127719361,23,36,1,1
"62003729",68,4154.20559284316,4753.17520996603,2806.43931339586,28,40,1,1
"62003730",71,3727.49785229665,4786.44046463388,2831.31372136695,29,42,1,1
"62003731",79,3980.98421050891,3598.89271781332,2893.78092561085,29,50,1,1
"62003732",61,3890.10489681608,3744.75856734865,2744.81051624266,25,36,1,1
"62003733",65,3541.80277254555,3323.77612721615,2780.67589681985,25,40,1,1
"62003737",67,3144.21930579822,3582.88340072172,2797.95380131742,33,34,1,1
"676003239",52,3281.67017897783,3934.68080189214,2656.6981055205,25,27,1,1
"676003240",54,3488.05805665538,4336.36656678245,2677.2712016452,27,27,1,1
"676003241",38,3105.35216347802,3686.78762698096,2491.71993967651,16,22,1,1
"676003242",45,3418.58237414904,3789.08954183707,2579.33597919865,18,27,1,1
"676003243",69,3854.06632336336,4863.92851684754,2814.82611826518,32,37,1,1
"676003244",57,3496.88545341388,4026.99575005771,2707.02236739438,26,31,1,1
"676003245",56,3215.60432150695,3153.3009482478,2697.24673169728,29,27,1,1
"676003247",51,3260.75384398381,3840.56209123983,2646.17454577679,25,26,1,1
"676003248",45,3393.65727403544,3692.65677002219,2579.33597919865,22,23,1,1
"676003249",40,3054.6758364013,3343.83653839346,2517.98110851286,18,22,1,1
"676003250",60,3664.2185911321,4245.11415244412,2735.5526890818,27,33,1,1
"676003251",50,3449.62911038396,4297.62797285046,2635.48551585152,26,24,1,1
"676003252",60,3651.59688971007,3784.23021022474,2735.5526890818,35,25,1,1
"676003741",39,3299.43797997886,3986.18154489449,2504.98447234734,17,22,1,1
"676003742",39,3055.79324217479,3123.37391604839,2504.98447234734,15,24,1,1
"682002937",56,3900.10727718688,4057.45387032184,2697.24673169728,24,32,1,1
"682002938",44,3144.53126074105,3586.00325372242,2567.51523707907,18,26,1,1
"682002939",39,2500.97078759007,2218.76338800178,2504.98447234734,17,22,1,1
"682002940",56,3385.90194758873,3847.54361348428,2697.24673169728,24,32,1,1
"683003147",44,3110.46999509158,4088.56789175176,2567.51523707907,18,26,1,1
"683003148",43,3153.17894835323,3666.69392961548,2555.47878346624,17,26,1,1
"683003149",38,2759.40224505798,2724.13698035239,2491.71993967651,11,27,1,1
"683003150",55,3143.43985497312,3843.06908787657,2687.33120998132,20,35,1,1
"683003151",38,3078.8838384576,3331.26917606171,2491.71993967651,13,25,1,1
"683003152",40,3223.98268418135,3454.56627778642,2517.98110851286,13,27,1,1
"683003153",34,3047.81945643908,3619.82830044352,2435.71163614839,10,24,1,1
"683003932",31,2498.07229150259,2690.04211144869,2390.15469389133,10,21,1,1
"683003933",31,2790.85513064437,3052.83401043807,2390.15469389133,11,20,1,1
"683003934",36,2861.20729414165,3360.84478080561,2464.33502634194,14,22,1,1
"689003033",43,2786.5248510059,2924.36079436979,2555.47878346624,14,29,1,1
"689003034",40,2415.12112416231,2133.93844883288,2517.98110851286,15,25,1,1
"689003035",44,2706.83823225042,2866.47826130429,2567.51523707907,15,29,1,1
"689003036",49,2918.9208097202,3162.57841501205,2624.62502504328,20,29,1,1
"689003037",47,3076.46099692949,3477.91852295783,2602.36394728806,16,31,1,1
"689003038",39,2625.06062681123,2888.51346351915,2504.98447234734,16,23,1,1
"689003039",40,2740.45388569813,3137.64524456136,2517.98110851286,15,25,1,1
"689003040",61,3691.37297876637,4279.29122398946,2744.81051624266,31,30,1,1
"689003041",68,2964.30522839629,2513.82355467599,2806.43931339586,27,41,1,1
"689003042",36,2956.10850322311,3197.73888286672,2464.33502634194,19,17,1,1
"689003043",63,3148.01945661437,3496.0998156223,2762.96971264875,27,36,1,1
"689003044",55,3093.30424861105,4031.80743129767,2687.33120998132,27,28,1,1
"689003045",33,2913.27953316992,3267.97130009509,2420.89448855093,22,11,1,1
"689003046",41,3050.38810229141,2599.28088227526,2530.72175773865,24,17,1,1
"689003047",37,3145.20471355402,3455.68655694153,2478.17471526668,21,16,1,1
"689003048",52,3406.20084886706,4637.64484996118,2656.6981055205,26,26,1,1
"689003049",50,3384.07478449267,3751.85726148856,2635.48551585152,26,24,1,1
"689003050",49,3276.03245603651,3216.19850804725,2624.62502504328,20,29,1,1
"689003051",63,3192.19598566581,4069.14701486776,2762.96971264875,25,38,1,1
"689003052",43,3466.43258581256,3502.73518877807,2555.47878346624,17,26,1,1
"689003053",70,3392.94425307173,3397.64477695901,2823.11677003184,31,39,1,1
"689003054",51,3141.85011198791,3142.96934632809,2646.17454577679,26,25,1,1
"689003055",50,3593.23693881859,4107.856204449,2635.48551585152,23,27,1,1
"689003056",41,3639.98197570323,3890.41511279334,2530.72175773865,22,19,1,1
"689003058",43,3372.27255367986,3922.81084673556,2555.47878346624,18,25,1,1
"689003059",45,3267.39519160934,4474.26585677511,2579.33597919865,19,26,1,1
"689003060",53,3558.29613761646,4008.90091785473,2667.061866114,22,31,1,1
"689003061",32,2678.8752821086,3308.24119212488,2405.71569249515,19,13,1,1
"689003735",39,2690.70879714123,2686.64780186649,2504.98447234734,12,27,1,1
"689003736",40,2843.70626672025,3654.1187659455,2517.98110851286,16,24,1,1
"689003738",35,3299.57087630632,3913.96508115433,2450.1860183293,15,20,1,1
"689003739",49,3331.07653989845,3276.09764290895,2624.62502504328,23,26,1,1
"8000649",9,1872.09216936193,1903.11390645989,1856.26587460569,2,7,1,1
"8000650",8,1896.00678019094,1942.53952974025,1812.11073017574,2,6,1,1
"8000651",10,1935.26718350412,2084.97954763482,1896.67490607898,4,6,1,1
"8000653",11,1960.88977305857,1977.80818344445,1933.98659929558,5,6,1,1
"8000654",8,1766.00019429054,1877.13919978152,1812.11073017574,2,6,1,1
"8000655",10,1993.55508677522,2005.52992843973,1896.67490607898,4,6,1,1
"8000656",14,2106.05711516883,2175.21589434259,2031.70713799962,8,6,1,1
"8000657",14,2197.24904809931,2319.95792375016,2031.70713799962,7,7,1,1
"8000658",18,2226.38900629998,2438.95561711366,2138.79896507223,7,11,1,1
"8000659",6,1734.52366992436,1808.77043518485,1708.62817714657,2,4,1,1
"8000660",19,2124.99744343376,2165.03596017634,2162.56636020013,6,13,1,1
"8000661",41,2972.63341171012,3875.08124712098,2530.72175773865,14,27,1,1
"8000662",47,3309.62030195875,4214.11988597339,2602.36394728806,17,30,1,1
"8000663",45,3072.88206648023,3401.28917786609,2579.33597919865,20,25,1,1
"8000664",15,2166.33078868361,2251.75408820188,2060.56118614118,7,8,1,1
"8000665",16,2147.64666494309,2293.31880174139,2087.92318348224,8,8,1,1
"8000666",10,2003.80848843157,2009.51259390035,1896.67490607898,5,5,1,1
"8000669",2,1374.4644476772,1375.40364453026,1364.97646362037,0,2,1,1
"8000670",6,1757.020925796,1791.47339192606,1708.62817714657,3,3,1,1
"8000671",10,1840.01413703554,1963.85597851322,1896.67490607898,3,7,1,1
"8000672",17,2201.99196083194,2064.61360061012,2113.95669457394,5,12,1,1
"8000673",6,1821.45489705406,1781.40963034242,1708.62817714657,2,4,1,1
"8000674",11,2059.43463512541,2165.99960250791,1933.98659929558,3,8,1,1
"8000675",10,2007.58381440615,1973.0850437478,1896.67490607898,6,4,1,1
"855003140",37,2257.27304177652,1579.54900412581,2478.17471526668,15,22,1,1
"855003141",25,2196.58438605768,2291.81710946257,2287.34065519221,10,15,1,1
"855003142",29,2519.95854419654,2326.63364577172,2357.79423966008,13,16,1,1
"855003143",28,2364.21429739715,2568.62406343656,2340.94327947849,10,18,1,1
"855003144",25,2317.45011236705,2346.18174931901,2287.34065519221,10,15,1,1
"855003145",28,2414.85388254319,2365.5675514353,2340.94327947849,13,15,1,1
"855003146",22,2158.29348196757,2095.06165833046,2228.3491786518,10,12,1,1
"912340011",48,3031.47945596873,2871.60105649965,2613.58673801098,29,19,1,1
"912340012",48,2970.1914931428,2710.46876159494,2613.58673801098,32,16,1,1
"912340013",61,2961.3079495576,2548.81401370829,2744.81051624266,27,34,1,1
"912340014",40,2730.40144748385,2418.56189163302,2517.98110851286,19,21,1,1
"912340015",51,2641.25726083245,2596.03590737414,2646.17454577679,24,27,1,1
"912340016",45,2752.29597188839,3126.33640454479,2579.33597919865,21,24,1,1
"912340017",49,2751.6486503139,2868.25664087507,2624.62502504328,20,29,1,1
"912340018",55,3202.28060632198,3670.66736783642,2687.33120998132,27,28,1,1
"912340019",50,3255.62940152682,3889.47110049642,2635.48551585152,30,20,1,1
"912340020",68,3748.02335106062,2844.61924617678,2806.43931339586,38,30,1,1
"912340021",63,3308.15931734609,3260.9891696715,2762.96971264875,36,27,1,1
"912340022",54,3223.86179938226,2909.60414827592,2677.2712016452,31,23,1,1
"912340023",39,2589.76515593888,2025.7788535334,2504.98447234734,18,21,1,1
"912340024",46,3002.14783168242,2786.32206915687,2590.94954296761,25,21,1,1
"912340025",64,3367.0786840449,3607.81185323076,2771.87783482774,34,30,1,1
"912340026",47,2962.58487664829,2652.9642374186,2602.36394728806,32,15,1,1
"912340027",62,3389.57247693397,3710.55253938195,2753.94837323248,34,28,1,1
"912340028",55,3191.69122855355,3344.02730856466,2687.33120998132,29,26,1,1
"912340029",39,2939.66914776256,2716.50141822453,2504.98447234734,22,17,1,1
"912340030",51,3385.18158840172,3202.19148871184,2646.17454577679,29,22,1,1
"912340031",30,2587.5369732613,2386.85336510208,2374.18906024059,11,19,1,1
"912340032",52,2891.87985027962,2772.80809652498,2656.6981055205,23,29,1,1
"912340033",59,3088.43824744057,3514.15413487109,2726.17127719361,34,25,1,1
"912340034",58,3374.32208009039,3419.00409384323,2716.66249357165,35,23,1,1
"912340035",40,3017.94582017637,2835.72836787917,2517.98110851286,23,17,1,1
"912340036",32,2621.36304625711,2627.29198385731,2405.71569249515,17,15,1,1
"912340295",32,2573.61132001012,2788.75656452004,2405.71569249515,14,18,1,1
"912340357",56,3465.09612546187,4050.83604005751,2697.24673169728,17,39,1,1
"912340358",7,1786.97066048386,1802.81813041559,1763.32076508842,5,2,1,1
"912340359",16,1907.61156029663,1788.33601992428,2087.92318348224,3,13,1,1
"912340360",59,3966.99024135501,5448.26409001929,2726.17127719361,21,38,1,1
"912340361",68,4501.28324997791,4965.34027988371,2806.43931339586,23,45,1,1
"912340362",69,4580.94121601866,5785.53819967209,2814.82611826518,25,44,1,1
"912340363",70,4113.89686429657,5393.03029994464,2823.11677003184,24,46,1,1
"912340364",75,4094.5524738392,5393.17709982938,2863.21031780169,28,47,1,1
"912340366",70,4079.5666943808,6862.73162685998,2823.11677003184,26,44,1,1
"912340367",69,4189.3236748983,5007.47927854077,2814.82611826518,26,43,1,1
"912340368",64,4328.28251438816,4956.08640531526,2771.87783482774,22,42,1,1
"912340369",54,3476.11322826367,4318.97795227612,2677.2712016452,18,36,1,1
"912340370",59,4055.85311150291,3897.33843207055,2726.17127719361,24,35,1,1
"912340371",57,4059.16002989936,6263.46950683637,2707.02236739438,17,40,1,1
"912340372",48,3383.50717914853,3782.10276812103,2613.58673801098,15,33,1,1
"912340373",52,3393.47205342043,3433.28154957689,2656.6981055205,19,33,1,1
"912340374",46,3432.34039144069,3496.84949074973,2590.94954296761,15,31,1,1
"912340375",59,3798.31082067962,4824.2815720898,2726.17127719361,21,38,1,1
"912340376",49,3440.55289527358,3692.60395660971,2624.62502504328,20,29,1,1
"912340377",65,3727.0227192603,3888.59120017678,2780.67589681985,24,41,1,1
"912340378",50,3615.11828950966,3582.50777959883,2635.48551585152,16,34,1,1
"912340379",59,3574.15501561674,3749.2231290669,2726.17127719361,19,40,1,1
"912340380",47,2923.60607787952,2866.55297122727,2602.36394728806,12,35,1,1
"912340381",54,3567.78563104022,3908.15802854158,2677.2712016452,17,37,1,1
"912340382",67,3297.27640696509,3734.75996672638,2797.95380131742,21,46,1,1
"912340383",57,3336.91705167476,3999.68808074489,2707.02236739438,20,37,1,1
"912340384",47,3549.12343055613,4155.38144459462,2602.36394728806,14,33,1,1
"912340385",45,3082.25891882092,3094.55998379134,2579.33597919865,21,24,1,1
"912340386",45,3111.24597754639,3257.57615651204,2579.33597919865,13,32,1,1
"912340387",48,3691.49597313164,4089.00356565908,2613.58673801098,13,35,1,1
"912340388",31,2976.6126219138,3112.52275647254,2390.15469389133,10,21,1,1
"912340389",37,3194.24151527573,3472.27075935354,2478.17471526668,15,22,1,1
"912340390",43,2870.41667082295,3492.6852282372,2555.47878346624,16,27,1,1
"912340391",65,3021.39757269535,2894.88457291552,2780.67589681985,26,39,1,1
"912340392",34,3033.08692745041,3144.64214760649,2435.71163614839,12,22,1,1
"912340393",71,3019.35841534378,3578.7707051234,2831.31372136695,32,39,1,1
"912340394",39,2758.51213856329,2401.5691473646,2504.98447234734,21,18,1,1
"912340395",32,2431.98007094089,2332.3160620017,2405.71569249515,12,20,1,1
"912340396",36,2621.58235119146,2022.72623396017,2464.33502634194,18,18,1,1
"912340397",42,2499.42653880351,2084.05840294202,2543.21752514954,23,19,1,1
"912340398",37,2600.50544162554,2385.06990296554,2478.17471526668,18,19,1,1
"912340399",35,2635.85270469435,2533.04771380612,2450.1860183293,17,18,1,1
"912340400",36,2675.13042624084,2258.57691188492,2464.33502634194,16,20,1,1
"912340401",30,2455.47873364601,2312.22502864453,2374.18906024059,18,12,1,1
"912340402",33,2547.24465026541,2450.57172753363,2420.89448855093,17,16,1,1
"912340403",36,2416.11459549973,2656.16622257032,2464.33502634194,19,17,1,1
"912340404",28,2374.51938524588,2410.3975584297,2340.94327947849,16,12,1,1
"912340405",39,2671.2274900451,2660.03817098713,2504.98447234734,17,22,1,1
"912340406",31,2444.31883779877,2479.40904420778,2390.15469389133,16,15,1,1
"912340407",33,2555.89318426359,2559.96213729457,2420.89448855093,16,17,1,1
"912340408",11,1858.67568612383,2167.1491679068,1933.98659929558,2,9,1,1
"912340414",10,1792.32851218022,1762.23524780872,1896.67490607898,1,9,1,1
"912340415",8,1828.37263155951,2110.52867175818,1812.11073017574,2,6,1,1
"912340416",8,1813.92146440574,2002.90901097325,1812.11073017574,1,7,1,1
"912340417",9,1806.20923724585,1963.62722335222,1856.26587460569,1,8,1,1
"912340418",10,1775.97608592176,1696.54058814901,1896.67490607898,2,8,1,1
"912340419",9,1783.18260691335,1623.75977523952,1856.26587460569,1,8,1,1
"912340420",9,1799.44271313308,1651.78463008677,1856.26587460569,2,7,1,1
"912340421",10,1858.51642192585,1753.09092495125,1896.67490607898,1,9,1,1
"912340422",11,1786.50732124788,1804.25977750377,1933.98659929558,1,10,1,1
"912340423",10,1879.57697684135,2140.78931278698,1896.67490607898,1,9,1,1
"912340424",9,1764.39703108683,1573.87710662355,1856.26587460569,2,7,1,1
"912340425",16,1866.70717171187,1707.65980888043,2087.92318348224,5,11,1,1
"912340426",12,1827.82659095545,1888.72611906863,1968.69006049611,1,11,1,1
"912340427",11,1833.60224082751,1633.55217159711,1933.98659929558,1,10,1,1
"912340428",13,1839.95575657642,1795.16633813385,2001.16379457045,3,10,1,1
"912340429",8,1792.87928012926,1562.2460998729,1812.11073017574,1,7,1,1
"912340430",6,1727.90176575961,2009.79509721205,1708.62817714657,0,6,1,1
"912340431",7,1670.25370547949,1774.2835868204,1763.32076508842,1,6,1,1
"912340432",8,1828.23319810744,1971.36190525478,1812.11073017574,1,7,1,1
"912340433",13,1776.41106726051,1688.22864185361,2001.16379457045,3,10,1,1
"912340434",10,1762.59828591475,1676.46775525379,1896.67490607898,2,8,1,1
"912340435",7,1710.388859067,1600.17131549001,1763.32076508842,1,6,1,1
"912340436",7,1747.99177743485,1974.7395008018,1763.32076508842,0,7,1,1
"912340437",7,1762.53363910924,2089.40324417947,1763.32076508842,0,7,1,1
"912340438",8,1802.30825496349,2061.51351255099,1812.11073017574,2,6,1,1
"912340439",8,1782.05443895535,2039.79149367984,1812.11073017574,0,8,1,1
"912340440",10,1798.43237726157,1603.6110708621,1896.67490607898,1,9,1,1
"912340441",7,1733.52698460885,1901.39693684677,1763.32076508842,2,5,1,1
"912340442",8,1859.25827289447,2022.8155690052,1812.11073017574,0,8,1,1
"912340443",15,1970.91554264458,2108.27591107,2060.56118614118,3,12,1,1
"912340444",8,1622.69583794002,1281.68612633888,1812.11073017574,2,6,1,1
"912340445",8,1785.68897824697,1629.52401148921,1812.11073017574,1,7,1,1
"912340559",62,3246.00939222947,4570.63215306391,2753.94837323248,34,28,1,1
"912340560",48,3186.86589942467,4286.45560764611,2613.58673801098,29,19,1,1
"912340561",35,2830.17768530703,3031.39187255559,2450.1860183293,16,19,1,1
"912340562",43,3031.71695117256,4053.35945186765,2555.47878346624,19,24,1,1
"912340563",51,3141.02092923401,3715.00564742886,2646.17454577679,26,25,1,1
"912340564",32,3014.01153071098,3710.73835660513,2405.71569249515,15,17,1,1
"912340565",34,2925.69911816496,4090.11444193495,2435.71163614839,21,13,1,1
"912340566",29,2684.54767232378,3357.65919781089,2357.79423966008,13,16,1,1
"912340567",34,2705.32970110068,3491.42584916205,2435.71163614839,19,15,1,1
"912340568",30,2598.54053559921,3471.26378242261,2374.18906024059,18,12,1,1
"912340569",34,3032.66040762431,3624.07195028814,2435.71163614839,20,14,1,1
"912340570",38,2881.07330043969,3544.12806785289,2491.71993967651,23,15,1,1
"912340571",40,2967.18063020048,3717.28309506285,2517.98110851286,20,20,1,1
"912340572",37,2793.83389619034,3771.3870612071,2478.17471526668,24,13,1,1
"912340573",33,2703.09807025879,3659.95638269743,2420.89448855093,16,17,1,1
"912340574",55,3495.61488236287,4587.41937157023,2687.33120998132,26,29,1,1
"912340575",64,3800.9167529189,4508.85470140909,2771.87783482774,33,31,1,1
"912340576",51,3386.23024011257,4452.05496014922,2646.17454577679,30,21,1,1
"912340577",47,3123.67110417507,4087.77196839679,2602.36394728806,24,23,1,1
"912340578",45,2928.24890349119,3093.80645020693,2579.33597919865,26,19,1,1
"912340579",43,2643.85189811742,2691.6827707862,2555.47878346624,22,21,1,1
"912340580",40,2831.14593803398,2973.22140135295,2517.98110851286,24,16,1,1
"912340581",39,2807.43392927748,3360.01438483534,2504.98447234734,22,17,1,1
"912340582",36,3094.78091123944,3644.87032163841,2464.33502634194,17,19,1,1
"912340583",56,3464.10990089862,4559.15835699313,2697.24673169728,33,23,1,1
"912340584",43,3051.49173100573,3724.32118166909,2555.47878346624,25,18,1,1
"912340585",41,3007.91413703204,3810.42295043464,2530.72175773865,19,22,1,1
"912340586",47,3091.22940749925,4053.25284740226,2602.36394728806,24,23,1,1
"912340587",42,3229.01573503343,4167.838468717,2543.21752514954,25,17,1,1
"912340588",37,3045.53592260789,3386.46330319936,2478.17471526668,19,18,1,1
"912340589",43,3207.74675122464,3918.27112305112,2555.47878346624,24,19,1,1
"912340590",42,3091.15076719048,4259.06717184282,2543.21752514954,21,21,1,1
"912340591",45,2843.00901060745,3770.27719741635,2579.33597919865,25,20,1,1
"912340592",23,2439.55127411918,2604.89553570886,2248.68783741607,15,8,1,1
"912340593",28,2233.24328391495,2249.83229201818,2340.94327947849,15,13,1,1
"912340594",42,2966.07176691248,2789.65955605843,2543.21752514954,19,23,1,1
"912340595",40,2661.37831816605,2413.19064230486,2517.98110851286,19,21,1,1
"912340596",41,2868.8383639966,2723.9045800269,2530.72175773865,21,20,1,1
"912340597",41,2816.96430083709,3171.51773749839,2530.72175773865,21,20,1,1
"912340598",32,2654.244006226,3117.76918247366,2405.71569249515,17,15,1,1
"912340599",34,2652.22967658063,2953.64164671524,2435.71163614839,15,19,1,1
"912340600",28,2459.04564828111,2997.18012142868,2340.94327947849,12,16,1,1
"912340601",25,2402.89058639869,2700.22520252756,2287.34065519221,11,14,1,1
"912340602",37,2706.75473414293,3086.51222627521,2478.17471526668,21,16,1,1
"912340603",51,2684.03766048343,2625.98310694804,2646.17454577679,26,25,1,1
"912340604",53,3425.95285393593,4282.18518397686,2667.061866114,26,27,1,1
"912340605",52,3443.49862263774,4655.16115658851,2656.6981055205,27,25,1,1
"912340606",38,2745.14620687956,3483.46065929306,2491.71993967651,19,19,1,1
"912340607",38,2789.63334254537,3480.95925000064,2491.71993967651,21,17,1,1
"912340608",37,2543.96808011737,2602.05670814378,2478.17471526668,25,12,1,1
"912340609",33,2573.99344421124,2672.98017554314,2420.89448855093,20,13,1,1
"912340610",39,2808.66240536926,2967.67133194941,2504.98447234734,20,19,1,1
"912340611",49,3150.49232886762,3675.27419666911,2624.62502504328,30,19,1,1
"912341092",54,3299.46845811187,3997.6176680068,2677.2712016452,24,30,1,1
"912341093",39,2998.5862553576,3377.89971128711,2504.98447234734,18,21,1,1
"912341094",44,3179.36229815756,3667.14338852242,2567.51523707907,17,27,1,1
"912341095",29,2542.35460594862,2725.85169222679,2357.79423966008,10,19,1,1
"912341096",51,2760.68756852806,2570.51859149754,2646.17454577679,19,32,1,1
"912341097",38,2459.77120440468,2561.86561578792,2491.71993967651,11,27,1,1
"912341098",45,2500.70480257315,2593.54650440382,2579.33597919865,14,31,1,1
"912341099",17,2280.81720558265,2512.83893536404,2113.95669457394,8,9,1,1
"912341100",29,2627.26045135418,3031.31058591172,2357.79423966008,13,16,1,1
"912341101",35,2643.09215873515,2979.09453151765,2450.1860183293,15,20,1,1
"912341102",38,2709.97672705101,2838.8774054687,2491.71993967651,13,25,1,1
"912341103",34,2530.22142607752,2798.27954238382,2435.71163614839,16,18,1,1
"912341104",32,2434.83177453261,2623.19344306543,2405.71569249515,14,18,1,1
"912341105",32,2451.35108607337,2739.61868756476,2405.71569249515,12,20,1,1
"912341106",33,2257.22864089361,2168.26273105757,2420.89448855093,13,20,1,1
"912341107",36,2855.74328169903,3331.61430484867,2464.33502634194,14,22,1,1
"912341108",33,2876.2106963734,3004.49226554634,2420.89448855093,12,21,1,1
"912341109",26,2613.82986329022,2757.79279799901,2305.75108410937,10,16,1,1
"912341110",41,3201.34356814515,3685.74673166531,2530.72175773865,17,24,1,1
"912341111",47,3204.03040287554,4375.70545959937,2602.36394728806,16,31,1,1
"912341112",38,2777.94193697468,2966.83280764747,2491.71993967651,11,27,1,1
"912341113",34,2584.44760150616,2807.0071525599,2435.71163614839,14,20,1,1
"912341114",43,3080.60996823335,3828.71188543549,2555.47878346624,16,27,1,1
"912341115",43,3139.81789682972,3697.60670565795,2555.47878346624,22,21,1,1
"912341116",35,2647.92135947645,2690.75942544985,2450.1860183293,19,16,1,1
"912341117",30,2654.58997947302,3008.46347156969,2374.18906024059,15,15,1,1
"912341118",28,2768.91596863024,2786.65608481574,2340.94327947849,15,13,1,1
"912341119",31,2709.67647992628,2974.31888706257,2390.15469389133,15,16,1,1
"912341120",33,2901.36557903745,3226.33203678855,2420.89448855093,17,16,1,1
"912341121",40,2738.74055974109,3001.47207478891,2517.98110851286,14,26,1,1
"912341122",34,2647.45368054246,2331.16105023283,2435.71163614839,14,20,1,1
"912341123",38,2748.47948009539,3141.79561972663,2491.71993967651,17,21,1,1
"912341124",32,2592.57358407976,3065.29341312733,2405.71569249515,14,18,1,1
"912341125",40,3057.5903640927,4081.46971198885,2517.98110851286,18,22,1,1
"912341126",50,3092.64740457201,3571.66588176569,2635.48551585152,18,32,1,1
"912341127",38,2791.92658150161,3548.81134388123,2491.71993967651,16,22,1,1
"912341128",39,2914.32887330195,3398.75839154104,2504.98447234734,15,24,1,1
"912341129",40,2843.4663543612,3634.97514175394,2517.98110851286,14,26,1,1
"912341130",43,2661.69652289648,3072.607307222,2555.47878346624,16,27,1,1
"912341131",29,2709.39843219266,3014.65712386857,2357.79423966008,12,17,1,1
"912341132",31,2838.62430514298,2849.3452312272,2390.15469389133,11,20,1,1
"912341133",44,2713.58767993214,2792.41863468358,2567.51523707907,15,29,1,1
"912341134",23,2428.03377607237,2230.2068358018,2248.68783741607,4,19,1,1
"912341135",35,2835.23951546799,3259.85617383846,2450.1860183293,13,22,1,1
"912341136",32,2675.72593106825,2946.10060831975,2405.71569249515,12,20,1,1
"912341137",39,2732.36697827674,3186.50191148466,2504.98447234734,17,22,1,1
"912341138",17,2193.0797002562,2310.71901482675,2113.95669457394,3,14,1,1
"912341139",39,2651.54154268233,3093.38723063062,2504.98447234734,18,21,1,1
"912341140",59,2889.41946674316,2894.73050097986,2726.17127719361,27,32,1,1
"912341141",30,2607.66976595846,2757.99510095667,2374.18906024059,13,17,1,1
"912341142",26,2609.54329901336,2582.07871536935,2305.75108410937,9,17,1,1
"912341143",25,2579.72145728624,2816.50517589655,2287.34065519221,11,14,1,1
"912341144",58,3820.26561601412,3961.76764629808,2716.66249357165,23,35,1,1
"912341145",22,2651.69267287501,2960.70674221061,2228.3491786518,9,13,1,1
"912341146",45,3331.91003560091,3586.9039525879,2579.33597919865,16,29,1,1
"912341147",20,2337.24071657386,2312.36147689541,2185.35845629437,8,12,1,1
"912341148",29,2751.93951975234,2753.12022028733,2357.79423966008,12,17,1,1
"912341149",27,2638.27471275319,2622.76071482988,2323.60649590586,12,15,1,1
"912341150",30,3025.72650364991,3326.74601359546,2374.18906024059,12,18,1,1
"912341151",36,3211.79943879007,3253.30185186055,2464.33502634194,16,20,1,1
"912341152",16,2225.19881134993,2220.0587764831,2087.92318348224,6,10,1,1
"912341153",28,2926.0164479808,3125.53349329521,2340.94327947849,13,15,1,1
"912341154",41,3298.19919406025,3914.09348017179,2530.72175773865,20,21,1,1
"912341155",48,3001.9975201825,3565.07461970781,2613.58673801098,21,27,1,1
"912341156",27,2714.99883475253,2838.29318857772,2323.60649590586,10,17,1,1
"912341157",25,2582.17460868667,2881.09617673859,2287.34065519221,11,14,1,1
"912341158",44,2989.89278840743,3976.49625483966,2567.51523707907,18,26,1,1
"912341159",29,2769.4037009015,2737.50594442785,2357.79423966008,13,16,1,1
"912341160",35,2903.00596027449,2966.30570036382,2450.1860183293,14,21,1,1
"912341162",15,2198.01857629032,2506.10371801774,2060.56118614118,9,6,1,1
"912341163",31,2899.01169432146,3212.90121524563,2390.15469389133,15,16,1,1
"912341164",27,2979.3534169634,3312.66945769566,2323.60649590586,12,15,1,1
"912341165",29,3138.65023415872,3392.01846285979,2357.79423966008,15,14,1,1
"912341166",45,3249.88223990417,3941.93033567241,2579.33597919865,23,22,1,1
"912341167",36,3069.21392291945,3552.04136169355,2464.33502634194,14,22,1,1
"912341168",33,2856.68475120868,2900.30849819568,2420.89448855093,15,18,1,1
"912341169",33,2889.67387651161,3214.02975319022,2420.89448855093,10,23,1,1
"912341170",41,3357.25969692565,3315.76157008252,2530.72175773865,16,25,1,1
"912341171",27,2537.93219830465,3135.228519341,2323.60649590586,11,16,1,1
"912341172",32,2512.41560268951,2868.78954115179,2405.71569249515,13,19,1,1
"912341173",39,3435.40184816242,3719.33234155852,2504.98447234734,17,22,1,1
"912341174",30,2852.03157536629,2978.53476224847,2374.18906024059,16,14,1,1
"912341175",36,3280.85314692745,4197.4617846717,2464.33502634194,16,20,1,1
"912341176",34,3073.6100591396,3569.87128017947,2435.71163614839,14,20,1,1
"912341177",45,3628.07521146313,4365.24966277325,2579.33597919865,21,24,1,1
"912341178",34,2760.11884329951,2772.84996334767,2435.71163614839,16,18,1,1
"912341179",39,2799.73044104392,3657.12404046429,2504.98447234734,16,23,1,1
"912341180",34,3159.34329965774,3829.75938145883,2435.71163614839,12,22,1,1
"912341181",42,2957.67958009669,3511.41853440015,2543.21752514954,17,25,1,1
"912341182",30,2773.18343584777,3125.35239967224,2374.18906024059,13,17,1,1
"912341183",36,2858.0753517615,3761.99574639334,2464.33502634194,17,19,1,1
"912341184",35,2747.80452153631,3445.34535159887,2450.1860183293,13,22,1,1
"912341185",28,2625.29556990062,3068.58674212414,2340.94327947849,11,17,1,1
"912341186",32,2901.24208344545,3702.99335093634,2405.71569249515,16,16,1,1
"912341187",36,3062.17265085711,3445.1769175275,2464.33502634194,15,21,1,1
"912341188",34,2873.19888916893,3294.04702243874,2435.71163614839,16,18,1,1
"912341189",27,2565.01000087184,2668.28207248292,2323.60649590586,12,15,1,1
"912341190",36,2837.934205362,2941.79245778995,2464.33502634194,18,18,1,1
"912341191",46,3158.21703879452,3455.57670783522,2590.94954296761,23,23,1,1
"912341192",48,3356.89234436182,3050.55818048549,2613.58673801098,28,20,1,1
"912341193",41,2820.38806300054,3253.07703801437,2530.72175773865,21,20,1,1
"912341194",43,3110.10880764423,3296.8534617736,2555.47878346624,22,21,1,1
"912341195",51,3067.63975363679,2691.51438133268,2646.17454577679,25,26,1,1
"912341196",41,3192.21956233723,3412.01768045201,2530.72175773865,20,21,1,1
"912341197",37,2804.81875031411,3136.18693685376,2478.17471526668,19,18,1,1
"912341198",47,2758.89006943531,2583.85419956207,2602.36394728806,24,23,1,1
"912341199",37,2761.33020089239,2404.605858578,2478.17471526668,15,22,1,1
"912341200",34,2842.98715471335,2820.74349852887,2435.71163614839,18,16,1,1
"912341201",30,2785.36231672151,3049.12886981919,2374.18906024059,17,13,1,1
"912341202",49,2956.08895190331,2976.42626322458,2624.62502504328,25,24,1,1
"912341203",46,3170.40282854681,3659.40651032892,2590.94954296761,21,25,1,1
"912341204",33,2714.69425447358,2902.07923088652,2420.89448855093,21,12,1,1
"912341205",23,2703.66737673588,3141.86686067455,2248.68783741607,14,9,1,1
"912341206",43,3153.59239425913,4213.10626664124,2555.47878346624,21,22,1,1
"912341207",27,2730.113247809,3071.69516658891,2323.60649590586,12,15,1,1
"912341208",26,2491.60649017784,2908.10415256634,2305.75108410937,9,17,1,1
"912341209",30,2591.73445230959,2723.57231686031,2374.18906024059,17,13,1,1
"912341210",39,2716.5760468733,3013.80976498075,2504.98447234734,21,18,1,1
"912341211",29,2700.61341562277,3396.40087063945,2357.79423966008,17,12,1,1
"912341212",46,2718.46565889196,3008.34186007672,2590.94954296761,25,21,1,1
"912341213",30,2641.84480872815,2966.65478616339,2374.18906024059,18,12,1,1
"912341214",46,2575.0148159323,2883.06641569557,2590.94954296761,22,24,1,1
"912341215",53,3216.28324252387,3692.57231586964,2667.061866114,30,23,1,1
"912341216",25,2494.69343108399,2681.30281129016,2287.34065519221,13,12,1,1
"912341217",55,3298.55955934681,4344.27535089734,2687.33120998132,26,29,1,1
"912341218",32,2810.20486923301,3368.69652844447,2405.71569249515,17,15,1,1
"912341219",52,3048.9252359735,4189.31800060148,2656.6981055205,29,23,1,1
"912341220",38,2605.99091097871,2540.12356735052,2491.71993967651,18,20,1,1
"912341221",39,2998.81659620158,3310.5022966025,2504.98447234734,21,18,1,1
"912341222",28,2789.1063036884,3049.39985835214,2340.94327947849,14,14,1,1
"912341223",54,3423.5271491482,4569.18804319591,2677.2712016452,25,29,1,1
"912341789",18,2280.04846242577,2483.75477060909,2138.79896507223,11,7,1,1
"912341790",22,2276.84500696155,2512.44241129854,2228.3491786518,14,8,1,1
"912341791",20,2298.21053651125,2287.57524033859,2185.35845629437,10,10,1,1
"912341792",19,2233.83417814166,2163.22632647729,2162.56636020013,8,11,1,1
"912341793",17,2127.34456720918,1883.21418416165,2113.95669457394,12,5,1,1
"912341794",18,2335.71609805801,2176.25922437156,2138.79896507223,12,6,1,1
"912341795",24,2094.01757076692,2036.35862401606,2268.33468283819,14,10,1,1
"912341796",22,2174.40921117511,2062.47243022672,2228.3491786518,11,11,1,1
"912341797",16,2208.8688102262,2076.06489515343,2087.92318348224,10,6,1,1
"912341798",14,2071.33873471563,1892.91903173568,2031.70713799962,8,6,1,1
"912341799",26,2289.59343683617,1908.67449610351,2305.75108410937,15,11,1,1
"912341800",27,2380.00586456722,1915.69079326992,2323.60649590586,16,11,1,1
"912341801",17,2116.35755783268,1861.48632431516,2113.95669457394,9,8,1,1
"912341802",18,2160.73579611071,2157.83443094177,2138.79896507223,9,9,1,1
"912341803",17,2199.43789582979,1863.08956001876,2113.95669457394,9,8,1,1
"912341804",18,2210.04716450929,2108.84354666528,2138.79896507223,10,8,1,1
"912341805",19,2279.06842020051,2131.77835581548,2162.56636020013,12,7,1,1
"912341806",15,2133.91719704566,1813.45060830977,2060.56118614118,10,5,1,1
"912341807",19,2180.57907703494,2071.21962579864,2162.56636020013,8,11,1,1
"912341808",18,2150.86430212698,1989.25232983397,2138.79896507223,8,10,1,1
"912341809",22,2213.40104789553,1970.73903880866,2228.3491786518,11,11,1,1
"912341810",23,2334.64419573266,2298.3974667941,2248.68783741607,12,11,1,1
"912341811",18,2158.7472127261,1961.24426355682,2138.79896507223,5,13,1,1
"912341812",17,2024.69722442658,1717.40460709665,2113.95669457394,7,10,1,1
"912341813",18,2053.45922715019,1899.97262261825,2138.79896507223,7,11,1,1
"912341814",16,2094.86261696072,2022.52582669398,2087.92318348224,6,10,1,1
"912341815",9,1901.08030004216,1818.31272220984,1856.26587460569,5,4,1,1
"912341816",13,2052.7220964369,1994.68548554986,2001.16379457045,6,7,1,1
"912341817",30,2669.6741497869,2985.60363956265,2374.18906024059,16,14,1,1
"912341818",33,2873.89008680618,2865.14097659933,2420.89448855093,14,19,1,1
"912341819",26,2432.67657624674,2702.42241005415,2305.75108410937,14,12,1,1
"912341820",6,1740.85845279674,1739.18114075022,1708.62817714657,5,1,1,1
"912341821",9,1862.63225702545,1918.12048530371,1856.26587460569,2,7,1,1
"912341822",26,2629.21143135442,2593.8339008399,2305.75108410937,14,12,1,1
"912341823",31,2487.77372515237,2637.38059727985,2390.15469389133,14,17,1,1
"912341824",13,2093.97464022781,2152.21505557544,2001.16379457045,6,7,1,1
"912341825",33,2528.556702688,2672.95740751456,2420.89448855093,16,17,1,1
"912341826",39,2746.80228011232,3068.30321368459,2504.98447234734,18,21,1,1
"912341827",27,2643.7210136346,2624.66246216591,2323.60649590586,14,13,1,1
"912341837",63,3178.0496823709,3247.55097710262,2762.96971264875,30,33,1,1
"912341838",42,3040.30736352337,3320.74638366427,2543.21752514954,23,19,1,1
"912341839",41,3045.85911975717,3010.68552412425,2530.72175773865,21,20,1,1
"912341840",26,2616.30410656064,2617.04498944062,2305.75108410937,13,13,1,1
"912341841",44,2955.18421552989,2893.05902516693,2567.51523707907,23,21,1,1
"912341842",58,3418.00949112668,3103.88854898264,2716.66249357165,34,24,1,1
"912341843",68,3540.01286402826,3227.30738231973,2806.43931339586,35,33,1,1
"912341844",49,3135.01132749161,2809.88776860093,2624.62502504328,32,17,1,1
"912341845",46,3027.63543850853,2562.14265195304,2590.94954296761,26,20,1,1
"912341966",73,4072.42524572638,4302.37624266915,2847.4358582506,31,42,1,1
"912341967",86,4410.95966906152,4044.16030147864,2944.43562859908,38,48,1,1
"912341968",69,3376.73210608046,3644.34485703622,2814.82611826518,33,36,1,1
"912341969",75,3792.17917696163,3628.58602158978,2863.21031780169,30,45,1,1
"912341970",77,3665.55234304499,3151.92347453098,2878.65357631343,31,46,1,1
"912342032",95,4489.06600898907,6204.19858271314,3004.94950458202,46,49,1,1
"912342034",92,3662.96849426679,3493.87470429427,2985.30521778333,41,51,1,1
"912342035",76,3596.8051665135,3655.88369531584,2870.97236507783,39,37,1,1
"912342036",5,1670.08930527589,1889.85269786966,1646.12614877363,1,4,1,1
"912342037",6,1753.82270501979,1914.57148071217,1708.62817714657,1,5,1,1
"912342038",9,1826.69037014003,1748.60582283804,1856.26587460569,0,9,1,1
"912342039",13,1820.03720839454,2008.4997766789,2001.16379457045,2,11,1,1
"912342040",5,1679.50104732665,1939.68071223106,1646.12614877363,1,4,1,1
"912342041",7,1695.69318457373,1824.56278242116,1763.32076508842,0,7,1,1
"912342042",9,1762.0944117022,1800.56698198923,1856.26587460569,1,8,1,1
"912342043",7,1791.50190253212,2028.08362691395,1763.32076508842,1,6,1,1
"912342044",9,1796.57363640712,2183.97888347098,1856.26587460569,1,8,1,1
"912342045",11,1804.62702898428,1734.62890481168,1933.98659929558,0,11,1,1
"912342047",14,1814.55270143981,1811.42552790038,2031.70713799962,3,11,1,1
"912342049",14,1855.08252301203,1605.28767302035,2031.70713799962,4,10,1,1
"912342050",4,1632.43195767696,1730.84766404667,1572.73281143487,1,3,1,1
"912342051",6,1659.31021722951,1687.55175505902,1708.62817714657,1,5,1,1
"912342052",7,1754.94842010142,1998.4767404928,1763.32076508842,2,5,1,1
"912342053",6,1678.82645649962,1768.88646432616,1708.62817714657,0,6,1,1
"912342054",10,1791.21068413514,1471.70842552346,1896.67490607898,1,9,1,1
"912342055",4,1598.49886519612,1726.70288581289,1572.73281143487,0,4,1,1
"912342056",6,1714.86409871611,1952.60467735911,1708.62817714657,0,6,1,1
"912342057",9,1739.4454813256,1596.13776684128,1856.26587460569,2,7,1,1
"912342058",6,1719.28237633261,1905.19659244716,1708.62817714657,0,6,1,1
"912342059",10,1885.03224470899,1954.99476221153,1896.67490607898,3,7,1,1
"912342060",9,1835.07036929491,1977.08266886383,1856.26587460569,1,8,1,1
"912342061",9,1809.55333735547,1854.03047069047,1856.26587460569,0,9,1,1
"912342062",6,1740.87379438638,1937.94432520126,1708.62817714657,1,5,1,1
"912342063",7,1786.76497402477,1969.99680318117,1763.32076508842,1,6,1,1
"912342064",8,1837.60953473395,2018.88820804985,1812.11073017574,1,7,1,1
"912342065",8,1768.9789598743,1826.64737389766,1812.11073017574,1,7,1,1
"912342066",11,1712.31048760185,1347.51639836203,1933.98659929558,1,10,1,1
"912342067",7,1739.96609625588,1835.6889536479,1763.32076508842,0,7,1,1
"912342068",8,1779.11165295952,1892.21804378478,1812.11073017574,0,8,1,1
"912342069",6,1768.7396495308,1959.35292957162,1708.62817714657,0,6,1,1
"912342070",7,1819.32167090561,1963.2701704378,1763.32076508842,0,7,1,1
"912342071",6,1600.58134723807,1611.59748758811,1708.62817714657,1,5,1,1
"912342072",6,1756.31576273589,1913.83269185867,1708.62817714657,0,6,1,1
"912342073",5,1684.74990748949,1816.15831637316,1646.12614877363,0,5,1,1
"912342074",9,1766.31810782488,1353.85585337499,1856.26587460569,1,8,1,1
"912342075",7,1780.9597522461,1930.72461199601,1763.32076508842,0,7,1,1
"912342076",7,1782.02452530679,1979.88639778999,1763.32076508842,0,7,1,1
"912342077",5,1684.74990748949,1819.51044770275,1646.12614877363,0,5,1,1
"912342078",5,1684.74990748949,1851.2304475265,1646.12614877363,0,5,1,1
"912342079",10,1822.65276619431,1917.13643460336,1896.67490607898,1,9,1,1
"912342080",5,1684.74990748949,1808.28614933123,1646.12614877363,0,5,1,1
"912342081",6,1755.26635085425,1863.81601964852,1708.62817714657,0,6,1,1
"912342082",2,1399.19231957997,1489.33448454593,1364.97646362037,0,2,1,1
"912342083",4,1623.45851670784,1813.52295326488,1572.73281143487,0,4,1,1
"912342084",12,1780.83000470623,1306.40804206041,1968.69006049611,2,10,1,1
"912342085",13,1889.50383492955,1970.95440506282,2001.16379457045,3,10,1,1
"912342086",9,1827.56562091862,2085.94105770047,1856.26587460569,0,9,1,1
"912342087",10,1786.05816756625,1859.66439230341,1896.67490607898,1,9,1,1
"912342088",12,1849.08187585674,2084.89615582236,1968.69006049611,0,12,1,1
"912342089",7,1733.69365013235,1886.74118780995,1763.32076508842,0,7,1,1
"912342096",17,2080.06331360399,1881.94461286665,2113.95669457394,8,9,1,1
"912342098",18,2117.80627697368,2227.76233850376,2138.79896507223,6,12,1,1
"912342099",10,1784.61768360572,1765.85294024602,1896.67490607898,3,7,1,1
"912342107",12,1882.75956801595,1839.21776307489,1968.69006049611,5,7,1,1
"912342109",19,2162.3298524914,2294.54647181825,2162.56636020013,8,11,1,1
"912342111",17,2096.35909227505,2084.57836268475,2113.95669457394,6,11,1,1
"912342112",14,2015.20324435758,1998.38829370206,2031.70713799962,6,8,1,1
"912342113",9,1875.80144090881,1742.17041043167,1856.26587460569,5,4,1,1
"912342115",15,2072.67262107634,2027.41438257008,2060.56118614118,5,10,1,1
"912342118",46,3044.78403738495,3601.94509374366,2590.94954296761,24,22,1,1
"912342119",46,3132.40361787749,3615.28198927247,2590.94954296761,21,25,1,1
"912342120",40,3229.81724586823,3466.78045328186,2517.98110851286,15,25,1,1
"912342121",49,3243.2921064906,3973.64854528204,2624.62502504328,25,24,1,1
"912342122",47,2920.31205161039,3505.64683265688,2602.36394728806,21,26,1,1
"912342123",35,2583.97578977983,2860.84881319504,2450.1860183293,13,22,1,1
"912342124",37,2735.04951446556,2840.18563538286,2478.17471526668,15,22,1,1
"912342125",36,2825.32570841989,3006.21701833163,2464.33502634194,15,21,1,1
"912342126",42,3109.1493331814,3914.976058675,2543.21752514954,21,21,1,1
"912342127",87,3302.21018293771,4257.56666317668,2951.40156710974,36,51,1,1
"912342128",30,2522.90212807309,3322.24134181047,2374.18906024059,12,18,1,1
"912342129",59,3184.4257156852,3526.36280102667,2726.17127719361,25,34,1,1
"912342130",68,3426.09220100575,4031.65542459079,2806.43931339586,29,39,1,1
"912342131",53,3393.3036783252,4212.99138805284,2667.061866114,26,27,1,1
"912342132",79,3674.12986253133,4199.64758450645,2893.78092561085,31,48,1,1
"912342133",65,2923.38385715768,2552.02278162397,2780.67589681985,26,39,1,1
"912342134",73,3072.44339397391,2846.06400341244,2847.4358582506,33,40,1,1
"912342135",73,3901.36543781384,5013.13798504708,2847.4358582506,32,41,1,1
"912342136",74,3375.17746764589,3431.08775022409,2855.36548874306,30,44,1,1
"912342137",52,3088.29549324076,3189.49434390911,2656.6981055205,24,28,1,1
"912342138",78,2903.04136670937,3432.87963290287,2886.25582696583,32,46,1,1
"912342139",81,3806.67846463405,3257.35013476994,2908.60658576875,33,48,1,1
"912342140",61,3322.63797663457,3482.1845218256,2744.81051624266,21,40,1,1
"912342141",52,3558.05079080276,4840.43012864793,2656.6981055205,26,26,1,1
"912342142",91,3195.40874310971,3282.18018747621,2978.64386243803,37,54,1,1
"912342144",59,3207.52373510059,4559.98270171452,2726.17127719361,29,30,1,1
"912342145",47,3057.52187362683,4221.72271648176,2602.36394728806,28,19,1,1
"912342146",57,3027.87238448759,3650.37066649274,2707.02236739438,26,31,1,1
"912342147",60,3138.14487707754,4012.28925635987,2735.5526890818,27,33,1,1
"912342148",72,3093.9094180881,3606.78930650861,2839.4193288992,27,45,1,1
"912342150",61,3555.97178590995,4022.23813437786,2744.81051624266,29,32,1,1
"912342151",71,3264.88297255757,3985.13388871452,2831.31372136695,28,43,1,1
"912342152",51,2832.76002229912,2791.94397004221,2646.17454577679,22,29,1,1
"912342153",73,3353.58506444006,4551.10226869781,2847.4358582506,27,46,1,1
"912342154",81,3403.2340422721,3571.47388877762,2908.60658576875,32,49,1,1
"912342155",41,2926.11112411927,3045.90112571872,2530.72175773865,18,23,1,1
"912342156",47,3100.33312692294,3384.7838944942,2602.36394728806,21,26,1,1
"912342157",37,2572.72969096153,2296.67753087729,2478.17471526668,15,22,1,1
"912342158",33,2745.31988149968,2993.76621064035,2420.89448855093,16,17,1,1
"912342159",30,2470.38978136136,2326.45506478628,2374.18906024059,15,15,1,1
"912342160",34,2594.85662955462,2814.64262776294,2435.71163614839,16,18,1,1
"912342161",31,2680.52899637657,2481.27447628154,2390.15469389133,16,15,1,1
"912342162",25,2280.88011854535,2599.79631041265,2287.34065519221,8,17,1,1
"912342163",35,2429.86268438449,2472.48987492434,2450.1860183293,15,20,1,1
"912342164",30,2459.11010843339,2511.92944089326,2374.18906024059,11,19,1,1
"912342165",72,3173.43012495614,3698.47602981303,2839.4193288992,34,38,1,1
"912342166",57,3195.62236152404,3511.52429401991,2707.02236739438,27,30,1,1
"912342167",40,2893.33226766256,3176.44765052934,2517.98110851286,18,22,1,1
"912342168",44,3189.19845666365,3765.99393317786,2567.51523707907,21,23,1,1
"912342169",23,1922.60160380468,1689.03443025679,2248.68783741607,7,16,1,1
"912342173",27,2222.02189663621,1978.16402283262,2323.60649590586,14,13,1,1
"912342174",23,2388.30402189622,2466.52528268405,2248.68783741607,13,10,1,1
"912342175",18,2157.85907071975,2167.26076785945,2138.79896507223,11,7,1,1
"912342176",20,2164.78237539987,2264.44531575807,2185.35845629437,9,11,1,1
"912342177",12,1988.07088124604,1989.92622209584,1968.69006049611,8,4,1,1
"912342178",21,2261.79935339861,2235.42147452005,2207.26116887512,9,12,1,1
"912342179",16,2108.62135318104,2179.16791475705,2087.92318348224,8,8,1,1
"912342180",16,2118.51576744603,2296.86319881862,2087.92318348224,8,8,1,1
"912342181",19,2179.36347537247,2297.87390262574,2162.56636020013,10,9,1,1
"912342182",20,2238.45285979767,2386.78161719722,2185.35845629437,10,10,1,1
"912342183",12,1891.92294251038,1897.16920381402,1968.69006049611,7,5,1,1
"912342184",23,2060.77587537909,2150.00607503211,2248.68783741607,13,10,1,1
"912342185",26,2357.10705198932,2433.53381491275,2305.75108410937,10,16,1,1
"912342186",29,2509.38181354369,2274.75977256434,2357.79423966008,14,15,1,1
"912342187",39,2668.0966864288,2344.01591886468,2504.98447234734,20,19,1,1
"912342188",40,2599.33740915592,2837.59477927181,2517.98110851286,17,23,1,1
"912342189",45,2699.72296204727,2993.46717024549,2579.33597919865,21,24,1,1
"912342190",48,2833.76404066128,3044.45858684233,2613.58673801098,19,29,1,1
"912342191",38,2747.90994873525,3051.71831323034,2491.71993967651,16,22,1,1
"912342205",13,1853.46166337906,1836.21999110192,2001.16379457045,7,6,1,1
"912342206",18,2046.87247899548,1913.91981724613,2138.79896507223,11,7,1,1
"912342207",23,2170.78587709809,1994.47855237366,2248.68783741607,12,11,1,1
"912342208",19,2140.75286601639,2023.01956589313,2162.56636020013,12,7,1,1
"912342209",24,2200.68791965105,1885.96209213873,2268.33468283819,11,13,1,1
"912342210",27,2052.77220985077,2120.81608722809,2323.60649590586,14,13,1,1
"912342211",22,2092.56233345431,2009.2019624199,2228.3491786518,11,11,1,1
"912342212",8,1807.48420425216,1824.25583236465,1812.11073017574,5,3,1,1
"912342213",15,1918.00684179446,1965.61138433864,2060.56118614118,6,9,1,1
"912342214",22,2133.5631329798,1920.00182112454,2228.3491786518,12,10,1,1
"912342215",13,1940.09919415479,1933.46192940343,2001.16379457045,8,5,1,1
"912342216",21,2207.22552152513,1978.67246470568,2207.26116887512,11,10,1,1
"912342217",24,2118.32351987502,1747.41621336305,2268.33468283819,12,12,1,1
"912342218",22,2098.74721688475,1809.57526936779,2228.3491786518,10,12,1,1
"912342219",20,2066.96809522893,1719.91894510313,2185.35845629437,9,11,1,1
"912342220",28,2098.70008853081,1721.47880218705,2340.94327947849,10,18,1,1
"912342221",21,1952.5235204482,1700.69698178761,2207.26116887512,12,9,1,1
"912342222",26,2144.25718813161,1889.67863330111,2305.75108410937,12,14,1,1
"912342223",25,2004.20084004016,1647.59336966054,2287.34065519221,12,13,1,1
"912342224",13,2023.53195562113,1950.57556446685,2001.16379457045,7,6,1,1
"912342225",23,2507.34224728058,2807.34738193275,2248.68783741607,9,14,1,1
"912342226",25,2590.0435701627,2564.4072993573,2287.34065519221,10,15,1,1
"912342227",28,2789.35632442119,2873.91665582721,2340.94327947849,11,17,1,1
"912342228",33,2828.14009096095,2528.265596232,2420.89448855093,15,18,1,1
"912342229",35,2954.89270665574,3237.68233910287,2450.1860183293,14,21,1,1
"912342230",54,2947.651984501,2898.94980788049,2677.2712016452,27,27,1,1
"912342232",62,2906.21245179042,3219.69469953643,2753.94837323248,27,35,1,1
"912342233",53,3128.06696693651,2734.82362407619,2667.061866114,26,27,1,1
"912342234",58,3266.92849725622,3784.97605144899,2716.66249357165,24,34,1,1
"912342235",72,3722.63021970187,4197.05431627451,2839.4193288992,40,32,1,1
"912342236",81,4164.77201312009,3789.5334582483,2908.60658576875,43,38,1,1
"912342237",58,3006.07980121966,3658.08847155499,2716.66249357165,27,31,1,1
"912342238",47,3233.4515006951,3369.1449088309,2602.36394728806,20,27,1,1
"912342239",29,2556.45969245459,2320.85025133912,2357.79423966008,15,14,1,1
"912342240",41,2787.08018738351,2828.93251965626,2530.72175773865,22,19,1,1
"912342241",42,3070.16701134996,2620.63467481718,2543.21752514954,18,24,1,1
"912342242",44,2879.40633767266,2269.04348439927,2567.51523707907,18,26,1,1
"912342243",51,3104.76906552511,3452.05947323822,2646.17454577679,24,27,1,1
"912342245",20,2371.22757120874,2478.33643085115,2185.35845629437,8,12,1,1
"912342266",46,3036.07492327625,3285.98253187855,2590.94954296761,20,26,1,1
"912342267",61,3418.65534587181,3734.52004831735,2744.81051624266,30,31,1,1
"912342268",57,2918.92431538713,2904.79317664957,2707.02236739438,27,30,1,1
"912342269",66,2890.80124646659,3017.72804497573,2789.3669207067,32,34,1,1
"912342270",64,3020.33797156121,3446.31969045076,2771.87783482774,33,31,1,1
"912342271",76,3171.34746630447,3108.56144886739,2870.97236507783,38,38,1,1
"912342272",41,2921.22584001778,3290.39228860748,2530.72175773865,21,20,1,1
"912342273",56,3427.29343092578,3559.08031403775,2697.24673169728,27,29,1,1
"912342274",52,3040.71374110247,2741.13246323457,2656.6981055205,27,25,1,1
"912342275",40,2678.53102023647,2751.8308412978,2517.98110851286,21,19,1,1
"912342276",45,2697.83609382923,2963.43320112082,2579.33597919865,17,28,1,1
"912342277",48,3191.62866461328,3105.98461103944,2613.58673801098,20,28,1,1
"912342278",48,3006.05756370833,3201.27615713607,2613.58673801098,22,26,1,1
"912342279",68,2974.18312436204,2631.9356166151,2806.43931339586,34,34,1,1
"912342280",50,2978.32313190745,2588.16894809956,2635.48551585152,21,29,1,1
"912342281",47,3015.02589133171,2928.95857925721,2602.36394728806,21,26,1,1
"912342282",59,3085.68985062799,3333.92260281616,2726.17127719361,32,27,1,1
"912342283",44,2636.86983672851,2579.41463770378,2567.51523707907,24,20,1,1
"912342284",47,2763.06625798255,2732.34193128457,2602.36394728806,24,23,1,1
"912342285",72,3386.67720965851,2676.30196359804,2839.4193288992,35,37,1,1
"912342373",60,3065.37927855209,3782.35464244289,2735.5526890818,27,33,1,1
"912342374",40,3073.67133623951,3644.37146722452,2517.98110851286,16,24,1,1
"912342375",75,3243.87977988938,4159.19837612935,2863.21031780169,29,46,1,1
"912342376",71,3421.33716418485,4573.79557040886,2831.31372136695,27,44,1,1
"912342377",73,3271.56371574984,3134.96607690775,2847.4358582506,30,43,1,1
"912342378",66,3025.12785019349,3761.97636866537,2789.3669207067,25,41,1,1
"912342379",85,4397.66520016429,4322.75835980497,2937.40494579778,44,41,1,1
"912342380",67,3607.61441725902,3824.46990854991,2797.95380131742,33,34,1,1
"912342381",86,4077.65227181001,4463.62446800813,2944.43562859908,36,50,1,1
"912342382",86,4027.9501908943,3836.07460305615,2944.43562859908,46,40,1,1
"912342385",71,3903.85385532648,4017.18810584942,2831.31372136695,33,38,1,1
"912342386",49,2781.45191419271,2244.34254552192,2624.62502504328,19,30,1,1
"912342387",65,3010.60532469513,2989.93485846365,2780.67589681985,35,30,1,1
"912342388",71,3650.30461989993,4482.17189810439,2831.31372136695,37,34,1,1
"912342389",19,2046.85512411575,1664.9907247003,2162.56636020013,8,11,1,1
"912342390",13,1908.59901483272,1485.80710696626,2001.16379457045,6,7,1,1
"912342391",17,1987.0441132661,1596.96881725161,2113.95669457394,10,7,1,1
"912342392",14,1873.16019551031,1563.51567960747,2031.70713799962,7,7,1,1
"912342393",16,1967.74848511925,1612.08137677841,2087.92318348224,7,9,1,1
"912342394",11,1848.69488442908,1829.2987824294,1933.98659929558,5,6,1,1
"912342395",16,1954.15926554425,1617.83418628156,2087.92318348224,8,8,1,1
"912342396",12,1887.84024250803,1501.51774121225,1968.69006049611,4,8,1,1
"912342397",13,1889.40399707373,1710.09538191374,2001.16379457045,6,7,1,1
"912342398",6,1658.00110655364,1524.49618398421,1708.62817714657,2,4,1,1
"912342399",8,1813.5695243488,1758.06137928113,1812.11073017574,4,4,1,1
"912342408",18,1843.95238247057,1602.90437793151,2138.79896507223,10,8,1,1
"912342409",24,2111.77967451916,1721.18886931811,2268.33468283819,11,13,1,1
"912342410",22,2046.29329182002,1677.96891803967,2228.3491786518,14,8,1,1
"912342411",24,2092.71789890335,1614.76766466795,2268.33468283819,12,12,1,1
"912342412",17,1922.53315337768,1588.05087279799,2113.95669457394,9,8,1,1
"912342413",20,1897.72036430428,1511.36234482203,2185.35845629437,11,9,1,1
"912342414",21,2012.75158942775,1505.42100441627,2207.26116887512,11,10,1,1
"912342419",18,2034.75362235121,1685.68357645442,2138.79896507223,9,9,1,1
"912342420",18,2066.282136294,1797.46141252502,2138.79896507223,12,6,1,1
"912342421",27,2189.39308255106,1684.4053830122,2323.60649590586,12,15,1,1
"912342422",15,1849.23098025215,1534.10244793042,2060.56118614118,7,8,1,1
"912342423",18,2031.47898566615,1470.38140943574,2138.79896507223,11,7,1,1
"912342424",19,1948.84489407159,1541.55047752338,2162.56636020013,9,10,1,1
"912342425",16,1989.35893584746,1742.35159187924,2087.92318348224,9,7,1,1
"912342427",12,1849.14366475414,1695.05746659337,1968.69006049611,5,7,1,1
"912342428",15,1944.63619345275,1722.01668667893,2060.56118614118,9,6,1,1
"912342429",41,2884.70639659383,2401.40358515544,2530.72175773865,22,19,1,1
"912342430",17,2029.83978648879,1680.19829667951,2113.95669457394,9,8,1,1
"912342431",41,2686.64099102651,2540.56832825171,2530.72175773865,21,20,1,1
"912342432",25,2288.64706805201,2168.16934208448,2287.34065519221,14,11,1,1
"912342433",47,2763.69896755423,2343.20715521137,2602.36394728806,31,16,1,1
"912342434",42,2553.37075445791,1969.306001656,2543.21752514954,24,18,1,1
"912342435",30,2602.41001200109,2258.44844877551,2374.18906024059,16,14,1,1
"912342436",26,2211.87130736125,2176.90290110926,2305.75108410937,14,12,1,1
"912342437",43,2825.89464804336,3015.12973685644,2555.47878346624,24,19,1,1
"912342438",47,2915.18466974856,2843.81887425155,2602.36394728806,26,21,1,1
"912342439",32,2837.41819486553,3233.37565960235,2405.71569249515,17,15,1,1
"912342440",31,2792.44934009844,3305.86400083336,2390.15469389133,16,15,1,1
"912342441",30,2632.27393312229,2937.21966771032,2374.18906024059,19,11,1,1
"912342442",36,2784.48106035372,2892.00233896947,2464.33502634194,23,13,1,1
"912342443",23,1825.26660514932,1544.20831933312,2248.68783741607,12,11,1,1
"912342444",25,2143.58548880609,1864.33493312974,2287.34065519221,14,11,1,1
"912342445",27,2350.21414216391,1946.04621919382,2323.60649590586,17,10,1,1
"912342446",27,2356.41999972556,2131.40402781068,2323.60649590586,16,11,1,1
"912342447",23,2215.02119956739,1923.12163688318,2248.68783741607,14,9,1,1
"912342448",21,2204.57454972298,2186.66791835619,2207.26116887512,14,7,1,1
"912342449",22,2211.39838456262,1980.8056195619,2228.3491786518,13,9,1,1
"912342450",38,2523.41746439884,2499.76659384587,2491.71993967651,21,17,1,1
"912342451",27,2151.88459757142,1560.12664861744,2323.60649590586,14,13,1,1
"912342452",25,2360.38307699812,1805.98648947464,2287.34065519221,15,10,1,1
"912342453",40,2728.19343491499,2236.85457873522,2517.98110851286,23,17,1,1
"912342454",34,2583.57913324193,2143.64173362966,2435.71163614839,22,12,1,1
"912342455",28,2511.73130403991,2293.70824739909,2340.94327947849,16,12,1,1
"912342456",35,2661.57385457689,2566.15554614309,2450.1860183293,21,14,1,1
"912342457",24,2360.54418933261,2647.64438976434,2268.33468283819,12,12,1,1
"912342458",26,2628.14412792797,2837.24011835874,2305.75108410937,16,10,1,1
"912342459",19,2123.6445811418,1713.17363305534,2162.56636020013,11,8,1,1
"912342460",31,2578.96315517842,2475.54398901788,2390.15469389133,16,15,1,1
"912342461",34,2823.24698498286,2848.72691260221,2435.71163614839,20,14,1,1
"912342462",36,2838.6690150539,2512.53009573522,2464.33502634194,20,16,1,1
"912342463",29,2758.09005118646,2663.04688425433,2357.79423966008,16,13,1,1
"912342464",42,3055.20337189449,3612.88362417704,2543.21752514954,23,19,1,1
"912342465",33,2740.72400999152,3119.86959555194,2420.89448855093,19,14,1,1
"912342466",24,2436.45670958927,2745.59818829801,2268.33468283819,14,10,1,1
"912342467",22,2233.81096261586,1917.96026329881,2228.3491786518,8,14,1,1
"912342468",22,2315.98811150271,2015.31495272854,2228.3491786518,9,13,1,1
"912342469",15,1877.53430684411,1494.86265136703,2060.56118614118,6,9,1,1
"912342470",35,2606.9689290344,1987.9127673687,2450.1860183293,19,16,1,1
"912342471",15,2112.7286233026,1667.0894045866,2060.56118614118,8,7,1,1
"912342472",26,2308.61940643181,2008.685305927,2305.75108410937,14,12,1,1
"912342473",10,1891.06103713815,1740.97892625819,1896.67490607898,5,5,1,1
"912342474",16,1969.87916380547,1684.27798073646,2087.92318348224,10,6,1,1
"912342475",22,2089.26146820516,1706.34774947046,2228.3491786518,12,10,1,1
"912342476",25,2319.31651179683,1788.93433370726,2287.34065519221,13,12,1,1
"912342477",26,2292.34657727252,1945.90214055563,2305.75108410937,16,10,1,1
"912342478",41,2575.38551635168,2337.98015456775,2530.72175773865,24,17,1,1
"912342479",28,2470.99778112022,2280.20534847822,2340.94327947849,15,13,1,1
"912342480",45,2649.57524326284,2065.36975969435,2579.33597919865,25,20,1,1
"912342481",41,2939.27679674528,4080.43769958318,2530.72175773865,23,18,1,1
"912342482",49,3318.38196718501,3938.76710360858,2624.62502504328,30,19,1,1
"912342483",39,2608.11177353592,3272.48870026906,2504.98447234734,18,21,1,1
"912342484",25,2398.64571956818,2589.2997387275,2287.34065519221,15,10,1,1
"912342485",42,2765.65246919501,2384.48401378199,2543.21752514954,26,16,1,1
"912342486",49,2792.56197180799,2010.52740830014,2624.62502504328,28,21,1,1
"912342487",12,1875.10427248942,1579.8024143013,1968.69006049611,8,4,1,1
"912342488",13,1921.60144640041,1675.66495957427,2001.16379457045,10,3,1,1
"912342489",28,2458.55751970358,2065.24772474991,2340.94327947849,14,14,1,1
"912342490",46,2240.14675852006,2400.12103967311,2590.94954296761,24,22,1,1
"912342491",26,2339.02500699009,1969.66171799641,2305.75108410937,14,12,1,1
"912342492",35,2692.47300355631,2732.29019913802,2450.1860183293,21,14,1,1
"912342493",28,2363.42614360485,2297.8455836893,2340.94327947849,17,11,1,1
"912342494",42,2636.24205725901,2381.83480070817,2543.21752514954,23,19,1,1
"912342506",61,3580.53375373393,4532.60889682826,2744.81051624266,33,28,1,1
"912342507",75,3687.50039739234,5039.49632452622,2863.21031780169,44,31,1,1
"912342944",9,1848.68133679814,1808.95247005635,1856.26587460569,1,8,1,1
"912342945",10,1767.99683782689,1573.00374887101,1896.67490607898,2,8,1,1
"912342946",7,1777.50555521672,1900.63393531308,1763.32076508842,1,6,1,1
"912342947",9,1836.29628980298,2082.16370893303,1856.26587460569,1,8,1,1
"912342948",8,1810.54194458098,2072.95831305547,1812.11073017574,0,8,1,1
"912342949",6,1722.49823538877,1783.04154924239,1708.62817714657,0,6,1,1
"912342950",9,1815.40952823676,1977.29193674901,1856.26587460569,0,9,1,1
"912342951",11,1856.1919032431,1968.26962726802,1933.98659929558,2,9,1,1
"912342952",12,1792.09777334353,1517.23648855967,1968.69006049611,3,9,1,1
"912342953",6,1687.31259470073,1607.89529535499,1708.62817714657,1,5,1,1
"912342954",8,1749.63075949707,1835.14395266223,1812.11073017574,1,7,1,1
"912342955",8,1798.39970753569,1968.81701088126,1812.11073017574,2,6,1,1
"912342956",8,1718.41084273866,1626.29139387206,1812.11073017574,1,7,1,1
"912342957",8,1760.74407882123,1946.63131512789,1812.11073017574,2,6,1,1
"912342958",11,1821.49351565315,1736.81126751397,1933.98659929558,2,9,1,1
"912342959",13,1835.00832962458,1507.23813412281,2001.16379457045,3,10,1,1
"912342960",9,1792.27198012834,1651.28482483858,1856.26587460569,1,8,1,1
"912342961",9,1809.36217710295,1715.01561300245,1856.26587460569,1,8,1,1
"912343026",9,1817.46045344383,1997.46314816276,1856.26587460569,1,8,1,1
"912343028",6,1762.42435404811,1927.34587204222,1708.62817714657,0,6,1,1
"912343055",6,1692.960255028,1824.46569078512,1708.62817714657,0,6,1,1
"912343056",4,1623.45851670784,1860.54988826845,1572.73281143487,0,4,1,1
"912343057",4,1623.45851670784,1829.21139119502,1572.73281143487,0,4,1,1
"912343058",6,1764.58788100619,1979.725761776,1708.62817714657,1,5,1,1
"912343059",9,1696.72634771287,1465.86155769305,1856.26587460569,3,6,1,1
"912343060",9,1757.99826366752,1672.72212671658,1856.26587460569,1,8,1,1
"912343088",32,2560.51164091727,2909.98391194155,2405.71569249515,19,13,1,1
"912343089",42,3112.32199869211,2843.19322825115,2543.21752514954,22,20,1,1
"912343090",51,3120.04308742317,3121.54206983164,2646.17454577679,24,27,1,1
"912343091",44,3158.92813080768,3057.93482496554,2567.51523707907,25,19,1,1
"912343092",48,3537.76451564617,3557.96490555977,2613.58673801098,23,25,1,1
"912343093",40,3020.93193557008,2940.62719329471,2517.98110851286,18,22,1,1
"912343094",36,2605.20631568263,2548.23560070016,2464.33502634194,21,15,1,1
"912343095",35,2755.68448243476,2624.55820938107,2450.1860183293,19,16,1,1
"912343096",53,3335.55071228715,3099.46258748892,2667.061866114,27,26,1,1
"912343097",38,2979.66817026425,2720.27508089945,2491.71993967651,20,18,1,1
"912343098",44,2740.20551782359,2822.23236111007,2567.51523707907,21,23,1,1
"912343100",34,2836.65236537671,2940.26909886319,2435.71163614839,16,18,1,1
"912343101",41,3020.02244179213,3051.24277656852,2530.72175773865,21,20,1,1
"912343102",49,2894.28075197652,2644.50340374787,2624.62502504328,23,26,1,1
"912343103",31,2444.34920857137,2418.95769855573,2390.15469389133,15,16,1,1
"912343104",30,2486.658882632,2711.8206310386,2374.18906024059,16,14,1,1
"912343105",46,2862.65286078702,2707.48753508976,2590.94954296761,27,19,1,1
"912343106",43,3068.36692021219,3272.80103527675,2555.47878346624,22,21,1,1
"912343107",41,2830.56522048594,2837.26898157084,2530.72175773865,23,18,1,1
"912343108",35,2840.50651435047,2892.9291928108,2450.1860183293,14,21,1,1
"912343109",39,2828.97836255508,2736.66849351104,2504.98447234734,21,18,1,1
"912343110",41,3130.45712218502,3557.63887323232,2530.72175773865,23,18,1,1
"912343111",47,3141.16221775955,3104.30249166994,2602.36394728806,25,22,1,1
"912343112",30,2508.39771857131,2422.8498380367,2374.18906024059,14,16,1,1
"912343113",24,2459.30103687469,2476.33263264891,2268.33468283819,12,12,1,1
"912343114",41,2833.91381808961,3022.94410434635,2530.72175773865,22,19,1,1
"912343115",33,2578.21866201882,2684.88896153288,2420.89448855093,12,21,1,1
"912343116",52,2929.43565377203,3216.19697289264,2656.6981055205,26,26,1,1
"912343117",28,2425.58322058111,2504.58846526268,2340.94327947849,15,13,1,1
"912343118",40,2856.61382297338,2881.51131826039,2517.98110851286,20,20,1,1
"912343119",39,2930.34336410037,2978.27279670312,2504.98447234734,19,20,1,1
"912343120",42,3309.20461521171,3226.30792006396,2543.21752514954,23,19,1,1
"912343121",43,2826.18648306969,2731.90251403499,2555.47878346624,22,21,1,1
"912343122",29,2603.75378060719,2526.49253051508,2357.79423966008,16,13,1,1
"912343123",51,3151.40382456976,3066.63439923263,2646.17454577679,30,21,1,1
"912343124",61,3293.5564476161,3259.07614726052,2744.81051624266,28,33,1,1
"912343125",37,2871.82384065241,3045.96953567463,2478.17471526668,20,17,1,1
"912343126",32,2993.40396017132,2874.87583637083,2405.71569249515,17,15,1,1
"912343127",53,3617.56725666522,3962.51838476762,2667.061866114,31,22,1,1
"912343128",55,3238.32077685839,3570.50744851436,2687.33120998132,31,24,1,1
"912343129",42,2811.43893786337,2489.77607813027,2543.21752514954,24,18,1,1
"912343130",31,2543.71778617365,2542.74612449192,2390.15469389133,17,14,1,1
"912343133",33,2707.97994829948,2696.90675995825,2420.89448855093,16,17,1,1
"912343134",24,2509.42558779454,2695.97293505464,2268.33468283819,14,10,1,1
"912343135",39,3071.98257744878,2964.67618482021,2504.98447234734,16,23,1,1
"912343136",34,2959.24012347145,2690.35360851494,2435.71163614839,15,19,1,1
"912343137",37,3007.79940006091,2578.23548479342,2478.17471526668,20,17,1,1
"912343138",30,2739.75068616593,2601.45595041286,2374.18906024059,18,12,1,1
"912343139",33,2617.49312400845,2477.77624835207,2420.89448855093,15,18,1,1
"912343140",37,2669.67107398402,2812.90279131285,2478.17471526668,16,21,1,1
"912343141",34,2807.04891067242,2749.62027769558,2435.71163614839,20,14,1,1
"912343142",50,3542.06599115331,3257.62967090712,2635.48551585152,29,21,1,1
"912343143",28,2625.85916889195,2929.33706120526,2340.94327947849,13,15,1,1
"912343144",39,2877.00289389499,2991.51589843782,2504.98447234734,22,17,1,1
"912343145",51,3249.19912482663,3313.93842207915,2646.17454577679,26,25,1,1
"912343146",43,3216.79380286366,3136.64974252598,2555.47878346624,20,23,1,1
"912343147",43,3026.00233531061,3042.81577021809,2555.47878346624,24,19,1,1
"912343149",49,3091.65468971476,2982.43196786141,2624.62502504328,20,29,1,1
"912343150",50,3118.53862941372,2718.13162983453,2635.48551585152,26,24,1,1
"912343151",38,2810.59591936108,3387.55711102523,2491.71993967651,13,25,1,1
"912343152",39,2981.18599511654,3378.70129323152,2504.98447234734,20,19,1,1
"912343153",40,2926.22231052745,2688.7229979745,2517.98110851286,20,20,1,1
"912343154",53,2675.06304282345,2263.65442012473,2667.061866114,25,28,1,1
"912343155",23,2487.70814516313,2943.56283098644,2248.68783741607,11,12,1,1
"912343156",33,2565.79055016718,2766.18397800107,2420.89448855093,22,11,1,1
"912343157",28,2494.37804345019,2404.80981574544,2340.94327947849,17,11,1,1
"912343158",44,2573.4275156591,2435.66162302054,2567.51523707907,26,18,1,1
"912343159",43,2989.06945893493,3520.38753231166,2555.47878346624,22,21,1,1
"912343160",34,2659.35089644327,3131.6999630244,2435.71163614839,21,13,1,1
"912343161",48,2980.31569792091,3286.85524535114,2613.58673801098,22,26,1,1
"912343162",32,2882.35002554988,3010.61965044589,2405.71569249515,16,16,1,1
"912343163",41,2800.55278205653,3656.82468608429,2530.72175773865,19,22,1,1
"912343164",50,2905.05933411114,2937.35949996587,2635.48551585152,25,25,1,1
"912343165",36,2533.34971893461,2490.98737372188,2464.33502634194,18,18,1,1
"912343166",49,2964.42763976949,2779.62070057495,2624.62502504328,29,20,1,1
"912343167",44,2884.06062053489,2646.51376048143,2567.51523707907,24,20,1,1
"912343168",30,2627.5896046538,2641.74285335711,2374.18906024059,17,13,1,1
"912343169",41,2694.52334273888,3295.87430059907,2530.72175773865,21,20,1,1
"912343170",54,2957.11225138974,3459.18122056725,2677.2712016452,30,24,1,1
"912343171",47,3022.16810549488,2939.44727049436,2602.36394728806,23,24,1,1
"912343173",54,2721.17969789855,2571.64740641813,2677.2712016452,27,27,1,1
"912343174",43,2825.6930505097,2571.4300097956,2555.47878346624,20,23,1,1
"912343175",52,3373.99902650731,3206.29651093945,2656.6981055205,26,26,1,1
"912343176",55,3202.96363792352,2792.85868140242,2687.33120998132,23,32,1,1
"912343177",45,3073.38214841735,3420.86896212886,2579.33597919865,26,19,1,1
"912343178",50,3332.04965829762,3027.20616273598,2635.48551585152,27,23,1,1
"912343179",27,2636.39061198502,2730.85796113463,2323.60649590586,12,15,1,1
"912343180",58,2857.91520951213,2855.0491917695,2716.66249357165,31,27,1,1
"912343181",46,2912.22108204627,2834.54264195934,2590.94954296761,23,23,1,1
"912343182",53,2752.94226333794,3015.3986165862,2667.061866114,27,26,1,1
"912343183",46,2944.3567547053,3167.73046975161,2590.94954296761,22,24,1,1
"912343184",46,2952.0572931295,2913.34340739779,2590.94954296761,26,20,1,1
"912343185",31,2558.49038184908,2736.45381394327,2390.15469389133,15,16,1,1
"912343186",35,3058.10772416949,4017.53731533774,2450.1860183293,21,14,1,1
"912343187",42,2945.16209675498,3080.14558496237,2543.21752514954,22,20,1,1
"912343189",46,2954.20885268931,3315.92958928804,2590.94954296761,19,27,1,1
"912343190",51,2813.31448050574,2251.99834825463,2646.17454577679,25,26,1,1
"912343191",39,2580.22638312355,2141.40550976324,2504.98447234734,19,20,1,1
"912343193",21,2453.31391984625,2322.30521764441,2207.26116887512,12,9,1,1
"912343194",22,2357.70031982206,2325.73217072399,2228.3491786518,11,11,1,1
"912343195",41,3393.52630566364,4002.08082453058,2530.72175773865,19,22,1,1
"912343196",49,3334.91168243224,3909.69860137391,2624.62502504328,22,27,1,1
"912343197",45,3418.05194694786,4204.5928150944,2579.33597919865,23,22,1,1
"912343198",44,3164.48561528923,3180.92127203699,2567.51523707907,19,25,1,1
"912343199",50,2949.02640139011,3857.15058952644,2635.48551585152,24,26,1,1
"912343200",44,2913.84333125173,3686.59935227453,2567.51523707907,23,21,1,1
"912343201",46,2772.19868910556,3209.11834601548,2590.94954296761,23,23,1,1
"912343202",40,2842.27795009827,3334.57818528407,2517.98110851286,16,24,1,1
"912343203",39,2730.78723072688,2522.51917510129,2504.98447234734,15,24,1,1
"912343204",44,3014.03367022137,3771.46021538019,2567.51523707907,18,26,1,1
"912343205",43,3161.89157848985,3330.6749633028,2555.47878346624,22,21,1,1
"912343206",67,3370.89445602963,3823.68589340703,2797.95380131742,36,31,1,1
"912343207",55,2850.5255071883,3031.14967762283,2687.33120998132,25,30,1,1
"912343208",51,2449.73818031369,2792.88093114836,2646.17454577679,27,24,1,1
"912343209",57,2850.25331336367,3622.4183871682,2707.02236739438,28,29,1,1
"912343210",38,3066.91014201365,3120.63129085973,2491.71993967651,19,19,1,1
"912343211",46,2918.5718094412,3658.57831985763,2590.94954296761,18,28,1,1
"912343212",46,3117.74777014501,3488.8508759619,2590.94954296761,21,25,1,1
"912343213",44,3158.57996761194,3074.11459451256,2567.51523707907,24,20,1,1
"912343214",38,2912.42921020727,3120.39804419891,2491.71993967651,18,20,1,1
"912343215",23,2345.07950192585,2328.71692453242,2248.68783741607,12,11,1,1
"912343216",40,2550.87164333818,3239.445189667,2517.98110851286,17,23,1,1
"912343217",56,3007.84927920561,3333.00395810328,2697.24673169728,26,30,1,1
"912343218",41,3092.58676175948,3272.78600135444,2530.72175773865,21,20,1,1
"912343219",36,3042.30663028701,3314.55968585279,2464.33502634194,17,19,1,1
"912343220",39,2975.88108147569,3271.68560764496,2504.98447234734,16,23,1,1
"912343221",40,2762.33251301305,3128.11129485974,2517.98110851286,19,21,1,1
"912343222",41,3144.26867763005,3843.77887952452,2530.72175773865,16,25,1,1
"912343223",39,2812.29965085768,2727.45636147723,2504.98447234734,16,23,1,1
"912343224",48,3133.3322083062,3566.4966269345,2613.58673801098,26,22,1,1
"912343225",54,3384.92317549549,3473.66832490235,2677.2712016452,23,31,1,1
"912343226",51,3616.45914017855,3850.88525605589,2646.17454577679,31,20,1,1
"912343227",47,2747.92950244004,3173.55468895707,2602.36394728806,19,28,1,1
"912343228",57,2676.17340956108,1796.37136946007,2707.02236739438,24,33,1,1
"912343229",74,3314.61244331956,3946.68382395527,2855.36548874306,32,42,1,1
"912343230",49,3321.65852384503,3829.99794197207,2624.62502504328,22,27,1,1
"912343231",56,3397.28200057596,3770.87667991101,2697.24673169728,23,33,1,1
"912343232",62,3345.65155936151,3566.26150065061,2753.94837323248,30,32,1,1
"912343233",51,3135.21062537153,3293.7821509134,2646.17454577679,20,31,1,1
"912343235",59,3277.09269911335,3834.045847575,2726.17127719361,29,30,1,1
"912343236",39,2867.86503152562,2965.62699974121,2504.98447234734,21,18,1,1
"912343237",31,2556.87380681452,2705.7715776664,2390.15469389133,13,18,1,1
"912343238",26,2330.70065012035,2557.79563286481,2305.75108410937,10,16,1,1
"912343239",29,2323.91921097043,2536.0569661604,2357.79423966008,15,14,1,1
"912343240",35,2658.04534924846,2873.83627458032,2450.1860183293,23,12,1,1
"912343241",39,2991.47911248859,3302.01401278899,2504.98447234734,23,16,1,1
"912343242",43,2693.36737529997,3252.02308911209,2555.47878346624,21,22,1,1
"912343243",20,2404.11934715902,2497.77337193759,2185.35845629437,11,9,1,1
"912343245",57,2951.38107995896,3380.99561562042,2707.02236739438,28,29,1,1
"912343246",48,2727.06738104708,3409.27779407981,2613.58673801098,24,24,1,1
"912343247",58,2883.5597658911,3389.8362091521,2716.66249357165,30,28,1,1
"912343248",47,3033.32507002711,3018.58385223157,2602.36394728806,24,23,1,1
"912343250",45,3396.42800093746,3474.48548003364,2579.33597919865,23,22,1,1
"912343252",43,3071.63234439708,3729.46158610394,2555.47878346624,23,20,1,1
"912343253",53,3280.97030375218,4024.7999360715,2667.061866114,27,26,1,1
"912343254",61,3117.04819868592,3190.53839481402,2744.81051624266,30,31,1,1
"912343255",57,3301.86798382182,3473.85702757533,2707.02236739438,26,31,1,1
"912343256",50,2852.7693449831,2772.2867988641,2635.48551585152,25,25,1,1
"912343257",40,2957.37869524903,3130.86065931955,2517.98110851286,23,17,1,1
"912343258",50,3111.37970317047,3476.46876957049,2635.48551585152,22,28,1,1
"912343259",38,2646.37841365573,2474.17270814278,2491.71993967651,21,17,1,1
"912343261",61,3244.42263303693,3533.93603819391,2744.81051624266,27,34,1,1
"912343262",58,3341.86891293264,3863.60761946617,2716.66249357165,26,32,1,1
"912343263",49,3034.91571581732,3013.19211263436,2624.62502504328,22,27,1,1
"912343264",37,2803.67772102736,2955.30809787276,2478.17471526668,19,18,1,1
"912343265",44,2856.58081847067,2744.94726173314,2567.51523707907,18,26,1,1
"912343266",39,2672.75372378843,2698.97081274323,2504.98447234734,16,23,1,1
"912343267",51,2623.43630154038,2329.41387995317,2646.17454577679,31,20,1,1
"912343268",44,2916.25871252923,2470.73189596123,2567.51523707907,23,21,1,1
"912343269",51,3230.92916766689,3247.1156380049,2646.17454577679,23,28,1,1
"912343270",44,2977.29854725318,3129.38752246707,2567.51523707907,17,27,1,1
"912343271",35,2462.8555372722,2522.36491075713,2450.1860183293,18,17,1,1
"912343272",37,2654.86445452625,2620.34492695134,2478.17471526668,16,21,1,1
"912343273",33,2742.63135746551,3099.66770549646,2420.89448855093,17,16,1,1
"912343274",41,2694.12488688143,3309.9302931271,2530.72175773865,16,25,1,1
"912343275",53,2868.08650159868,2458.29038295582,2667.061866114,23,30,1,1
"912343277",49,2893.9581355326,2906.32766414838,2624.62502504328,23,26,1,1
"912343278",41,2764.510545986,2620.6614793682,2530.72175773865,19,22,1,1
"912343280",40,2760.25612070286,2949.01537162069,2517.98110851286,20,20,1,1
"912343281",45,3200.77686644649,3062.47929996977,2579.33597919865,18,27,1,1
"912343282",39,2732.87400500413,3010.49063093576,2504.98447234734,16,23,1,1
"912343283",51,2856.66291956922,3219.61415008125,2646.17454577679,28,23,1,1
"912343284",48,3094.20391025985,3013.44311312239,2613.58673801098,23,25,1,1
"912343285",53,3241.18923988003,3830.22985172008,2667.061866114,26,27,1,1
"912343286",58,3138.29698978768,3335.30332516961,2716.66249357165,25,33,1,1
"912343287",69,3316.68344966569,3693.50674779358,2814.82611826518,34,35,1,1
"912343288",31,2523.69502159209,2732.53817989585,2390.15469389133,16,15,1,1
"912343289",62,3127.82085260022,3282.04979495698,2753.94837323248,29,33,1,1
"912343290",29,2639.0893405101,2858.64070808783,2357.79423966008,13,16,1,1
"912343291",32,2416.31853393978,2764.22829874806,2405.71569249515,14,18,1,1
"912343292",57,3446.14012355252,3794.89017649827,2707.02236739438,30,27,1,1
"912343293",45,2794.91067336783,2879.82715658788,2579.33597919865,20,25,1,1
"912343294",57,3346.2686024569,3603.51827760339,2707.02236739438,30,27,1,1
"912343295",45,2812.92175881376,2680.68532335308,2579.33597919865,26,19,1,1
"912343296",49,2744.74425549495,2613.33930878989,2624.62502504328,21,28,1,1
"912343297",53,2901.18614154092,2495.72721780885,2667.061866114,27,26,1,1
"912343298",43,3029.24327792307,3100.36120875435,2555.47878346624,23,20,1,1
"912343299",51,2961.6208965369,3305.01212594097,2646.17454577679,32,19,1,1
"912343300",38,2767.22526183294,3137.09002752268,2491.71993967651,20,18,1,1
"912343301",57,3154.76091890903,3566.6522718894,2707.02236739438,25,32,1,1
"912343303",43,2788.03674195807,2473.68789080399,2555.47878346624,19,24,1,1
"912343304",40,2962.61509923573,3779.10673344757,2517.98110851286,20,20,1,1
"912343305",58,2921.70399688838,2985.68785801889,2716.66249357165,26,32,1,1
"912343306",43,2890.76910817894,3016.17598568325,2555.47878346624,20,23,1,1
"912343307",46,2958.38268074642,3077.933269306,2590.94954296761,18,28,1,1
"912343308",56,2924.52529451719,3049.41009643691,2697.24673169728,24,32,1,1
"912343309",54,3131.17504910137,2811.68381828868,2677.2712016452,28,26,1,1
"912343310",38,2887.89123019288,2998.85035804842,2491.71993967651,18,20,1,1
"912343311",38,2980.01589884747,2971.01006346821,2491.71993967651,21,17,1,1
"912343312",57,3403.52567580315,3706.81744229128,2707.02236739438,30,27,1,1
"912343313",62,3233.83346174232,3162.7236276953,2753.94837323248,30,32,1,1
"912343314",29,2851.48795491705,3352.3968606816,2357.79423966008,15,14,1,1
"912343315",22,2643.83810909589,3105.63292173205,2228.3491786518,8,14,1,1
"912343316",49,2550.60212692998,2479.00292895084,2624.62502504328,25,24,1,1
"912343317",44,2641.20484347203,2657.81686848316,2567.51523707907,25,19,1,1
"912343318",56,3144.22191746913,3332.5344947939,2697.24673169728,29,27,1,1
"912343319",55,3321.59172132668,3484.21759756925,2687.33120998132,23,32,1,1
"912343320",35,2699.08635940165,2849.76804175557,2450.1860183293,14,21,1,1
"912343321",42,2928.96171067945,3056.35413593219,2543.21752514954,19,23,1,1
"912343322",43,2731.34134027237,3001.28139733721,2555.47878346624,16,27,1,1
"912343323",36,2716.38274998681,2934.07832671599,2464.33502634194,14,22,1,1
"912343324",66,2824.52456506105,3408.90490118575,2789.3669207067,28,38,1,1
"912343325",49,2645.64110528767,2392.65259965399,2624.62502504328,25,24,1,1
"912343326",65,3541.17082235087,3800.08355637304,2780.67589681985,26,39,1,1
"912343327",68,3396.57626180277,3600.50202163015,2806.43931339586,27,41,1,1
"912343328",54,3138.10752803508,3600.49993461475,2677.2712016452,27,27,1,1
"912343329",50,3106.84536889657,3839.69208572676,2635.48551585152,23,27,1,1
"912343330",55,3322.15756235341,3390.65556599374,2687.33120998132,26,29,1,1
"912343331",36,2723.21747221777,3285.13020001571,2464.33502634194,12,24,1,1
"912343332",50,2857.27562023868,2989.24050883015,2635.48551585152,25,25,1,1
"912343333",44,2917.15136728549,3119.17942551039,2567.51523707907,19,25,1,1
"912343335",57,3085.865377564,3789.22497837526,2707.02236739438,26,31,1,1
"912343336",52,2689.04342675283,2580.39158342665,2656.6981055205,29,23,1,1
"912343337",53,2681.64652922418,2819.47494391942,2667.061866114,24,29,1,1
"912343338",43,2855.69015879953,3026.82146772825,2555.47878346624,19,24,1,1
"912343339",60,2814.33611708774,2993.9304335227,2735.5526890818,23,37,1,1
"912343340",69,3465.96330823559,3529.96213501918,2814.82611826518,31,38,1,1
"912343342",56,2874.5532906991,3006.69749161428,2697.24673169728,33,23,1,1
"912343343",50,3063.41569505493,3009.31006149283,2635.48551585152,27,23,1,1
"912343344",50,2934.89356527934,3292.39364974872,2635.48551585152,24,26,1,1
"912343345",55,2891.37455196643,3389.54471059678,2687.33120998132,30,25,1,1
"912343346",62,2988.74922737725,3335.73515938792,2753.94837323248,29,33,1,1
"912343347",54,2647.17108811925,3108.25620271471,2677.2712016452,24,30,1,1
"912343348",71,3307.18350148152,4104.24534038849,2831.31372136695,30,41,1,1
"912343349",51,2866.45246945716,3204.61957595669,2646.17454577679,24,27,1,1
"912343350",63,3270.39989967691,3038.67762773852,2762.96971264875,31,32,1,1
"912343351",70,2804.26288856769,3055.13973674047,2823.11677003184,31,39,1,1
"912343352",41,2467.16905371278,2118.12529112743,2530.72175773865,21,20,1,1
"912343353",28,2452.15222966831,2149.81441887253,2340.94327947849,14,14,1,1
"912343354",53,3228.92444399678,3177.98580309802,2667.061866114,25,28,1,1
"912343355",36,2776.21587781918,2999.22664220213,2464.33502634194,21,15,1,1
"912343356",44,3052.78867366074,3386.34758926206,2567.51523707907,26,18,1,1
"912343357",51,3355.98528573377,3251.3089382862,2646.17454577679,30,21,1,1
"912343358",36,2154.85955667003,1811.10472700804,2464.33502634194,16,20,1,1
"912343359",37,2000.16877050594,1128.07011363124,2478.17471526668,16,21,1,1
"912343400",43,3009.4411473894,3213.24953117663,2555.47878346624,21,22,1,1
"912343401",40,2921.78933026502,3269.38614585037,2517.98110851286,22,18,1,1
"912343407",57,2989.41537810382,3487.35203470617,2707.02236739438,29,28,1,1
"912343408",47,2951.89242919019,3033.4559447383,2602.36394728806,22,25,1,1
"912343409",53,3308.01365031407,3722.22753438625,2667.061866114,25,28,1,1
"912343410",55,3208.22969101958,3486.31704937895,2687.33120998132,25,30,1,1
"912343411",44,2939.40643873295,3170.12303600624,2567.51523707907,23,21,1,1
"912343412",46,3096.87849644515,3535.04455259871,2590.94954296761,20,26,1,1
"912343413",58,3140.12791554343,3547.46777929029,2716.66249357165,27,31,1,1
"912343414",58,3466.38710274677,3776.55959942126,2716.66249357165,30,28,1,1
"912343415",53,3073.13096860753,2779.1817350487,2667.061866114,21,32,1,1
"912343416",55,3613.05600275654,3693.43806332531,2687.33120998132,32,23,1,1
"912343417",50,2981.58369222911,2823.47729034807,2635.48551585152,22,28,1,1
"912343418",45,3535.33883698621,3569.20795744126,2579.33597919865,18,27,1,1
"912343419",35,2577.52958509828,2551.57352017186,2450.1860183293,21,14,1,1
"912343421",19,2102.25865334552,2067.90573048725,2162.56636020013,11,8,1,1
"912343422",38,2568.89362155608,2635.30962092996,2491.71993967651,25,13,1,1
"912343423",61,3385.33912721582,3204.0656384943,2744.81051624266,23,38,1,1
"912343424",50,3426.7715104339,3556.75929173198,2635.48551585152,20,30,1,1
"912343425",53,2822.8196884715,2531.58096317477,2667.061866114,27,26,1,1
"912343427",44,2921.61310805294,2917.8230991937,2567.51523707907,28,16,1,1
"912343428",40,2706.2830995132,2722.52407378989,2517.98110851286,23,17,1,1
"912343429",42,2655.72401745084,2680.56971002483,2543.21752514954,26,16,1,1
"912343430",49,2876.63546359194,2666.90385093251,2624.62502504328,27,22,1,1
"912343431",32,2485.8628989293,2164.46527462978,2405.71569249515,20,12,1,1
"912343432",36,2699.72562239843,2333.99321827844,2464.33502634194,19,17,1,1
"912343433",39,2583.58540638345,2630.02172972521,2504.98447234734,26,13,1,1
"912343434",43,2713.18895970747,2396.10060418159,2555.47878346624,26,17,1,1
"912343748",38,2816.84098608134,2965.70790643368,2491.71993967651,16,22,1,1
"912343750",65,2956.97492187665,3053.32516027871,2780.67589681985,31,34,1,1
"912343751",43,3086.08021140539,3031.87079910019,2555.47878346624,19,24,1,1
"912343752",41,2937.08138936875,2860.29889071729,2530.72175773865,24,17,1,1
"912343753",53,3336.45408743471,3097.88613963994,2667.061866114,30,23,1,1
"912343754",42,3064.21292973064,2781.69887952564,2543.21752514954,25,17,1,1
"912343755",54,2909.76992041851,2590.71275850879,2677.2712016452,22,32,1,1
"912343756",68,2891.8721726865,2656.96520934495,2806.43931339586,29,39,1,1
"912343757",46,2836.04528562283,3089.92303550372,2590.94954296761,20,26,1,1
"912343758",55,3528.98830428449,3253.44960251236,2687.33120998132,24,31,1,1
"912343759",46,3283.98884700018,3189.95718056228,2590.94954296761,19,27,1,1
"912343760",43,2985.69854975358,3061.1273820627,2555.47878346624,18,25,1,1
"912343761",40,2794.601585658,3111.92978864712,2517.98110851286,21,19,1,1
"912343762",34,2748.20370021039,3383.04898345013,2435.71163614839,16,18,1,1
"912343763",66,3536.58006830402,3670.54989351493,2789.3669207067,30,36,1,1
"912343764",60,2969.01085643204,2953.38666413618,2735.5526890818,30,30,1,1
"912343765",61,2853.83437323968,3154.21236957317,2744.81051624266,28,33,1,1
"912343766",69,2939.72569361563,3041.65542002121,2814.82611826518,31,38,1,1
"912343767",60,3445.63679978642,3348.64065446839,2735.5526890818,30,30,1,1
"912343768",57,3266.57673232704,3922.02699152363,2707.02236739438,26,31,1,1
"912343769",55,3030.9805008599,2714.9394925354,2687.33120998132,25,30,1,1
"912343770",69,3581.45454499799,2965.42070255702,2814.82611826518,34,35,1,1
"912343771",54,3191.47539572142,3173.29009284249,2677.2712016452,27,27,1,1
"912343772",69,3505.52281608933,3870.31147219561,2814.82611826518,33,36,1,1
"912343773",53,3444.22510582755,4139.24407927148,2667.061866114,23,30,1,1
"912343774",56,3640.03007307394,3935.29588951677,2697.24673169728,23,33,1,1
"912343775",73,4008.25280920717,3767.80465522378,2847.4358582506,32,41,1,1
"912343776",66,3847.10520031292,3938.80455503892,2789.3669207067,31,35,1,1
"912343777",61,3883.36258626424,3514.4175692649,2744.81051624266,25,36,1,1
"912343778",70,2992.96838654236,2933.87751384788,2823.11677003184,32,38,1,1
"912343779",36,2535.18716086952,2457.09818465849,2464.33502634194,16,20,1,1
"912343780",43,3034.74844646323,3086.71204600312,2555.47878346624,19,24,1,1
"912343781",40,2938.73967575959,3420.00852986933,2517.98110851286,19,21,1,1
"912343782",37,2987.25857229797,3408.55895700986,2478.17471526668,17,20,1,1
"912343783",33,2776.00294558208,2689.15590373304,2420.89448855093,17,16,1,1
"912343784",45,2520.19512964173,2449.22764799687,2579.33597919865,24,21,1,1
"912343785",42,2867.7031060568,3495.17741400682,2543.21752514954,20,22,1,1
"912343786",40,2975.453495581,2577.348990836,2517.98110851286,19,21,1,1
"912343787",38,2628.8625267225,2779.54680739604,2491.71993967651,20,18,1,1
"912343788",29,2646.19036888865,2658.56666329489,2357.79423966008,15,14,1,1
"912343789",40,2592.0382805632,3007.04689542683,2517.98110851286,25,15,1,1
"912343790",50,2690.64969114973,2672.84702918456,2635.48551585152,24,26,1,1
"912343791",50,3032.14291611623,3673.12867120848,2635.48551585152,24,26,1,1
"912343792",58,2901.5362086261,4024.49139514665,2716.66249357165,32,26,1,1
"912343793",53,2958.62601903655,2641.91508243216,2667.061866114,29,24,1,1
"912343794",51,3142.40407070296,3865.10201918026,2646.17454577679,30,21,1,1
"912343795",47,3012.35747503048,3157.6400912074,2602.36394728806,26,21,1,1
"912343796",53,2917.77484472093,2623.58081774372,2667.061866114,23,30,1,1
"912343797",50,3311.71250786461,4083.47689244604,2635.48551585152,24,26,1,1
"912343798",54,3173.33513777372,3057.30987666549,2677.2712016452,19,35,1,1
"912343799",51,3096.46194863278,3570.36045213292,2646.17454577679,25,26,1,1
"912343800",49,3471.95051698497,3721.10732927839,2624.62502504328,20,29,1,1
"912343801",61,2869.18628918896,1748.18517260965,2744.81051624266,23,38,1,1
"912343802",59,3221.88282902778,2839.09170561435,2726.17127719361,28,31,1,1
"912343803",59,3689.76797158664,3867.23240423727,2726.17127719361,28,31,1,1
"912343804",50,2690.74540535433,2561.61503969765,2635.48551585152,22,28,1,1
"912343805",65,2972.85110067834,2710.55974247835,2780.67589681985,34,31,1,1
"912343807",47,2943.11878341746,2848.80393660628,2602.36394728806,22,25,1,1
"912343808",52,3095.60357951314,3081.41432650658,2656.6981055205,24,28,1,1
"912343809",60,3472.99233061668,3468.91906145472,2735.5526890818,29,31,1,1
"912343810",63,3380.46271239317,4258.68845856558,2762.96971264875,27,36,1,1
"912343811",50,3017.87923739923,3118.96966411557,2635.48551585152,28,22,1,1
"912343813",46,2850.69399643531,2983.1287966355,2590.94954296761,21,25,1,1
"912343814",27,2466.8527295504,2607.23202598342,2323.60649590586,15,12,1,1
"912343815",65,3243.91366910387,3095.14375215502,2780.67589681985,34,31,1,1
"912343816",74,3027.55050181068,2573.89323052483,2855.36548874306,40,34,1,1
"912343817",85,3442.18841508172,3117.63489922609,2937.40494579778,44,41,1,1
"912343818",55,2816.31159517162,2695.90788962362,2687.33120998132,27,28,1,1
"912343819",34,2578.2868802214,2342.07097216246,2435.71163614839,18,16,1,1
"912343820",8,1805.97122911304,1922.89757145678,1812.11073017574,6,2,1,1
"912343821",26,2319.59446158843,2611.93030224269,2305.75108410937,14,12,1,1
"912343822",32,2583.78111057439,2570.92479347666,2405.71569249515,15,17,1,1
"912343823",24,2429.25596772708,2696.88910532462,2268.33468283819,9,15,1,1
"912343824",6,1812.02593354677,1883.76925963351,1708.62817714657,2,4,1,1
"912343825",29,2275.54255359388,2390.38518585169,2357.79423966008,16,13,1,1
"912343826",35,2542.93064079758,2657.04834270496,2450.1860183293,16,19,1,1
"912343827",22,2206.3547042248,2569.48915995396,2228.3491786518,11,11,1,1
"912343828",9,1931.91265071024,1981.30303281758,1856.26587460569,5,4,1,1
"912343829",28,2523.11576277406,2375.95464653679,2340.94327947849,16,12,1,1
"912343831",24,2337.09793860772,2710.85326256313,2268.33468283819,13,11,1,1
"912344164",34,2627.24159866539,2855.32991730201,2435.71163614839,11,23,1,1
"912344165",34,2755.14464019564,3067.17084373415,2435.71163614839,15,19,1,1
"912344166",39,2903.96049537989,3111.59300253585,2504.98447234734,16,23,1,1
"912344167",47,3113.07170517997,3491.96063965691,2602.36394728806,16,31,1,1
"912344168",43,3162.30615656631,3669.30742036291,2555.47878346624,18,25,1,1
"912344169",49,3261.17366399256,3974.25949073439,2624.62502504328,25,24,1,1
"912344170",42,3211.867120432,3914.26139542476,2543.21752514954,20,22,1,1
"912344171",34,2885.52135233882,3217.01518323469,2435.71163614839,16,18,1,1
"912344172",34,3232.99916978956,3329.08484212003,2435.71163614839,17,17,1,1
"912344173",54,3255.51351458868,3512.66900577668,2677.2712016452,23,31,1,1
"912344174",52,3367.07536107329,3554.1010702888,2656.6981055205,21,31,1,1
"912344175",34,2719.13343740941,3130.90557869205,2435.71163614839,16,18,1,1
"912344176",30,2775.28155519577,2914.03596008825,2374.18906024059,17,13,1,1
"912344177",29,2316.97596774333,2355.30619399193,2357.79423966008,14,15,1,1
"912344178",36,2577.7621346652,2770.10939206097,2464.33502634194,18,18,1,1
"912344179",65,3652.01539857786,3731.32888236848,2780.67589681985,23,42,1,1
"912344180",53,3058.50223053603,3107.88065420772,2667.061866114,17,36,1,1
"912344181",49,3177.18642272902,3034.93664713028,2624.62502504328,18,31,1,1
"912344183",50,3087.05186986636,3143.31645091044,2635.48551585152,19,31,1,1
"912344185",44,2761.41015969996,2904.47502892555,2567.51523707907,20,24,1,1
"912344186",52,2752.41856574901,2837.60237858918,2656.6981055205,20,32,1,1
"912344187",51,3269.46009099314,3825.76650243806,2646.17454577679,21,30,1,1
"912344188",38,2958.19680610688,3603.40049215272,2491.71993967651,16,22,1,1
"912344189",61,3439.2823556596,3028.12545080675,2744.81051624266,22,39,1,1
"912344190",56,3003.34150665456,2921.8434171806,2697.24673169728,20,36,1,1
"912344191",74,3737.55992778602,4664.233194077,2855.36548874306,31,43,1,1
"912344192",47,2944.87606098374,2721.49823311244,2602.36394728806,20,27,1,1
"912344193",61,3364.83630135783,3179.67476818166,2744.81051624266,30,31,1,1
"912344194",38,2720.45211280673,3052.9198333728,2491.71993967651,19,19,1,1
"912344195",42,2935.85180341903,3114.8751240683,2543.21752514954,19,23,1,1
"912344196",59,3525.03804165773,3508.9138473277,2726.17127719361,26,33,1,1
"912344197",63,3307.14473928813,4006.20127932096,2762.96971264875,29,34,1,1
"912344198",41,2944.41683246703,2920.4635276988,2530.72175773865,17,24,1,1
"912344199",44,3055.18530265655,3386.11198529114,2567.51523707907,15,29,1,1
"912344200",49,3016.50882239186,3266.81014332795,2624.62502504328,17,32,1,1
"912344201",52,3121.83252846487,3273.33016323267,2656.6981055205,22,30,1,1
"912344202",43,3065.86023850784,3387.94750271756,2555.47878346624,16,27,1,1
"912344203",44,3025.45231749694,3112.69627415181,2567.51523707907,18,26,1,1
"912344204",51,3663.87467788028,3867.40572265873,2646.17454577679,18,33,1,1
"912344205",59,3861.67564865583,4370.13817197766,2726.17127719361,20,39,1,1
"912344206",55,3445.28297818278,3324.25180711967,2687.33120998132,18,37,1,1
"912344207",36,2855.04144463145,3013.95292699669,2464.33502634194,17,19,1,1
"912344208",34,2762.75373848351,3027.22882230581,2435.71163614839,15,19,1,1
"912344209",40,2930.93691103946,3249.98395806183,2517.98110851286,17,23,1,1
"912344210",47,2938.52882582004,3624.57483894303,2602.36394728806,24,23,1,1
"912344211",46,3196.75155620813,3746.94394447416,2590.94954296761,21,25,1,1
"912344213",57,4148.6739012952,4541.25321767532,2707.02236739438,25,32,1,1
"912344214",60,4022.21306526149,4764.08274556172,2735.5526890818,22,38,1,1
"912344215",74,3798.14523200212,6495.58843999876,2855.36548874306,33,41,1,1
"912344217",52,3328.37399255036,3799.05561541739,2656.6981055205,21,31,1,1
"912344218",48,3359.50914075519,4095.64290879776,2613.58673801098,25,23,1,1
"912344219",47,3218.88922279146,4008.35229740787,2602.36394728806,21,26,1,1
"912344220",38,2904.50559799492,3314.48404520946,2491.71993967651,18,20,1,1
"912344221",55,3341.09721046917,3737.27605865955,2687.33120998132,21,34,1,1
"912344222",54,3395.62512476502,3599.22346824276,2677.2712016452,23,31,1,1
"912344223",37,2943.38590839922,3376.91501804778,2478.17471526668,15,22,1,1
"912344224",44,3075.17100591497,3649.38767442107,2567.51523707907,16,28,1,1
"912344225",44,3168.33843477602,3475.31079367326,2567.51523707907,13,31,1,1
"912344226",53,2992.86551647564,3202.68118180681,2667.061866114,17,36,1,1
"912344227",55,3596.60810579573,4197.43002147079,2687.33120998132,24,31,1,1
"912344228",77,3707.22840006357,3718.27662677743,2878.65357631343,35,42,1,1
"912344229",41,2986.34350903704,2888.57313809986,2530.72175773865,16,25,1,1
"912344230",54,3368.02252144264,3475.00680919472,2677.2712016452,20,34,1,1
"912344231",52,3645.85258322199,4041.04189812068,2656.6981055205,20,32,1,1
"912344232",53,3562.87744567154,4620.31880660839,2667.061866114,20,33,1,1
"912344233",45,2973.03705717557,2980.28678162276,2579.33597919865,19,26,1,1
"912344234",60,3415.03106913298,3135.00547594856,2735.5526890818,28,32,1,1
"912344235",52,2920.39458697187,2407.61732350375,2656.6981055205,23,29,1,1
"912344236",43,2759.44399197909,3191.48681321958,2555.47878346624,20,23,1,1
"912344237",92,3418.83938877029,4049.9401571423,2985.30521778333,41,51,1,1
"912344238",57,3687.95361940579,4039.02745788834,2707.02236739438,23,34,1,1
"912344239",59,3486.91230643798,4156.89112785393,2726.17127719361,21,38,1,1
"912344240",53,3341.626118855,3782.9631922729,2667.061866114,24,29,1,1
"912344241",69,4078.03121674326,5161.28886281445,2814.82611826518,27,42,1,1
"912344242",63,3231.23441154992,4157.29992967316,2762.96971264875,26,37,1,1
"912344243",53,3340.80203303964,3847.33072530173,2667.061866114,20,33,1,1
"912344244",66,3221.08598092839,4031.34883213316,2789.3669207067,33,33,1,1
"912344245",49,3467.27643316297,5136.45042310634,2624.62502504328,23,26,1,1
"912344246",65,3856.7569558369,4914.48773800394,2780.67589681985,27,38,1,1
"912344247",43,3309.9880635059,4041.75879020898,2555.47878346624,19,24,1,1
"912344248",36,2957.64336246133,3510.65790643871,2464.33502634194,14,22,1,1
"912344249",31,2516.25554624798,2621.45578101995,2390.15469389133,10,21,1,1
"912344250",30,2607.57578043213,2918.31185486853,2374.18906024059,17,13,1,1
"912344251",36,2670.38868867235,2775.000699107,2464.33502634194,19,17,1,1
"912344252",29,2594.47497485098,2613.92133985726,2357.79423966008,10,19,1,1
"912344253",33,2679.26940767401,2474.43081629996,2420.89448855093,15,18,1,1
"912344254",35,2731.96853292752,2607.84692560262,2450.1860183293,14,21,1,1
"912344255",37,2568.77232290344,2683.38079724539,2478.17471526668,14,23,1,1
"912344256",30,2256.37863664992,2203.09315933906,2374.18906024059,15,15,1,1
"912344257",33,2613.1565571701,2582.75281570776,2420.89448855093,15,18,1,1
"912344258",39,2449.90353695892,2304.03773038433,2504.98447234734,17,22,1,1
"912344259",31,2509.77968741252,2371.41129807321,2390.15469389133,13,18,1,1
"912344260",50,2996.13132676307,3152.3252077696,2635.48551585152,22,28,1,1
"912344261",38,2616.28792096237,2428.18165904543,2491.71993967651,18,20,1,1
"912344262",50,2871.60474614164,2894.25757845101,2635.48551585152,24,26,1,1
"912344263",60,3231.90143084267,3245.46780918456,2735.5526890818,29,31,1,1
"912344264",46,2955.61688698246,3814.49247705968,2590.94954296761,16,30,1,1
"912344265",44,2991.8737464998,3705.59336250714,2567.51523707907,18,26,1,1
"912344266",62,3291.39384303941,3699.10988387309,2753.94837323248,23,39,1,1
"912344267",67,3459.18818603416,3811.58584102121,2797.95380131742,27,40,1,1
"912344268",42,3128.88182522348,4151.22152796824,2543.21752514954,17,25,1,1
"912344269",10,1884.98834345008,1925.48367397297,1896.67490607898,5,5,1,1
"912344270",35,2572.65739175243,2744.15818593922,2450.1860183293,19,16,1,1
"912344271",30,2607.25191490168,2574.91419479108,2374.18906024059,13,17,1,1
"912344272",11,1935.55680805888,1925.15638392063,1933.98659929558,6,5,1,1
"912344273",34,2442.30080143534,2068.48520908606,2435.71163614839,18,16,1,1
"912344274",40,2766.82391691325,2457.77428302493,2517.98110851286,21,19,1,1
"912344275",27,2356.51262775172,2215.09153783613,2323.60649590586,14,13,1,1
"912344276",39,2850.74555619924,2613.71378004745,2504.98447234734,21,18,1,1
"912344278",17,2023.66488735152,1917.21571721683,2113.95669457394,10,7,1,1
"912344279",13,1855.7749984089,1883.80148533149,2001.16379457045,8,5,1,1
"912344280",6,1746.98960530475,1774.55915003664,1708.62817714657,2,4,1,1
"912344281",10,1901.53074607584,1897.70297916263,1896.67490607898,5,5,1,1
"912344282",23,2563.02557677698,2575.82889209569,2248.68783741607,13,10,1,1
"912344283",29,2236.8571255352,2262.04771436781,2357.79423966008,13,16,1,1
"912344284",26,2471.74258439042,2336.07314855095,2305.75108410937,13,13,1,1
"912344285",2,1370.5414309119,1372.97378875317,1364.97646362037,2,0,1,1
"912344286",23,2219.05616253901,2411.30265641705,2248.68783741607,14,9,1,1
"912344287",28,2405.98095789766,2610.22197031651,2340.94327947849,14,14,1,1
"912344288",33,2322.18099190732,2384.08753868438,2420.89448855093,16,17,1,1
"912344290",38,2553.66848119453,2585.41604733083,2491.71993967651,20,18,1,1
"912344291",35,2441.98321475731,2807.28835663993,2450.1860183293,21,14,1,1
"912344292",26,2067.33508753206,2044.43693683064,2305.75108410937,13,13,1,1
"912344293",36,2567.78384095091,2753.18171482671,2464.33502634194,17,19,1,1
"912344294",30,2343.2551201298,2152.31456014392,2374.18906024059,16,14,1,1
"912344295",38,2476.61799476079,2144.6784444732,2491.71993967651,18,20,1,1
"912344296",43,2359.84335135173,2525.26310193703,2555.47878346624,20,23,1,1
"912344297",44,2481.73035045148,2705.60480701764,2567.51523707907,22,22,1,1
"912344298",38,2714.07070466574,2696.23188272056,2491.71993967651,21,17,1,1
"912344299",32,2398.33882962311,2676.38002233133,2405.71569249515,17,15,1,1
"912344300",33,2390.75321613776,2593.07502268452,2420.89448855093,14,19,1,1
"912344301",27,2242.63081059194,2217.09404424465,2323.60649590586,11,16,1,1
"912344302",39,2375.56376465729,2446.47644364452,2504.98447234734,23,16,1,1
"912344303",37,2383.27489901654,2372.03667020617,2478.17471526668,20,17,1,1
"912344304",45,2502.85587841282,2202.19909043742,2579.33597919865,23,22,1,1
"912344305",41,2375.58345252255,2234.7926478874,2530.72175773865,20,21,1,1
"912344306",33,2249.05245085737,2197.83721379292,2420.89448855093,18,15,1,1
"912344307",34,2407.44666329304,2404.96336781001,2435.71163614839,17,17,1,1
"912344308",28,2448.38692524863,2595.62902674339,2340.94327947849,13,15,1,1
"912344309",38,2468.37695297312,2673.70601880474,2491.71993967651,21,17,1,1
"912344310",28,2403.0724204226,2610.47470573625,2340.94327947849,14,14,1,1
"912344311",29,2460.38276230762,2631.78340433971,2357.79423966008,15,14,1,1
"912344312",34,2421.95182650806,2516.93470951429,2435.71163614839,20,14,1,1
"912344313",28,2458.96515823336,2527.75413436205,2340.94327947849,15,13,1,1
"912344314",23,2340.66070175855,2334.70011781643,2248.68783741607,11,12,1,1
"912344315",31,2409.89324518748,2457.34241149461,2390.15469389133,16,15,1,1
"912344316",63,2795.0171378088,2236.68571216128,2762.96971264875,33,30,1,1
"912344317",49,2723.24063174481,2223.70957791346,2624.62502504328,23,26,1,1
"912344318",26,2225.68603492247,2514.39897566177,2305.75108410937,13,13,1,1
"912344319",31,2347.21946257134,2393.83793043587,2390.15469389133,14,17,1,1
"912344320",43,2691.18310828005,2605.15246524183,2555.47878346624,24,19,1,1
"912344321",40,2529.34109957338,2271.94551019802,2517.98110851286,22,18,1,1
"912344322",33,2695.9207605794,2859.21524514647,2420.89448855093,16,17,1,1
"912344323",47,2704.55752935705,2976.41788917779,2602.36394728806,25,22,1,1
"912344324",45,2953.89697371857,3104.56637838514,2579.33597919865,30,15,1,1
"912344325",41,2839.32950980144,2873.92989043059,2530.72175773865,24,17,1,1
"912344326",38,3021.77329430585,3412.6355568557,2491.71993967651,23,15,1,1
"912344327",21,2282.32512213466,2376.76379356623,2207.26116887512,12,9,1,1
"912344328",53,2816.43262611359,2772.11527852445,2667.061866114,23,30,1,1
"912344329",48,2759.31647189124,2820.26865902842,2613.58673801098,21,27,1,1
"912344330",28,2481.2227056268,2742.06563747238,2340.94327947849,15,13,1,1
"912344331",25,2639.78035184654,2885.83089358487,2287.34065519221,13,12,1,1
"912344332",31,2476.69332759987,2302.6888158253,2390.15469389133,19,12,1,1
"912344333",39,2691.42477907022,2443.6063388041,2504.98447234734,23,16,1,1
"912344334",40,2876.21182665398,2683.46221732126,2517.98110851286,21,19,1,1
"912344335",42,2700.67132242126,2500.35042063191,2543.21752514954,23,19,1,1
"912344336",43,2840.6892128225,3060.76290542038,2555.47878346624,27,16,1,1
"912344337",38,2543.99502071197,2584.61633007262,2491.71993967651,19,19,1,1
"912344338",45,2717.28614926986,2655.29120815208,2579.33597919865,23,22,1,1
"912344339",36,2929.6294121366,2915.3793734855,2464.33502634194,20,16,1,1
"912344340",58,2909.42275092063,2293.65027108062,2716.66249357165,31,27,1,1
"912344341",45,2857.12974285393,2827.58183044871,2579.33597919865,27,18,1,1
"912344342",36,2769.24092031456,2925.45388738826,2464.33502634194,18,18,1,1
"912344343",35,2738.63120295067,3163.33491415293,2450.1860183293,19,16,1,1
"912344344",53,3057.68104347124,3100.6470059964,2667.061866114,28,25,1,1
"912344345",50,3091.98311377082,3025.11405996218,2635.48551585152,25,25,1,1
"912344346",46,2802.5562220173,2710.95549012688,2590.94954296761,25,21,1,1
"912344347",51,2922.11052761399,2771.551552207,2646.17454577679,29,22,1,1
"912344348",22,2413.69135151081,2410.93231169755,2228.3491786518,10,12,1,1
"912344349",37,2806.17180119448,3149.91440714275,2478.17471526668,21,16,1,1
"912344350",41,2734.47401938999,2803.74773030863,2530.72175773865,23,18,1,1
"912344351",45,2749.67972297159,2746.84016489218,2579.33597919865,27,18,1,1
"912344352",39,2885.3782661553,3022.84825923623,2504.98447234734,23,16,1,1
"912344353",53,3063.07427934056,2868.50858430416,2667.061866114,33,20,1,1
"912344354",23,2290.21433800852,2168.96761169947,2248.68783741607,13,10,1,1
"912344355",19,2131.93823605481,1848.12821081847,2162.56636020013,12,7,1,1
"912344356",23,2400.8792933441,2557.46970121363,2248.68783741607,13,10,1,1
"912344357",46,2754.29869134547,2745.1651643776,2590.94954296761,24,22,1,1
"912344358",48,2561.79919560598,2592.05515316674,2613.58673801098,28,20,1,1
"912344359",51,3027.07794629746,2505.10777210868,2646.17454577679,27,24,1,1
"912344360",51,2761.75729269328,2590.54470164442,2646.17454577679,22,29,1,1
"912344361",61,2554.62346316093,2144.63298400847,2744.81051624266,31,30,1,1
"912344363",28,2642.56229678096,2657.56367560362,2340.94327947849,16,12,1,1
"912344364",41,2613.68853711668,2907.70723283345,2530.72175773865,25,16,1,1
"912344365",41,2718.5856689997,2949.46769402016,2530.72175773865,25,16,1,1
"912344366",44,2557.22493220687,1921.79000052285,2567.51523707907,21,23,1,1
"912344367",40,2403.43040278334,2444.8361957733,2517.98110851286,20,20,1,1
"912344368",30,2620.72411431186,2512.48786579408,2374.18906024059,21,9,1,1
"912344369",29,2417.48483113832,2446.11652561885,2357.79423966008,18,11,1,1
"912344370",29,2027.13801794612,1473.7353852385,2357.79423966008,9,20,1,1
"912344371",23,1983.72534519895,1877.41102355705,2248.68783741607,8,15,1,1
"912344372",24,2015.10000938736,1878.9217921208,2268.33468283819,11,13,1,1
"912344373",62,3145.34047717253,4201.71867100671,2753.94837323248,30,32,1,1
"912344374",57,3233.58092052911,3908.6247806923,2707.02236739438,27,30,1,1
"912344375",56,3465.10810509711,4131.8862809981,2697.24673169728,29,27,1,1
"912344376",65,3638.06482318542,4791.32789869649,2780.67589681985,33,32,1,1
"912344377",47,3036.63898680316,3747.077628927,2602.36394728806,24,23,1,1
"912344378",39,2822.64942057908,3283.26376921707,2504.98447234734,21,18,1,1
"912344379",10,1878.7907392436,1718.52766362982,1896.67490607898,5,5,1,1
"912344380",3,1471.12497731539,1415.97867464663,1482.92019466158,2,1,1,1
"912344381",14,1884.13652340046,1526.29642214179,2031.70713799962,5,9,1,1
"912344382",19,2090.42924242454,1836.46436172835,2162.56636020013,4,15,1,1
"912344383",14,1932.72094019748,1752.3221910359,2031.70713799962,3,11,1,1
"912344384",17,1945.61675886802,1812.04957249831,2113.95669457394,4,13,1,1
"912344385",45,2485.19267116735,2323.35006091786,2579.33597919865,22,23,1,1
"912344386",40,2522.73775574346,2556.77906554897,2517.98110851286,22,18,1,1
"912344387",43,2481.38502980104,2695.17858924417,2555.47878346624,24,19,1,1
"912344388",31,2385.59016631531,2738.95584753259,2390.15469389133,18,13,1,1
"912344389",40,2560.22574015713,2778.64914401489,2517.98110851286,23,17,1,1
"912344390",29,2299.75946224577,2342.27936648089,2357.79423966008,16,13,1,1
"912344391",34,2255.60259345268,2204.19282785453,2435.71163614839,13,21,1,1
"912344392",19,1978.0806381318,1931.56225120608,2162.56636020013,7,12,1,1
"912344464",85,3759.65586399041,2873.90265431588,2937.40494579778,44,41,1,1
"912344465",76,3446.50505176548,2912.55671701696,2870.97236507783,45,31,1,1
"912344466",76,3641.96729066395,3006.45087483187,2870.97236507783,32,44,1,1
"912344467",99,3482.39934365587,2543.3560909193,3030.38817685238,44,55,1,1
"912344468",36,2572.90012587179,2755.97508964843,2464.33502634194,23,13,1,1
"912344469",33,2893.9737309534,3050.61223811859,2420.89448855093,15,18,1,1
"912344470",17,2162.2567244268,2113.44607600612,2113.95669457394,10,7,1,1
"912344471",67,3177.8250069181,2613.84242004848,2797.95380131742,35,32,1,1
"912344472",55,2763.74081320429,2271.99316313153,2687.33120998132,26,29,1,1
"912344473",81,3307.73302970551,2322.08157327669,2908.60658576875,39,42,1,1
"912344474",80,3943.11753540491,3218.6811017998,2901.2306171403,30,50,1,1
"912344475",76,3580.19631060799,2568.70296077881,2870.97236507783,35,41,1,1
"912344476",98,3515.85893535011,2492.37608256062,3024.10627920296,48,50,1,1
"912344477",92,3416.3490056701,2889.68822098802,2985.30521778333,40,52,1,1
"912344478",80,4075.4876107072,3458.08808670745,2901.2306171403,30,50,1,1
"912344480",85,3382.15587729453,2371.54122376468,2937.40494579778,45,40,1,1
"912344481",76,3280.55024255833,2146.7981943928,2870.97236507783,40,36,1,1
"912344482",105,3590.15636572206,2779.67667075431,3067.05425459434,40,65,1,1
"912344483",89,3574.53686849954,2540.13845767038,2965.14449011489,47,42,1,1
"912344484",79,3237.39112261689,2392.97258851979,2893.78092561085,37,42,1,1
"912344485",66,3556.21110834712,3156.75614602948,2789.3669207067,27,39,1,1
"912344487",84,2791.23945540315,2034.48688339317,2930.30814451558,40,44,1,1
"912344488",81,3249.03319695478,2533.15862292385,2908.60658576875,38,43,1,1
"912344489",61,2887.81362753006,2446.91008771757,2744.81051624266,31,30,1,1
"912344490",75,3912.56326907135,2996.83477814248,2863.21031780169,34,41,1,1
"912344491",64,3171.07677189213,3078.56053877686,2771.87783482774,31,33,1,1
"912344492",65,3687.21821279886,3491.87082050582,2780.67589681985,30,35,1,1
"912344493",79,3425.05827757979,3010.9587036429,2893.78092561085,37,42,1,1
"912344494",89,3548.42615738036,3720.87840434279,2965.14449011489,41,48,1,1
"912344495",61,3140.89369108205,3318.81533303671,2744.81051624266,29,32,1,1
"912344496",60,2849.26292367875,1997.15498197791,2735.5526890818,29,31,1,1
"912344498",120,3322.42018822235,2732.99796067168,3151.91769689326,51,69,1,1
"912344499",94,3191.06970730961,3222.5668005222,2998.45695239283,41,53,1,1
"912344500",43,3042.90965307225,3061.58971619006,2555.47878346624,20,23,1,1
"912344502",79,3727.19479033663,3465.6053445892,2893.78092561085,37,42,1,1
"912344503",75,3832.45913756374,3971.76039325389,2863.21031780169,41,34,1,1
"912344504",36,2425.17788175611,2243.12285902443,2464.33502634194,20,16,1,1
"912344505",46,2489.28743794097,1936.61573572216,2590.94954296761,27,19,1,1
"912344506",78,2877.59966376633,2158.43559687977,2886.25582696583,38,40,1,1
"912344507",63,3030.71003778287,3216.65552444942,2762.96971264875,34,29,1,1
"912344508",74,3449.36756467042,3078.89635020701,2855.36548874306,35,39,1,1
"912344509",72,3317.8674800679,2723.6390707018,2839.4193288992,36,36,1,1
"912344510",79,3157.50649783279,2278.81455347748,2893.78092561085,37,42,1,1
"912344511",82,3788.24923856794,2866.21863892647,2915.91045786314,42,40,1,1
"912344512",98,3257.35370470391,2236.18917581679,3024.10627920296,39,59,1,1
"912344513",73,3165.25834568592,2628.49563162369,2847.4358582506,41,32,1,1
"912344515",57,3409.77554209257,2860.83696993874,2707.02236739438,30,27,1,1
"912344516",66,3538.07576886994,3432.78363136209,2789.3669207067,32,34,1,1
"912344517",91,4234.59268719938,3739.9175626524,2978.64386243803,41,50,1,1
"912344518",77,3502.62141445441,2968.98874456195,2878.65357631343,36,41,1,1
"912344519",65,2895.82626098532,2949.97495270878,2780.67589681985,31,34,1,1
"912344520",123,3691.5193594834,2607.38379092906,3167.86598086922,59,64,1,1
"912344521",86,3054.983021155,2789.91324795268,2944.43562859908,47,39,1,1
"912344522",110,4009.03692387746,1887.40627606232,3096.3566638509,46,64,1,1
"912344524",96,3658.04748462182,2724.49936635754,3011.38790884243,45,51,1,1
"912344526",91,4003.10573337078,3841.92781652164,2978.64386243803,40,51,1,1
"912344527",74,3366.7490507767,3530.38251595177,2855.36548874306,37,37,1,1
"912344528",88,3359.25531445123,3164.06987474763,2958.30409156145,44,44,1,1
"912344530",47,2918.5243244004,3575.22080226079,2602.36394728806,20,27,1,1
"912344531",33,2645.31762935214,2947.12575517492,2420.89448855093,14,19,1,1
"912344532",41,2837.1808622387,3250.86692417722,2530.72175773865,15,26,1,1
"912344533",52,3283.85194150295,3452.42674711003,2656.6981055205,22,30,1,1
"912344536",48,3295.99443949909,3822.03343967139,2613.58673801098,20,28,1,1
"912344537",28,2512.0557741856,2721.81926097914,2340.94327947849,9,19,1,1
"912344538",45,2793.21958032006,2526.09710469419,2579.33597919865,23,22,1,1
"912344539",59,2886.66315410636,3190.93464467862,2726.17127719361,32,27,1,1
"912344540",46,2727.87898705425,3392.81623594477,2590.94954296761,15,31,1,1
"912344541",42,2610.97634437055,2710.88316101749,2543.21752514954,17,25,1,1
"912344542",24,2435.99232228787,2821.57591768853,2268.33468283819,13,11,1,1
"912344543",54,3053.57628256428,3394.2564119988,2677.2712016452,21,33,1,1
"912344544",52,3197.23825754066,4019.34812818349,2656.6981055205,21,31,1,1
"912344545",56,3088.65462565939,3244.46870612916,2697.24673169728,28,28,1,1
"912344546",60,3285.97147764259,4199.16699764706,2735.5526890818,27,33,1,1
"912344547",59,3047.37047135231,3562.87077608307,2726.17127719361,28,31,1,1
"912344548",51,3102.2904979483,3265.50265620643,2646.17454577679,23,28,1,1
"912344549",48,3363.84983010402,4221.03244319663,2613.58673801098,20,28,1,1
"912344550",27,2316.50117165336,2946.87712266934,2323.60649590586,11,16,1,1
"912344551",42,2590.18226871789,3256.88444684367,2543.21752514954,18,24,1,1
"912344553",20,2282.46041283682,2208.99434243343,2185.35845629437,7,13,1,1
"912344554",17,2003.96098156639,1851.67537193388,2113.95669457394,5,12,1,1
"912344556",22,2427.68045504373,2500.18642412586,2228.3491786518,12,10,1,1
"912344557",24,2439.1015874406,2493.64554603294,2268.33468283819,12,12,1,1
"912344558",24,2294.9861810815,2145.86135478824,2268.33468283819,11,13,1,1
"912344559",25,2256.08071925618,2090.74038267176,2287.34065519221,10,15,1,1
"912344560",21,2053.43920995445,2078.22487864312,2207.26116887512,11,10,1,1
"912344561",17,2072.81226079733,2111.34465816133,2113.95669457394,9,8,1,1
"912344562",19,2178.21340010706,2133.32531176734,2162.56636020013,10,9,1,1
"912344563",16,2069.10316159742,2105.06959836022,2087.92318348224,8,8,1,1
"912344564",16,2014.12853576769,1828.31163473916,2087.92318348224,7,9,1,1
"912344565",22,2086.49047777728,2218.69519986129,2228.3491786518,8,14,1,1
"912344566",19,2146.13383324014,2161.96880360164,2162.56636020013,10,9,1,1
"912344568",24,2232.34066848253,2333.91449664819,2268.33468283819,12,12,1,1
"912344569",21,2069.12615446176,2324.52847325232,2207.26116887512,10,11,1,1
"912344570",25,2401.27092673887,2381.81524201096,2287.34065519221,15,10,1,1
"912344571",24,2247.71144372649,1940.26942002393,2268.33468283819,13,11,1,1
"912344572",30,2473.20115884172,2584.88593900729,2374.18906024059,16,14,1,1
"912344573",85,2702.05438950002,2784.89447520153,2937.40494579778,48,37,1,1
"912344575",95,2903.82783913529,2351.19913326766,3004.94950458202,50,45,1,1
"912344576",70,3017.35856391398,2613.84729200979,2823.11677003184,34,36,1,1
"912344581",91,3885.16394526646,5115.27248436119,2978.64386243803,39,52,1,1
"912344644",74,3755.63323689682,3403.06940843954,2855.36548874306,33,41,1,1
"912344645",76,4082.42920917472,3790.35194662898,2870.97236507783,29,47,1,1
"912344646",87,4003.0696728768,3988.94165158241,2951.40156710974,33,54,1,1
"912344647",79,4063.86984520513,4449.52515194128,2893.78092561085,35,44,1,1
"912344648",83,4417.36302118397,3924.27120167335,2923.1438046077,35,48,1,1
"912344726",22,2395.57831276486,2512.30055463828,2228.3491786518,10,12,1,1
"912344727",11,1997.0286208408,2116.07044858516,1933.98659929558,7,4,1,1
"912344728",15,2099.93100541774,2192.42498895746,2060.56118614118,8,7,1,1
"912344729",14,2095.53866640541,2184.68741191075,2031.70713799962,8,6,1,1
"912344730",9,1784.97524905576,1708.15740363158,1856.26587460569,7,2,1,1
"912344731",10,1961.82801021815,1899.23514039163,1896.67490607898,6,4,1,1
"912344732",21,2235.25366450041,2162.42183925847,2207.26116887512,13,8,1,1
"912344733",17,2133.12040088832,2343.88937598632,2113.95669457394,9,8,1,1
"912344734",15,2120.4087510785,2240.46980460156,2060.56118614118,8,7,1,1
"912344735",20,2247.25560900432,2534.64299109726,2185.35845629437,12,8,1,1
"912344736",8,1768.70275304428,1706.79205740113,1812.11073017574,5,3,1,1
"912344737",14,2211.3751705014,2220.12505167465,2031.70713799962,8,6,1,1
"912344738",14,2086.16756534378,2245.52721021296,2031.70713799962,9,5,1,1
"912344739",12,2031.3695285938,2095.28943050929,1968.69006049611,8,4,1,1
"912344740",21,2151.13159835404,2234.63644737777,2207.26116887512,13,8,1,1
"912344741",15,2008.89283442367,2086.10275555411,2060.56118614118,9,6,1,1
"912344742",17,2201.49843962904,2326.37562550203,2113.95669457394,9,8,1,1
"912344743",19,2278.97693688623,2502.39816835269,2162.56636020013,9,10,1,1
"912344744",21,2391.65425382587,2562.0202361525,2207.26116887512,12,9,1,1
"912344745",16,2211.8908868737,2542.9992420971,2087.92318348224,9,7,1,1
"912344746",17,2135.40254976869,2271.69692370758,2113.95669457394,12,5,1,1
"912344747",12,1988.39296789484,2085.60806217353,1968.69006049611,7,5,1,1
"912344748",13,1941.68817228981,2021.31710835079,2001.16379457045,8,5,1,1
"912344749",9,1844.09010752111,1911.24588096255,1856.26587460569,5,4,1,1
"912344750",12,2144.54797218524,2364.5126822312,1968.69006049611,5,7,1,1
"912344751",16,2167.8125719509,2403.52586952307,2087.92318348224,10,6,1,1
"912344753",10,1930.63051625029,1982.03467010344,1896.67490607898,8,2,1,1
"912344754",19,2181.44606527053,2208.66517188631,2162.56636020013,12,7,1,1
"912344755",27,2463.45316358656,2221.34697023153,2323.60649590586,15,12,1,1
"912344756",17,2077.07015846673,2243.23699813406,2113.95669457394,11,6,1,1
"912344757",15,2191.76561284768,2294.84181172726,2060.56118614118,8,7,1,1
"912344794",22,2141.83501124662,2003.82029534635,2228.3491786518,11,11,1,1
"912344795",23,2108.29805916928,2063.03858653147,2248.68783741607,10,13,1,1
"912344796",18,2106.59152267823,1925.86330374539,2138.79896507223,9,9,1,1
"912344797",19,2095.30550077072,1964.5600014616,2162.56636020013,9,10,1,1
"912344798",14,1940.91668528497,2001.90255082849,2031.70713799962,6,8,1,1
"912344799",9,1875.81683880403,2001.33883014606,1856.26587460569,4,5,1,1
"912344800",11,1778.42054557368,1750.0359275531,1933.98659929558,5,6,1,1
"912344801",19,1983.47013894716,1649.59144924282,2162.56636020013,7,12,1,1
"912344802",17,2021.13033700826,2135.1034725934,2113.95669457394,7,10,1,1
"912344803",16,2007.18667378105,1963.45207324782,2087.92318348224,7,9,1,1
"912344804",24,2091.5242853083,1983.054364576,2268.33468283819,11,13,1,1
"912344805",19,2101.45938509052,1958.64725452895,2162.56636020013,9,10,1,1
"912344806",19,2137.13448564274,2012.64549445325,2162.56636020013,11,8,1,1
"912344807",12,1926.63339572356,1911.31064023138,1968.69006049611,5,7,1,1
"912344808",20,2098.52263747564,2001.5955035982,2185.35845629437,10,10,1,1
"912344809",13,1982.0978137101,1976.92640810382,2001.16379457045,8,5,1,1
"912344810",18,1996.16429078121,2053.71235239605,2138.79896507223,10,8,1,1
"912344811",20,2136.62888023026,1902.1571831028,2185.35845629437,10,10,1,1
"912344812",19,2036.77200196333,1983.30958545964,2162.56636020013,7,12,1,1
"912344813",16,2022.82108353076,1976.97998195523,2087.92318348224,9,7,1,1
"912344814",18,1960.07038740049,1859.41903325762,2138.79896507223,8,10,1,1
"912344815",13,1944.04270111736,1871.64047284735,2001.16379457045,6,7,1,1
"912344816",12,1924.68417831925,1738.63215254171,1968.69006049611,6,6,1,1
"912344818",21,2078.02112999281,2057.2641797013,2207.26116887512,6,15,1,1
"912344819",23,2153.66553445623,1744.77187019075,2248.68783741607,9,14,1,1
"912344820",15,2125.49227605489,1940.17599751072,2060.56118614118,7,8,1,1
"912344821",20,2129.90345531671,2269.50574648053,2185.35845629437,10,10,1,1
"912344822",21,2123.11895117888,1834.38139344417,2207.26116887512,10,11,1,1
"912344823",15,1967.36400223501,1918.85199105778,2060.56118614118,7,8,1,1
"912344824",16,1972.05291841108,1800.43966258612,2087.92318348224,5,11,1,1
"912344825",11,1924.24575128825,1896.33088343287,1933.98659929558,5,6,1,1
"912344826",20,2177.8393722394,2083.7200601473,2185.35845629437,7,13,1,1
"912344827",15,1988.09218778403,1854.52224440755,2060.56118614118,7,8,1,1
"912344828",15,1953.13512286622,1761.36911702524,2060.56118614118,7,8,1,1
"912344877",41,3026.82179719339,3500.2017992359,2530.72175773865,21,20,1,1
"912344878",35,2935.63599781744,3663.98077729137,2450.1860183293,16,19,1,1
"912344879",36,2897.21846913709,3557.43395061983,2464.33502634194,20,16,1,1
"912344880",32,2508.41342999493,3283.3018406942,2405.71569249515,17,15,1,1
"912344881",46,2850.78157722307,3414.1161241004,2590.94954296761,22,24,1,1
"912344882",47,2982.46330640769,3368.64869747239,2602.36394728806,23,24,1,1
"912344883",55,3451.20849801441,5048.30856517279,2687.33120998132,33,22,1,1
"912344884",39,2752.02336967357,2441.53888275156,2504.98447234734,19,20,1,1
"912344885",12,1896.28589214733,1954.57002448411,1968.69006049611,6,6,1,1
"912344886",42,2779.53031455914,2488.91614664313,2543.21752514954,20,22,1,1
"912344887",29,2467.58081255763,2591.541743054,2357.79423966008,15,14,1,1
"912344888",45,2950.63502150155,3662.60220441128,2579.33597919865,22,23,1,1
"912344889",41,2343.7361906264,2777.69317805265,2530.72175773865,20,21,1,1
"912344890",33,2950.82410603977,3576.31332712518,2420.89448855093,18,15,1,1
"912344891",54,3320.16738192864,4814.57111449898,2677.2712016452,27,27,1,1
"912344892",36,2984.8775816897,4031.80176593609,2464.33502634194,22,14,1,1
"912344893",26,2448.39360265956,2734.70233073856,2305.75108410937,14,12,1,1
"912344894",24,2391.6773244265,2561.66546498916,2268.33468283819,13,11,1,1
"912344895",38,2907.22804946601,3545.49223507751,2491.71993967651,22,16,1,1
"912344896",42,2985.6734062887,3560.02457515657,2543.21752514954,24,18,1,1
"912344897",46,2648.77385554266,2870.13801755492,2590.94954296761,22,24,1,1
"912344898",35,2523.60388662599,2990.30381470176,2450.1860183293,20,15,1,1
"912344899",42,2910.71027741106,3147.23249777245,2543.21752514954,21,21,1,1
"912344900",49,2903.02658825213,3378.29299311757,2624.62502504328,23,26,1,1
"912344901",20,2355.63377287668,2705.63701776268,2185.35845629437,10,10,1,1
"912344902",52,3040.49430356261,3405.01235571083,2656.6981055205,28,24,1,1
"912344903",33,2613.79799529514,3037.31735337465,2420.89448855093,16,17,1,1
"912344904",38,2694.71362463059,3742.40573193243,2491.71993967651,21,17,1,1
"912344905",46,3119.19611137421,3663.26032547171,2590.94954296761,23,23,1,1
"912344906",45,3069.32995671679,4102.50922510863,2579.33597919865,21,24,1,1
"912344907",44,3005.28127957217,3560.58697780357,2567.51523707907,18,26,1,1
"912344908",34,2635.32881815409,3312.03537664164,2435.71163614839,15,19,1,1
"912344909",36,2952.93312615409,3640.31466841461,2464.33502634194,19,17,1,1
"912344910",59,3292.36854394513,3944.77730970678,2726.17127719361,35,24,1,1
"912344911",52,3188.85021421028,4447.68085175458,2656.6981055205,29,23,1,1
"912344912",31,2576.49938609823,2684.28361605793,2390.15469389133,17,14,1,1
"912344913",37,2586.01531909225,3005.17038141339,2478.17471526668,17,20,1,1
"912344914",34,2823.19954267023,3465.92372675244,2435.71163614839,19,15,1,1
"912344915",58,3319.76284325579,4047.60640831508,2716.66249357165,28,30,1,1
"912344916",56,3589.43195318625,4005.18201550807,2697.24673169728,30,26,1,1
"912344917",44,3186.07434838792,3901.22494527458,2567.51523707907,22,22,1,1
"912344918",34,2820.4352779768,3275.41278034605,2435.71163614839,17,17,1,1
"912344919",58,3340.98002597591,3747.6491020073,2716.66249357165,28,30,1,1
"912344920",33,2539.3683396563,3102.19421364665,2420.89448855093,14,19,1,1
"912344921",41,2900.59299336861,3511.689512727,2530.72175773865,24,17,1,1
"912344923",39,2643.30465520994,2750.6871564783,2504.98447234734,21,18,1,1
"912344925",38,2334.25626239289,2501.49000553104,2491.71993967651,22,16,1,1
"912344926",47,3339.38003733548,4105.56009340729,2602.36394728806,25,22,1,1
"912344927",25,2319.56849935193,2395.62915478476,2287.34065519221,14,11,1,1
"912344928",43,3021.55394613973,3725.10674693358,2555.47878346624,22,21,1,1
"912344929",47,2813.88027699223,3108.63460950102,2602.36394728806,24,23,1,1
"912344930",59,3338.64669936263,3967.47675881707,2726.17127719361,30,29,1,1
"912344931",49,3162.1121120589,3339.98613865461,2624.62502504328,26,23,1,1
"912344932",51,3220.62426593116,3983.02822638152,2646.17454577679,27,24,1,1
"912344933",45,3146.77643756825,3842.66592076651,2579.33597919865,21,24,1,1
"912344934",33,2550.20974143306,2748.66189007713,2420.89448855093,20,13,1,1
"912344935",51,2995.66188554763,3701.68955160984,2646.17454577679,29,22,1,1
"912344936",40,2875.36254883891,3907.9554026483,2517.98110851286,22,18,1,1
"912344937",34,2643.77216256102,3339.65650637991,2435.71163614839,20,14,1,1
"912344938",34,2778.14364999799,3324.23436020057,2435.71163614839,18,16,1,1
"912344939",30,2718.6479202793,3068.75380149239,2374.18906024059,16,14,1,1
"912344940",41,3021.78415649656,3565.8534154464,2530.72175773865,23,18,1,1
"912344941",42,3207.40990819006,3995.0750227719,2543.21752514954,23,19,1,1
"912344942",47,2868.19971616799,3194.78227171875,2602.36394728806,25,22,1,1
"912344943",42,2774.99978905828,3255.38012446808,2543.21752514954,26,16,1,1
"912344944",43,3010.18191157086,3784.10960660686,2555.47878346624,25,18,1,1
"912344945",38,2911.04133408188,2889.15849785909,2491.71993967651,19,19,1,1
"912344946",42,2772.93224106822,2847.87432338255,2543.21752514954,23,19,1,1
"912344947",22,2285.55475246856,2491.369498651,2228.3491786518,13,9,1,1
"912344948",31,2661.16383810256,2910.04794565716,2390.15469389133,18,13,1,1
"912344949",34,2645.29534174812,3017.60089715447,2435.71163614839,15,19,1,1
"912344950",38,2754.4618876383,3186.65750150309,2491.71993967651,21,17,1,1
"912344951",36,2909.99860482902,3825.03297765814,2464.33502634194,19,17,1,1
"912344952",41,3140.27146273615,4218.11754791395,2530.72175773865,22,19,1,1
"912344953",41,2920.12268588725,3988.90105738477,2530.72175773865,22,19,1,1
"912344954",57,3226.03826530821,4882.53366517418,2707.02236739438,33,24,1,1
"912344955",46,2874.78285396977,2921.40970417941,2590.94954296761,27,19,1,1
"912344956",43,2901.19641062216,2802.61286575129,2555.47878346624,23,20,1,1
"912344957",45,2898.37084198562,3268.42039851703,2579.33597919865,21,24,1,1
"912344958",37,2777.01955695042,2770.8667719072,2478.17471526668,20,17,1,1
"912344959",45,3041.54384429334,3940.44391911769,2579.33597919865,24,21,1,1
"912344960",43,3176.68420206792,3581.1199134153,2555.47878346624,25,18,1,1
"912344961",35,2765.00020289614,3443.87994865955,2450.1860183293,19,16,1,1
"912344962",35,2893.42506789339,3383.335148497,2450.1860183293,18,17,1,1
"912344963",46,2770.93677360356,3221.06902401183,2590.94954296761,27,19,1,1
"912344964",56,3201.38576214282,3847.3562884068,2697.24673169728,31,25,1,1
"912344965",38,2606.0572084586,2721.44539571648,2491.71993967651,24,14,1,1
"912344967",35,2629.63738010703,3069.06258832436,2450.1860183293,19,16,1,1
"912344969",42,2901.08118988416,3749.58446667569,2543.21752514954,21,21,1,1
"912344970",67,3731.85776389776,4163.0419486014,2797.95380131742,34,33,1,1
"912344971",58,3488.74497282568,4420.98459971204,2716.66249357165,32,26,1,1
"912344972",41,3032.3855288302,3548.81696195835,2530.72175773865,21,20,1,1
"912345033",20,2439.8191786437,2564.95627849149,2185.35845629437,11,9,1,1
"912345034",22,2531.68904217952,2672.02771821608,2228.3491786518,12,10,1,1
"912345035",21,2502.71577743754,2684.14441412207,2207.26116887512,13,8,1,1
"912345036",19,2439.08872267055,2578.23637208914,2162.56636020013,11,8,1,1
"912345037",24,2547.81968756937,2743.22562532587,2268.33468283819,14,10,1,1
"912345038",28,2696.24006468184,2986.20709189945,2340.94327947849,16,12,1,1
"912345091",7,1708.85829699578,1296.61795991624,1763.32076508842,3,4,1,1
"912345092",9,1771.79372261847,1601.20134663155,1856.26587460569,4,5,1,1
"912345093",7,1709.44178204952,1586.48252219061,1763.32076508842,1,6,1,1
"912345094",11,1831.94426587645,1736.58557404693,1933.98659929558,1,10,1,1
"912345095",12,1770.7404049763,1493.3451391397,1968.69006049611,1,11,1,1
"912345097",8,1773.88629579208,1951.98699109181,1812.11073017574,0,8,1,1
"912345098",5,1613.6643576441,1468.27079230909,1646.12614877363,1,4,1,1
"912345099",7,1800.98529850456,1953.90879845719,1763.32076508842,0,7,1,1
"912345101",8,1731.48013502835,1747.97213389328,1812.11073017574,3,5,1,1
"912345102",13,1831.05044093558,1867.28513763957,2001.16379457045,3,10,1,1
"912345103",10,1814.64909376498,1809.26363622326,1896.67490607898,2,8,1,1
"912345104",9,1739.68729002108,1599.47664678104,1856.26587460569,2,7,1,1
"912345105",6,1724.71805881063,1986.3047811543,1708.62817714657,1,5,1,1
"912345106",5,1670.08930527589,1930.78932879871,1646.12614877363,1,4,1,1
"912345107",10,1846.90765365067,1968.22969138921,1896.67490607898,1,9,1,1
"912345108",12,1842.73068561317,1754.01865497371,1968.69006049611,2,10,1,1
"912345109",13,1846.47979267944,1728.5373996724,2001.16379457045,5,8,1,1
"912345110",8,1724.77665678977,1718.56659452492,1812.11073017574,2,6,1,1
"912345111",7,1735.65264058968,1885.52496340145,1763.32076508842,1,6,1,1
"912345112",5,1690.60958766006,1874.01668210237,1646.12614877363,0,5,1,1
"912345113",6,1711.62683872933,1787.94546830864,1708.62817714657,0,6,1,1
"912345114",6,1741.03239833594,1957.54398991984,1708.62817714657,1,5,1,1
"912345115",7,1826.48188013437,2032.81120720651,1763.32076508842,2,5,1,1
"912345116",9,1842.30130135335,1606.55039491259,1856.26587460569,2,7,1,1
"912345117",9,1790.11427536156,1740.20195095781,1856.26587460569,2,7,1,1
"912345118",8,1845.61308785146,2019.50612505499,1812.11073017574,2,6,1,1
"912345119",7,1799.92849721869,2065.91279414036,1763.32076508842,1,6,1,1
"912345360",42,2892.16683827288,2942.83834732144,2543.21752514954,30,12,1,1
"912345361",39,3021.2956915479,3162.60871009367,2504.98447234734,26,13,1,1
"912345362",45,2907.35562327061,3029.47093059323,2579.33597919865,29,16,1,1
"912345363",45,3058.48454264041,2997.83523254539,2579.33597919865,28,17,1,1
"912345364",44,2995.2494675565,2864.92526104373,2567.51523707907,27,17,1,1
"912345365",47,3137.71913940481,3198.93676318828,2602.36394728806,31,16,1,1
"912345366",42,3142.2601232235,3518.9405547046,2543.21752514954,26,16,1,1
"912345367",51,3334.16558491337,3647.31726426282,2646.17454577679,32,19,1,1
"912345368",55,3413.03202858915,3892.06039433058,2687.33120998132,32,23,1,1
"912345369",44,2783.06234457282,2894.15633663805,2567.51523707907,27,17,1,1
"912345370",56,3093.48249619492,3852.99931159641,2697.24673169728,31,25,1,1
"912345371",55,3392.51191403399,5216.4034486905,2687.33120998132,31,24,1,1
"912345372",37,2971.4321194815,3314.12939727031,2478.17471526668,24,13,1,1
"912345373",31,2555.80946368256,3123.34175741687,2390.15469389133,19,12,1,1
"912345374",58,3277.9732637414,4064.81590279203,2716.66249357165,32,26,1,1
"912345375",47,2898.84247088881,3639.65871967584,2602.36394728806,30,17,1,1
"912345376",65,3584.81073891474,3209.09499028918,2780.67589681985,37,28,1,1
"912345377",59,3534.42965746724,3812.24106193405,2726.17127719361,34,25,1,1
"912345378",39,2726.21351148834,2300.42716621836,2504.98447234734,20,19,1,1
"912345379",32,2577.44869795714,2068.80392883974,2405.71569249515,16,16,1,1
"912345380",46,2854.21361680441,2725.73849238501,2590.94954296761,25,21,1,1
"912345381",62,3287.08889832597,2998.10324922514,2753.94837323248,32,30,1,1
"912345382",56,3207.24123028601,2993.28229843962,2697.24673169728,31,25,1,1
"912345383",75,3400.8649995482,2971.10590720114,2863.21031780169,43,32,1,1
"912345384",55,2963.00454201391,2743.96262081697,2687.33120998132,30,25,1,1
"912345385",50,2809.22868607549,2547.22270414483,2635.48551585152,28,22,1,1
"912345386",52,2896.7430361883,2789.27438766712,2656.6981055205,28,24,1,1
"912345387",58,3135.31380808422,3237.11094052581,2716.66249357165,35,23,1,1
"912345388",66,3744.02437074667,4899.31669423465,2789.3669207067,38,28,1,1
"912345389",59,3595.90013320495,3631.81378085957,2726.17127719361,35,24,1,1
"912345390",55,3338.74064683319,4060.00500821651,2687.33120998132,30,25,1,1
"912345391",16,2094.96778554542,2221.31380635059,2087.92318348224,12,4,1,1
"912345392",28,2471.85225889551,2652.06545610975,2340.94327947849,16,12,1,1
"912345393",24,2268.55032220054,2112.17552459732,2268.33468283819,12,12,1,1
"912345394",21,2164.69637591806,1952.23018131532,2207.26116887512,12,9,1,1
"912345395",19,2230.13986074409,1970.63557601777,2162.56636020013,9,10,1,1
"912345396",32,2473.35401142619,2843.50362282945,2405.71569249515,17,15,1,1
"912345397",48,3192.81794658706,3092.22416781276,2613.58673801098,26,22,1,1
"912345398",24,2348.1126892649,2266.13298230848,2268.33468283819,16,8,1,1
"912345399",45,2729.71577309273,3036.89233297421,2579.33597919865,31,14,1,1
"912345400",47,2962.72230536907,3849.28163373813,2602.36394728806,30,17,1,1
"912345402",45,2761.97669624621,3341.24683761937,2579.33597919865,26,19,1,1
"912345403",42,2739.36959130556,3265.53250168136,2543.21752514954,28,14,1,1
"912345404",8,1848.9548710573,1981.12686269049,1812.11073017574,4,4,1,1
"912345405",13,2073.79776238927,2328.14699364463,2001.16379457045,8,5,1,1
"912345406",22,2244.40132416917,2463.66119616668,2228.3491786518,12,10,1,1
"912345407",38,2624.43090510434,2512.02472169214,2491.71993967651,21,17,1,1
"912345408",41,2724.72374713613,2692.14121938074,2530.72175773865,21,20,1,1
"912345409",36,2665.99667216837,2624.98604267034,2464.33502634194,21,15,1,1
"912345410",46,2927.73037133231,2986.92395722102,2590.94954296761,26,20,1,1
"912345411",56,3057.57276462669,3417.54132072991,2697.24673169728,34,22,1,1
"912345412",46,2840.2450495524,3286.81964591325,2590.94954296761,24,22,1,1
"912345413",48,3090.50542490136,3015.76435698991,2613.58673801098,34,14,1,1
"912345414",49,2739.55324230775,3013.0357218479,2624.62502504328,34,15,1,1
"912345415",53,3196.09251448825,3386.11794609082,2667.061866114,32,21,1,1
"912345416",40,2297.97820412706,2005.07981214434,2517.98110851286,26,14,1,1
"912345417",54,2771.06276864238,3078.42810840383,2677.2712016452,33,21,1,1
"912345418",37,2551.7695189846,2303.74936925841,2478.17471526668,23,14,1,1
"912345419",45,2605.40042972681,2747.73465082038,2579.33597919865,29,16,1,1
"912345420",53,3016.76851309107,2348.84321978576,2667.061866114,34,19,1,1
"912345421",48,2820.86369010901,2937.56761344027,2613.58673801098,30,18,1,1
"912345422",43,2884.58752479095,2311.13175458721,2555.47878346624,24,19,1,1
"912345423",54,3408.07521364618,4253.13906159616,2677.2712016452,31,23,1,1
"912345425",49,2981.77226187895,3071.81480920418,2624.62502504328,26,23,1,1
"912345426",66,3105.00168030151,4068.19756004173,2789.3669207067,32,34,1,1
"912345427",64,3545.98778712697,4210.6118421227,2771.87783482774,37,27,1,1
"912345428",54,3093.12459420163,3454.74669025563,2677.2712016452,28,26,1,1
"912345429",49,3093.92388851153,2860.9439512353,2624.62502504328,31,18,1,1
"912345432",63,3488.24881426555,3676.72495101871,2762.96971264875,35,28,1,1
"912345433",67,3975.2932128739,4263.2231177861,2797.95380131742,36,31,1,1
"912345434",40,2866.82641430326,2660.37438275986,2517.98110851286,24,16,1,1
"912345435",27,2645.87913073295,2416.12461981165,2323.60649590586,15,12,1,1
"912345436",56,2711.59055258652,2193.16917595582,2697.24673169728,31,25,1,1
"912345437",62,3119.34700675344,3363.03406544495,2753.94837323248,32,30,1,1
"912345438",30,2373.05384607225,2372.49618037116,2374.18906024059,19,11,1,1
"912345439",51,2876.89226020367,2492.59848975583,2646.17454577679,31,20,1,1
"912345440",57,2999.43330248916,3234.52906671935,2707.02236739438,25,32,1,1
"912345441",40,2766.1958971143,3042.75124003212,2517.98110851286,17,23,1,1
"912345442",58,3099.41066517811,2667.9027862088,2716.66249357165,30,28,1,1
"912345443",53,3190.71872793416,2836.01771037431,2667.061866114,25,28,1,1
"912345444",61,3415.11459423595,2906.42866959098,2744.81051624266,32,29,1,1
"912345445",70,3348.66585056996,2791.71592020463,2823.11677003184,33,37,1,1
"912345446",67,3315.29954749293,4103.23144888414,2797.95380131742,38,29,1,1
"912345447",57,3002.88606407563,3803.92488921379,2707.02236739438,31,26,1,1
"912345448",40,2968.86082885912,3389.34172484203,2517.98110851286,19,21,1,1
"912345449",51,3171.42226604456,3791.7001949554,2646.17454577679,30,21,1,1
"912345450",65,3402.45990690806,2323.52754664342,2780.67589681985,29,36,1,1
"912345451",80,3227.66471071133,2556.18830139105,2901.2306171403,36,44,1,1
"912345453",66,2986.34769545266,2796.72636996409,2789.3669207067,35,31,1,1
"912345454",9,1825.84710410213,1818.32542175412,1856.26587460569,5,4,1,1
"912345455",8,1820.89135816754,1838.99492533727,1812.11073017574,3,5,1,1
"912345456",54,3089.76123108314,3152.44103471376,2677.2712016452,28,26,1,1
"912345457",54,3320.44357188004,3389.97877039634,2677.2712016452,30,24,1,1
"912345458",70,3429.39707043409,3301.42216285024,2823.11677003184,34,36,1,1
"912345459",77,3670.61985579322,3637.50498824074,2878.65357631343,45,32,1,1
"912345460",50,2981.44628621306,2884.97570400826,2635.48551585152,29,21,1,1
"912345461",60,3280.39123613844,3418.42404329422,2735.5526890818,26,34,1,1
"912345462",61,3279.0433998476,3102.75316396011,2744.81051624266,32,29,1,1
"912345463",47,3039.65068385413,2900.88917312215,2602.36394728806,26,21,1,1
"912345464",33,2530.11287638525,2485.49438010481,2420.89448855093,20,13,1,1
"912345465",42,3015.76560117872,2839.49048962444,2543.21752514954,23,19,1,1
"912345466",41,2938.54134146444,2784.82179836477,2530.72175773865,23,18,1,1
"912345467",19,2136.76949314279,1851.48098293848,2162.56636020013,11,8,1,1
"912345468",18,2193.8940300328,2306.0658788469,2138.79896507223,8,10,1,1
"912345469",52,2468.52988203136,2007.64500681853,2656.6981055205,28,24,1,1
"912345470",35,2869.04684675247,2642.61988734104,2450.1860183293,24,11,1,1
"912345471",87,3676.59970579019,3847.91379471771,2951.40156710974,48,39,1,1
"912345472",39,3029.40366621155,3299.5300463703,2504.98447234734,22,17,1,1
"912345473",44,2932.3302708177,2615.63459326206,2567.51523707907,22,22,1,1
"912345474",53,3675.8134949053,3562.28017116852,2667.061866114,24,29,1,1
"912345475",45,3080.41971435638,3045.75531116763,2579.33597919865,25,20,1,1
"912345477",76,3616.61432383324,4608.39691650581,2870.97236507783,43,33,1,1
"912345478",25,2542.71766152966,2672.63816904272,2287.34065519221,13,12,1,1
"912345479",20,2147.26856168384,1869.41620788122,2185.35845629437,11,9,1,1
"912345480",51,2863.92640000187,2712.57519620516,2646.17454577679,33,18,1,1
"912345481",33,2620.99091251293,2695.49296290392,2420.89448855093,21,12,1,1
"912345482",48,2819.55010190048,2476.92250879674,2613.58673801098,23,25,1,1
"912345483",45,3030.85436989084,2752.16405224813,2579.33597919865,20,25,1,1
"912345484",52,3207.69154632592,3466.62551258674,2656.6981055205,27,25,1,1
"912345485",59,3182.08385915752,2550.87084560164,2726.17127719361,32,27,1,1
"912345486",80,3496.97602192691,2582.35169580748,2901.2306171403,41,39,1,1
"912345487",79,3617.0283296056,4169.29039537301,2893.78092561085,47,32,1,1
"912345488",84,3401.90129058806,3927.59790574211,2930.30814451558,41,43,1,1
"912345489",37,2669.85495433528,2404.00166599132,2478.17471526668,21,16,1,1
"912345490",53,3228.04027143424,3233.9748638707,2667.061866114,32,21,1,1
"912345491",44,2922.94322911977,2866.01046844029,2567.51523707907,26,18,1,1
"912345492",56,2841.70611969677,2154.34781348458,2697.24673169728,30,26,1,1
"912345493",28,2237.65101888362,2146.31508140269,2340.94327947849,14,14,1,1
"912345494",41,2919.86232834654,2450.18542934731,2530.72175773865,19,22,1,1
"912345495",57,3520.67168812102,3648.91408906062,2707.02236739438,29,28,1,1
"912345496",65,3668.59666836343,4089.80371242153,2780.67589681985,30,35,1,1
"912345497",57,3759.33235458708,4013.99200245115,2707.02236739438,29,28,1,1
"912345498",54,3030.8611379539,3076.61280427878,2677.2712016452,27,27,1,1
"912345499",38,2667.58783611974,2929.8177683137,2491.71993967651,16,22,1,1
"912345500",76,3434.30325977212,3290.33200789128,2870.97236507783,42,34,1,1
"912345501",43,2686.59059089132,3099.3780435032,2555.47878346624,22,21,1,1
"912345502",60,2950.64389256066,3150.66922971172,2735.5526890818,33,27,1,1
"912345505",45,2783.23423647462,2775.42002480416,2579.33597919865,18,27,1,1
"912345506",51,3165.939505986,3050.18835048938,2646.17454577679,25,26,1,1
"912345507",66,3699.89708916932,4550.74086149521,2789.3669207067,33,33,1,1
"912345508",65,3561.41235101817,3626.3785635459,2780.67589681985,37,28,1,1
"912345509",62,3051.16020743236,3150.60179887479,2753.94837323248,36,26,1,1
"912345510",56,3262.58089726705,3240.50811292943,2697.24673169728,31,25,1,1
"912345511",70,3582.31543706666,3976.3757890693,2823.11677003184,35,35,1,1
"912345512",60,3092.09251058062,3210.73349291406,2735.5526890818,23,37,1,1
"912345513",52,3350.57098066018,3696.42389291456,2656.6981055205,23,29,1,1
"912345514",52,3166.38359429655,3507.45355712245,2656.6981055205,26,26,1,1
"912345515",80,3945.18039229054,3654.81002657581,2901.2306171403,43,37,1,1
"912345516",75,4076.3545097725,4305.39381412013,2863.21031780169,39,36,1,1
"912345517",75,3427.82332261682,4182.54629119893,2863.21031780169,41,34,1,1
"912345518",79,4108.33134524099,4770.23084452067,2893.78092561085,43,36,1,1
"912345519",67,3538.84095291517,3411.02010727839,2797.95380131742,31,36,1,1
"912345520",41,2940.396099524,2494.61002430509,2530.72175773865,29,12,1,1
"912345521",49,2753.4349060242,2168.35776998992,2624.62502504328,29,20,1,1
"912345522",30,2391.57336106805,2162.89671671025,2374.18906024059,20,10,1,1
"912345523",57,3226.66629860619,3491.39013796618,2707.02236739438,38,19,1,1
"912345524",70,3904.35186099062,4450.21414947518,2823.11677003184,45,25,1,1
"912345525",58,3517.39944734789,3461.34001489229,2716.66249357165,40,18,1,1
"912345526",55,2903.55164962954,2898.13544627889,2687.33120998132,25,30,1,1
"912345527",57,3521.62324033424,3452.96669934643,2707.02236739438,36,21,1,1
"912345528",70,4153.35536526477,4976.27056070887,2823.11677003184,33,37,1,1
"912345529",79,3642.33147422778,3671.65690066918,2893.78092561085,45,34,1,1
"912345530",46,3038.00058036821,2476.1671625235,2590.94954296761,29,17,1,1
"912345531",46,2913.73541728289,3197.77886421683,2590.94954296761,31,15,1,1
"912345532",48,3082.18661977408,2704.32162849412,2613.58673801098,24,24,1,1
"912345533",63,3724.66325013422,4202.52233133607,2762.96971264875,36,27,1,1
"912345534",55,3355.68097467669,2930.30180026649,2687.33120998132,29,26,1,1
"912345535",61,2879.60326391287,2982.46578914329,2744.81051624266,28,33,1,1
"912345536",56,3760.38655783061,3794.10349319873,2697.24673169728,31,25,1,1
"912345537",68,3529.8230487836,3777.30646189169,2806.43931339586,37,31,1,1
"912345538",64,3205.11627618099,3124.26489844894,2771.87783482774,33,31,1,1
"912345609",12,1868.77329950407,1888.19919012358,1968.69006049611,5,7,1,1
"912345610",16,2021.06095371179,1982.1714316745,2087.92318348224,8,8,1,1
"912345611",17,2089.06050978052,2056.77535310074,2113.95669457394,8,9,1,1
"912345710",56,3154.06914003508,2689.91349238859,2697.24673169728,27,29,1,1
"912345711",45,2915.19300601083,2600.39786460239,2579.33597919865,28,17,1,1
"912345712",46,2901.16514960622,2878.19650074548,2590.94954296761,26,20,1,1
"912345713",47,2926.11591287428,2953.50982954904,2602.36394728806,27,20,1,1
"912345714",45,2752.98284065496,2940.47539282255,2579.33597919865,27,18,1,1
"912345715",40,2779.65971859119,2923.35082353231,2517.98110851286,21,19,1,1
"912345716",33,2660.3713897486,2589.45668270829,2420.89448855093,20,13,1,1
"912345717",39,2909.69130352066,2986.85981775117,2504.98447234734,21,18,1,1
"912345718",60,3780.48811076285,3375.8573154604,2735.5526890818,35,25,1,1
"912345719",52,3268.39114468894,3414.18642443239,2656.6981055205,27,25,1,1
"912345720",81,3854.99297570161,3910.7900310432,2908.60658576875,45,36,1,1
"912345721",68,3727.47647888899,3702.89164171278,2806.43931339586,41,27,1,1
"912345722",61,3494.2351818465,4270.41692725185,2744.81051624266,34,27,1,1
"912345723",62,3808.31743233395,4377.49614984097,2753.94837323248,33,29,1,1
"912345724",61,3288.83263806335,4559.91468551314,2744.81051624266,37,24,1,1
"912345725",53,3500.14950934527,5141.17809985271,2667.061866114,28,25,1,1
"912345726",72,4069.88129069678,4732.68899520822,2839.4193288992,41,31,1,1
"912345727",61,3814.1583389701,4636.24037826553,2744.81051624266,38,23,1,1
"912345728",61,4047.02998081058,4839.65045408098,2744.81051624266,32,29,1,1
"912345729",73,4425.05586430382,4672.86677904909,2847.4358582506,42,31,1,1
"912345730",63,3685.102513995,4245.49966508521,2762.96971264875,34,29,1,1
"912345731",58,3459.12797106191,4317.42953110343,2716.66249357165,33,25,1,1
"912345732",60,3605.05969943894,4239.34881926173,2735.5526890818,35,25,1,1
"912345733",65,3746.43514697723,4872.88274025972,2780.67589681985,38,27,1,1
"912345734",36,2750.44155840486,2684.59734582195,2464.33502634194,16,20,1,1
"912345735",41,2764.52891083157,2582.50215886675,2530.72175773865,20,21,1,1
"912345736",33,2586.5285809086,2795.88612340184,2420.89448855093,13,20,1,1
"912345737",55,2825.74821044121,3281.98250559524,2687.33120998132,23,32,1,1
"912345738",33,2568.94909211079,2891.96486178516,2420.89448855093,14,19,1,1
"912345739",33,2782.8576212713,3249.92412281203,2420.89448855093,16,17,1,1
"912345740",46,2680.50670314992,3013.7636471045,2590.94954296761,19,27,1,1
"912345741",33,2560.470807036,2109.96502951368,2420.89448855093,19,14,1,1
"912345742",36,2412.56278512768,2346.37341078677,2464.33502634194,19,17,1,1
"912345743",51,2560.98661292857,3032.07548986118,2646.17454577679,25,26,1,1
"912345744",40,2409.74243412537,2571.07686214536,2517.98110851286,20,20,1,1
"912345745",46,2856.38993260897,3153.45077549662,2590.94954296761,24,22,1,1
"912345746",47,2650.41894376528,2692.48170270332,2602.36394728806,25,22,1,1
"912345747",53,2697.37403168685,2563.42389452089,2667.061866114,27,26,1,1
"912345748",41,2696.37825548763,3216.78201300495,2530.72175773865,19,22,1,1
"912345749",32,2539.14660662335,2968.24643708427,2405.71569249515,17,15,1,1
"912345750",45,2918.08893470189,2962.50425178156,2579.33597919865,25,20,1,1
"912345751",41,2670.87312717603,2994.93291358915,2530.72175773865,17,24,1,1
"912345752",28,2366.79761056538,2398.56139729141,2340.94327947849,14,14,1,1
"912345753",38,2327.9416433756,2189.25525929026,2491.71993967651,17,21,1,1
"912345754",22,2206.02328139277,2204.33241652518,2228.3491786518,9,13,1,1
"912345755",24,2171.46581604187,2310.54822988563,2268.33468283819,8,16,1,1
"912345756",19,2023.01330957221,1820.46265240097,2162.56636020013,7,12,1,1
"912345757",17,2131.98554053479,2099.90029196888,2113.95669457394,10,7,1,1
"912345758",12,1991.65773772245,2049.06390991286,1968.69006049611,6,6,1,1
"912345759",14,1972.0962539608,2040.10669617979,2031.70713799962,5,9,1,1
"912345760",17,2227.89626381953,2158.11946350283,2113.95669457394,8,9,1,1
"912345761",18,2060.33885625484,2119.9880159872,2138.79896507223,6,12,1,1
"912345762",14,2096.8825514371,2033.48155624607,2031.70713799962,4,10,1,1
"912345763",7,1735.650956686,1674.38300431799,1763.32076508842,4,3,1,1
"912345764",17,2226.61627523163,2281.38733299845,2113.95669457394,7,10,1,1
"912345765",19,2304.73782044171,2655.21435302112,2162.56636020013,8,11,1,1
"912345766",32,2415.26251235553,2405.0223268306,2405.71569249515,18,14,1,1
"912345767",20,2186.89549549215,2445.88040545035,2185.35845629437,11,9,1,1
"912345768",30,2344.71108230162,2146.96495638582,2374.18906024059,18,12,1,1
"912345769",24,2176.58856956408,2212.90415323466,2268.33468283819,14,10,1,1
"912345770",30,2405.45372428183,2379.16974558782,2374.18906024059,15,15,1,1
"912345771",23,2442.91350629953,2690.59476793788,2248.68783741607,12,11,1,1
"912345772",16,2082.51888202822,2207.86122940182,2087.92318348224,7,9,1,1
"912345773",23,2228.73656563523,2401.0539687148,2248.68783741607,13,10,1,1
"912345774",28,2432.70693800082,2439.65186278228,2340.94327947849,11,17,1,1
"912345775",30,2411.24132538529,2564.43863452443,2374.18906024059,10,20,1,1
"912345776",31,2177.38256272726,1985.2785127393,2390.15469389133,10,21,1,1
"912345777",27,2253.03908915039,2290.45704231623,2323.60649590586,10,17,1,1
"912345778",17,2137.88784362115,2374.07149291303,2113.95669457394,6,11,1,1
"912345779",19,2169.30029533231,2328.32127006791,2162.56636020013,7,12,1,1
"912345780",13,2017.5033722261,2133.61061419903,2001.16379457045,6,7,1,1
"912345781",16,2091.56689033462,2261.96406618125,2087.92318348224,9,7,1,1
"912345782",19,2169.24453065983,2350.83134579782,2162.56636020013,8,11,1,1
"912345783",21,2184.95085689796,2240.15728194056,2207.26116887512,10,11,1,1
"912345784",31,2388.03640070774,2201.24359631664,2390.15469389133,16,15,1,1
"912345785",20,2122.98329682,2209.25379001693,2185.35845629437,12,8,1,1
"912345786",30,2240.81535184671,2154.92854190933,2374.18906024059,18,12,1,1
"912345787",20,2206.86147370061,2364.79207026579,2185.35845629437,11,9,1,1
"912345788",18,2241.74927594791,2337.21570269222,2138.79896507223,9,9,1,1
"912345789",36,2650.12712638741,2766.74426671124,2464.33502634194,17,19,1,1
"912345790",41,2473.22920728613,2364.53305650086,2530.72175773865,19,22,1,1
"912345791",30,2248.12130145061,2387.11256524042,2374.18906024059,14,16,1,1
"912345792",33,2437.01011556527,2204.87602002915,2420.89448855093,14,19,1,1
"912345793",38,2666.97638044189,2898.52265446737,2491.71993967651,19,19,1,1
"912345794",28,2454.01036897007,2550.54738639978,2340.94327947849,13,15,1,1
"912345795",34,2576.72072182557,2765.44490947196,2435.71163614839,17,17,1,1
"912345796",25,2294.69905618406,2419.01740816701,2287.34065519221,14,11,1,1
"912345797",29,2212.11164316933,2417.5470296505,2357.79423966008,13,16,1,1
"912345798",25,2274.40577526954,2423.86127349748,2287.34065519221,10,15,1,1
"912345799",32,2332.76492209939,2412.70692565059,2405.71569249515,15,17,1,1
"912345800",36,2239.8459100213,1910.49101635397,2464.33502634194,15,21,1,1
"912345801",35,2483.95365304562,2015.53841434853,2450.1860183293,16,19,1,1
"912345802",35,2475.18658107217,2053.15263250346,2450.1860183293,16,19,1,1
"912345803",30,2565.61310271897,2299.95166651978,2374.18906024059,17,13,1,1
"912345804",34,2715.13454427431,2942.40946545356,2435.71163614839,20,14,1,1
"912345805",34,2349.2899390578,2404.42699849959,2435.71163614839,20,14,1,1
"912345806",35,2476.81168045417,2440.5643838296,2450.1860183293,20,15,1,1
"912345807",29,2230.48962218508,2032.28834903232,2357.79423966008,16,13,1,1
"912345808",18,2141.1010174411,2524.97254144648,2138.79896507223,12,6,1,1
"912345809",28,2472.5045124787,2510.96377717854,2340.94327947849,16,12,1,1
"912345810",27,2362.29953600804,2543.34675284165,2323.60649590586,14,13,1,1
"912345811",33,2047.04589564196,1729.24693556405,2420.89448855093,14,19,1,1
"912345812",39,2075.79561026874,1758.77789969544,2504.98447234734,14,25,1,1
"912345813",33,2344.35161559297,2383.46892720353,2420.89448855093,13,20,1,1
"912345814",22,2020.99028768437,1846.0813441062,2228.3491786518,9,13,1,1
"912345815",29,2411.53147406414,2085.3254095698,2357.79423966008,15,14,1,1
"912345816",26,2337.77770145076,2307.77472834682,2305.75108410937,11,15,1,1
"912345817",38,2356.25435400082,2194.28467917415,2491.71993967651,17,21,1,1
"912345818",39,2446.25043304683,2510.81350191062,2504.98447234734,21,18,1,1
"912345819",41,2208.63806123105,2404.58426527196,2530.72175773865,20,21,1,1
"912345820",36,2454.37219570987,2378.21785491961,2464.33502634194,18,18,1,1
"912345821",37,2309.4180895449,2515.62478496011,2478.17471526668,17,20,1,1
"912345823",33,2251.48114949991,2152.91245080298,2420.89448855093,8,25,1,1
"912345824",29,2138.44284141645,1563.80847679931,2357.79423966008,8,21,1,1
"912345826",12,2024.22951481955,2027.63639548332,1968.69006049611,7,5,1,1
"912345827",14,2211.80944911731,2352.12429860991,2031.70713799962,6,8,1,1
"912345828",28,2286.52091645301,2255.65327209835,2340.94327947849,14,14,1,1
"912345829",11,1930.43025574607,1732.25729738016,1933.98659929558,2,9,1,1
"912345830",24,2348.16601794211,2498.61120541456,2268.33468283819,9,15,1,1
"912345831",18,2234.94309098762,2131.37410254139,2138.79896507223,6,12,1,1
"912345832",22,2351.10795972692,2437.85925834022,2228.3491786518,8,14,1,1
"912345833",25,2214.68469653159,1899.24444475483,2287.34065519221,12,13,1,1
"912345834",30,2124.88682837204,2030.18676040766,2374.18906024059,14,16,1,1
"912345835",18,1912.03740821094,1546.73159739362,2138.79896507223,9,9,1,1
"912345836",29,2318.42422854917,2304.71884419306,2357.79423966008,15,14,1,1
"912345837",37,2730.84878387376,3059.48226589138,2478.17471526668,18,19,1,1
"912345838",31,2690.69251434181,2603.70701757065,2390.15469389133,15,16,1,1
"912345839",31,2399.48160930776,2315.19255299993,2390.15469389133,16,15,1,1
"912345840",28,2214.73848929597,1960.81504396982,2340.94327947849,15,13,1,1
"912345841",32,2246.41788399764,1953.95815614054,2405.71569249515,19,13,1,1
"912345842",38,2506.67974477636,2312.35099840086,2491.71993967651,14,24,1,1
"912345843",49,2806.53820206172,2650.74152682517,2624.62502504328,26,23,1,1
"912345844",60,2538.71556839104,2167.64401705463,2735.5526890818,30,30,1,1
"912345846",50,2902.58638987876,2755.32929036082,2635.48551585152,26,24,1,1
"912345847",41,2688.90249299743,2822.28275046618,2530.72175773865,23,18,1,1
"912345848",24,2200.27524302951,1961.98184359582,2268.33468283819,10,14,1,1
"912345849",78,3421.8648014929,3015.30971942399,2886.25582696583,43,35,1,1
"912345850",64,3401.05692614133,3797.07923652216,2771.87783482774,35,29,1,1
"912345851",57,2980.87897814221,3139.06155701509,2707.02236739438,29,28,1,1
"912345852",75,2634.87172021182,2320.89128346169,2863.21031780169,39,36,1,1
"912345853",74,2587.5872778682,2259.50637205345,2855.36548874306,31,43,1,1
"912345854",69,2928.00083671468,2719.57858785947,2814.82611826518,35,34,1,1
"912345855",91,2860.686374705,3243.66577590176,2978.64386243803,48,43,1,1
"912345856",74,3036.0285352633,3372.11963341908,2855.36548874306,33,41,1,1
"912345857",59,3116.15448377385,3277.88285720325,2726.17127719361,28,31,1,1
"912345858",78,3356.56414967396,2936.39352822944,2886.25582696583,45,33,1,1
"912345859",87,3617.72993293908,3514.76537910568,2951.40156710974,53,34,1,1
"912345860",95,3529.09796376602,3649.38215266894,3004.94950458202,46,49,1,1
"912345861",68,3412.35480525786,3926.50713876884,2806.43931339586,33,35,1,1
"912345862",62,4123.91596156203,3999.83400257849,2753.94837323248,28,34,1,1
"912345863",67,3382.9193989894,4199.19543036586,2797.95380131742,38,29,1,1
"912345864",51,3232.20029115948,3132.8608306746,2646.17454577679,26,25,1,1
"912345865",101,4487.74688221492,5562.44010573505,3042.80202352452,53,48,1,1
"912345866",64,3666.84720965171,2808.43058746077,2771.87783482774,34,30,1,1
"912345867",58,3628.45109424432,3768.72234140638,2716.66249357165,33,25,1,1
"912345868",70,3169.25882574685,2966.55442466108,2823.11677003184,35,35,1,1
"912345869",64,3175.07343384047,3005.39224709522,2771.87783482774,30,34,1,1
"912345872",54,3122.61939431169,2696.49518864659,2677.2712016452,30,24,1,1
"912345873",52,3364.36654454703,3270.21750136622,2656.6981055205,23,29,1,1
"912345874",88,3630.6954835945,3273.71717890743,2958.30409156145,43,45,1,1
"912345875",79,3596.00380616303,3443.01359111532,2893.78092561085,38,41,1,1
"912345877",64,3641.24480515971,4116.97884444745,2771.87783482774,29,35,1,1
"912345878",61,3367.54928668118,3420.08341570811,2744.81051624266,32,29,1,1
"912345879",66,3533.18860983213,3608.38636312298,2789.3669207067,35,31,1,1
"912345880",37,2803.3152104415,2690.97980209065,2478.17471526668,25,12,1,1
"912345881",55,3328.87733601953,3382.68915440169,2687.33120998132,30,25,1,1
"912345882",45,2988.419935382,3051.52991369036,2579.33597919865,22,23,1,1
"912345883",85,3876.48417259831,3708.47338060015,2937.40494579778,44,41,1,1
"912345884",45,3078.44275096758,3238.55064950848,2579.33597919865,23,22,1,1
"912345885",46,3210.71706830383,4045.44735852823,2590.94954296761,27,19,1,1
"912345886",98,3540.18889050268,3558.82385848352,3024.10627920296,48,50,1,1
"912345887",74,4158.38893381428,4924.6691474925,2855.36548874306,35,39,1,1
"912345888",48,3284.89652642371,3527.43357161266,2613.58673801098,25,23,1,1
"912345889",77,3441.71669652147,3948.67318655765,2878.65357631343,38,39,1,1
"912345890",73,3307.25978924561,2942.87118493019,2847.4358582506,37,36,1,1
"912345891",87,3615.30120372461,3798.80769354055,2951.40156710974,45,42,1,1
"912345892",43,2808.2022922922,2742.33593795254,2555.47878346624,22,21,1,1
"912345893",62,2862.60102390425,2229.2987388943,2753.94837323248,35,27,1,1
"912345894",49,3077.13026128097,3193.25065460669,2624.62502504328,32,17,1,1
"912345896",40,2484.28243407528,2085.78776772106,2517.98110851286,23,17,1,1
"912345897",61,3350.48843066609,3096.65383450011,2744.81051624266,32,29,1,1
"912345898",66,2887.33398027829,2157.13422562438,2789.3669207067,32,34,1,1
"912345899",55,2940.85548437995,2653.58154855274,2687.33120998132,26,29,1,1
"912345900",62,3241.93017142649,2998.04062539535,2753.94837323248,34,28,1,1
"912345901",76,3465.58614498372,3084.01877099721,2870.97236507783,44,32,1,1
"912345902",61,3234.84221182566,3118.23483473583,2744.81051624266,35,26,1,1
"912345904",72,3079.1305171131,2800.88104370138,2839.4193288992,34,38,1,1
"912345905",78,3726.70807139186,3447.08322068644,2886.25582696583,39,39,1,1
"912345906",56,2970.97008073734,2963.81458410123,2697.24673169728,32,24,1,1
"912345907",70,3282.00591049408,3003.97834692669,2823.11677003184,36,34,1,1
"912345908",48,2678.90620434197,3176.86130822519,2613.58673801098,29,19,1,1
"912345909",53,2720.44535643745,2577.13254983617,2667.061866114,30,23,1,1
"912345910",42,2678.03819107405,2780.26307396818,2543.21752514954,25,17,1,1
"912345911",46,2654.58070225417,2496.2066589963,2590.94954296761,27,19,1,1
"912345912",14,1991.28361489428,2253.69638175594,2031.70713799962,6,8,1,1
"912345913",16,2140.03693380771,2399.09625559277,2087.92318348224,8,8,1,1
"912345914",32,2740.42353376715,2914.6046445957,2405.71569249515,17,15,1,1
"912345915",26,2567.92097148595,2871.04187206213,2305.75108410937,14,12,1,1
"912345916",33,2688.48282617502,3048.95697199093,2420.89448855093,17,16,1,1
"912345917",34,2869.2981343754,3133.85517364171,2435.71163614839,16,18,1,1
"912345918",34,2803.4928899497,3119.98942000929,2435.71163614839,18,16,1,1
"912345919",39,2736.72342950834,2549.11292634373,2504.98447234734,19,20,1,1
"912345957",62,3265.16952246791,3099.04768829187,2753.94837323248,33,29,1,1
"912345958",105,3879.26567735382,3534.1306107253,3067.05425459434,55,50,1,1
"912345962",48,2862.48970321122,2085.31804072521,2613.58673801098,23,25,1,1
"912345963",56,3146.78192643364,2958.00823540308,2697.24673169728,26,30,1,1
"912345964",44,2577.66358129935,2018.69774596199,2567.51523707907,27,17,1,1
"912345965",33,2609.5003078946,2624.46564713485,2420.89448855093,19,14,1,1
"912345966",50,3054.47681556274,2552.55114876586,2635.48551585152,22,28,1,1
"912345967",42,3109.2544101795,2855.3206344197,2543.21752514954,18,24,1,1
"912345968",26,2523.05152562926,2724.02742048471,2305.75108410937,10,16,1,1
"912345969",42,2757.65049488194,2988.86994805944,2543.21752514954,23,19,1,1
"912345970",42,3059.39288703839,3507.08107023455,2543.21752514954,16,26,1,1
"912345971",47,3592.26190862683,3976.39545993179,2602.36394728806,18,29,1,1
"912345972",56,3549.0754354766,4223.37697889563,2697.24673169728,24,32,1,1
"912345974",91,4073.25884519282,4201.81961583026,2978.64386243803,40,51,1,1
"912345976",74,4304.39488927677,4825.6230753456,2855.36548874306,34,40,1,1
"912345977",71,3765.82153058176,4452.64633651679,2831.31372136695,37,34,1,1
"912345978",63,3227.48839108968,3198.47818680529,2762.96971264875,32,31,1,1
"912345979",29,2357.27598465702,2559.50197534048,2357.79423966008,17,12,1,1
"912345981",56,3185.31454429895,3044.50668217051,2697.24673169728,28,28,1,1
"912345982",22,2486.88979569431,2467.7556394017,2228.3491786518,11,11,1,1
"912345984",65,3551.11960070499,2643.43609738539,2780.67589681985,28,37,1,1
"912345985",66,3347.26456143854,4057.18704744687,2789.3669207067,35,31,1,1
"912345986",66,3193.01493632396,3734.22771690451,2789.3669207067,34,32,1,1
"912345987",81,3335.32159144322,2600.41904327526,2908.60658576875,42,39,1,1
"912345988",51,3252.14463374494,2997.4364439831,2646.17454577679,25,26,1,1
"912345989",41,2662.84442433751,2232.58158647901,2530.72175773865,22,19,1,1
"912345991",75,2859.38465611068,2456.71936608133,2863.21031780169,34,41,1,1
"912345992",77,3461.15166554494,3668.49903406834,2878.65357631343,40,37,1,1
"912345993",83,3434.42327722287,2457.26229631621,2923.1438046077,35,48,1,1
"912345994",52,2936.97059929068,2828.09005770309,2656.6981055205,30,22,1,1
"912345995",59,3129.88584410511,2600.7731918265,2726.17127719361,33,26,1,1
"912345996",28,2279.30873060209,2272.12201639551,2340.94327947849,17,11,1,1
"912345998",21,2319.75464558339,2474.2322926631,2207.26116887512,12,9,1,1
"912345999",19,2144.51994447507,2165.69243905358,2162.56636020013,10,9,1,1
"912346000",66,3201.86227744683,2282.48056620197,2789.3669207067,31,35,1,1
"912346001",42,2704.75461181453,2636.40718919365,2543.21752514954,27,15,1,1
"912346002",44,2655.35139018656,2666.38570162304,2567.51523707907,24,20,1,1
"912346003",64,2969.74502822994,3178.66620678348,2771.87783482774,26,38,1,1
"912346004",54,2832.92927152942,2286.83181296424,2677.2712016452,28,26,1,1
"912346005",51,2806.83293235044,2675.66556444123,2646.17454577679,27,24,1,1
"912346007",62,3682.34647205179,2794.99946982158,2753.94837323248,31,31,1,1
"912346008",59,3313.13942571751,3237.24489930128,2726.17127719361,27,32,1,1
"912346009",41,2575.16974872673,2275.46966861322,2530.72175773865,15,26,1,1
"912346010",39,2805.74769181016,2674.7171201622,2504.98447234734,17,22,1,1
"912346011",48,3160.13431617786,2849.44048611197,2613.58673801098,20,28,1,1
"912346012",58,3655.47678604048,3742.66754317224,2716.66249357165,28,30,1,1
"912346013",70,3935.26209890632,3533.4443632506,2823.11677003184,33,37,1,1
"912346014",75,3661.45290678999,2810.78350837975,2863.21031780169,34,41,1,1
"912346015",87,3476.13521092306,3310.18707661595,2951.40156710974,43,44,1,1
"912346016",65,3456.26140346081,2902.30126459072,2780.67589681985,29,36,1,1
"912346017",59,3428.41416749703,3865.4050160145,2726.17127719361,34,25,1,1
"912346018",66,3329.43655203293,3454.31474145612,2789.3669207067,28,38,1,1
"912346019",90,3399.24071007285,2566.90839190463,2971.92401064611,44,46,1,1
"912346020",28,2235.55294690241,1708.9392729351,2340.94327947849,12,16,1,1
"912346023",84,3071.37083418786,2359.32230652079,2930.30814451558,41,43,1,1
"912346024",70,3189.02598684518,2780.46677767274,2823.11677003184,36,34,1,1
"912346025",86,3415.07729860394,2668.42822906857,2944.43562859908,40,46,1,1
"912346026",31,2591.24339213594,2671.48912397627,2390.15469389133,20,11,1,1
"912346027",58,3566.24404401718,2829.01556786989,2716.66249357165,28,30,1,1
"912346028",26,2351.16028976013,2468.42793095965,2305.75108410937,14,12,1,1
"912346029",39,2410.2956693171,2452.70884653191,2504.98447234734,18,21,1,1
"912346030",23,2283.27134973234,2184.80965302406,2248.68783741607,13,10,1,1
"912346031",17,2051.75622415702,2051.01542542452,2113.95669457394,7,10,1,1
"912346032",68,3784.33658068001,3312.38416256085,2806.43931339586,33,35,1,1
"912346033",67,3460.53241834094,2868.54864981453,2797.95380131742,34,33,1,1
"912346034",80,3742.27432777573,3236.486121826,2901.2306171403,36,44,1,1
"912346035",46,3006.08647108945,2683.00435026564,2590.94954296761,22,24,1,1
"912346036",35,2592.3163846257,2269.47140598488,2450.1860183293,16,19,1,1
"912346037",72,3430.29848734695,2728.460110573,2839.4193288992,35,37,1,1
"912346038",43,2797.21336200913,2580.91834420724,2555.47878346624,16,27,1,1
"912346039",59,3659.09668526884,3220.51737707749,2726.17127719361,30,29,1,1
"912346040",51,3526.24568478194,3304.37229628014,2646.17454577679,24,27,1,1
"912346041",52,3083.86332483482,2902.21281522154,2656.6981055205,29,23,1,1
"912346042",44,3069.13872944897,2956.25085401097,2567.51523707907,24,20,1,1
"912346043",32,2551.07055999144,2385.838578625,2405.71569249515,17,15,1,1
"912346044",57,3498.9924181387,3485.18247974022,2707.02236739438,25,32,1,1
"912346045",51,2940.46300156188,2952.02254393694,2646.17454577679,22,29,1,1
"912346046",34,2359.31164528013,2662.08394706854,2435.71163614839,15,19,1,1
"912346048",62,3028.0775316563,2816.49549089048,2753.94837323248,32,30,1,1
"912346112",32,2189.81119395761,1976.78303307213,2405.71569249515,10,22,1,1
"912346113",45,2208.11487794564,2098.47101501917,2579.33597919865,18,27,1,1
"912346315",28,2314.7741217727,2332.71561070185,2340.94327947849,18,10,1,1
"912346316",29,2505.84333150005,2549.51392824216,2357.79423966008,19,10,1,1
"912346317",45,2724.09415933326,2651.42019307129,2579.33597919865,27,18,1,1
"912346318",41,2709.32915880561,2655.56231339787,2530.72175773865,19,22,1,1
"912346319",52,3198.04431482023,3293.87839461786,2656.6981055205,36,16,1,1
"912346320",59,2880.03214694841,3183.29412426351,2726.17127719361,37,22,1,1
"912346321",39,2626.91745968925,2451.11078034534,2504.98447234734,21,18,1,1
"912346322",47,2990.12314216574,3316.25637638287,2602.36394728806,22,25,1,1
"912346323",26,2451.51468601922,2398.75161996206,2305.75108410937,12,14,1,1
"912346324",26,2667.53805659908,2666.38006800715,2305.75108410937,15,11,1,1
"912346325",38,2705.88238757159,2791.29054271848,2491.71993967651,21,17,1,1
"912346326",40,2769.21191817655,2583.73693481117,2517.98110851286,21,19,1,1
"912346327",60,3222.3649640305,3051.322006074,2735.5526890818,35,25,1,1
"912346328",44,2837.5569892807,2923.83614347673,2567.51523707907,25,19,1,1
"912346329",45,2879.78766770696,2672.04482699816,2579.33597919865,19,26,1,1
"912346330",54,3400.49212567998,3368.27727429368,2677.2712016452,19,35,1,1
"912346331",33,2914.22483731871,3264.81692021802,2420.89448855093,17,16,1,1
"912346332",36,3118.20924917535,3190.54520297153,2464.33502634194,21,15,1,1
"912346333",34,2477.84218742366,2686.74629619534,2435.71163614839,18,16,1,1
"912346334",52,3109.84663178248,3241.52324581121,2656.6981055205,29,23,1,1
"912346335",50,3106.51318909075,3144.07932501828,2635.48551585152,22,28,1,1
"912346336",46,2897.52635587742,2975.29071577423,2590.94954296761,28,18,1,1
"912346337",35,2621.34421648076,2850.30374023037,2450.1860183293,18,17,1,1
"912346338",30,2532.75316446171,2554.27420897483,2374.18906024059,16,14,1,1
"912346339",33,2591.47653774513,2917.40442992176,2420.89448855093,13,20,1,1
"912346340",39,2813.25985180271,2966.24851260706,2504.98447234734,23,16,1,1
"912346341",28,2503.18621612957,2618.01314586123,2340.94327947849,15,13,1,1
"912346342",42,2949.34742545107,2816.0560142343,2543.21752514954,22,20,1,1
"912346343",45,2847.63689893672,3032.36984561025,2579.33597919865,24,21,1,1
"912346344",41,2605.97749329169,2934.10908027525,2530.72175773865,24,17,1,1
"912346345",41,2740.54866908868,2929.55890135177,2530.72175773865,25,16,1,1
"912346346",37,2645.62745072879,2791.68157388541,2478.17471526668,20,17,1,1
"912346347",47,2833.34122938985,2653.34698142078,2602.36394728806,28,19,1,1
"912346348",41,2508.51013067669,2759.23462760017,2530.72175773865,23,18,1,1
"912346349",46,2861.12612001545,3037.18968870132,2590.94954296761,26,20,1,1
"912346350",60,2947.73634879117,3140.05226903673,2735.5526890818,36,24,1,1
"912346355",51,2699.32577727999,3126.42380336452,2646.17454577679,30,21,1,1
"912346356",45,2862.77180632959,3068.00687328705,2579.33597919865,27,18,1,1
"912346360",24,2306.18337953397,2331.28058670644,2268.33468283819,14,10,1,1
"912346361",24,2367.14602269146,2557.51208570654,2268.33468283819,13,11,1,1
"912346362",23,2307.47727913333,2274.65572244226,2248.68783741607,11,12,1,1
"912346366",25,2566.48359810197,2522.13636371992,2287.34065519221,15,10,1,1
"912346367",40,2651.80660381123,3366.31884418942,2517.98110851286,19,21,1,1
"912346368",39,2846.07081887204,3156.81150090332,2504.98447234734,21,18,1,1
"912346369",34,2569.34745352812,2883.9830292904,2435.71163614839,21,13,1,1
"912346370",37,2978.5522616679,3416.67121317742,2478.17471526668,21,16,1,1
"912346371",47,2606.54314219722,2522.5760351263,2602.36394728806,22,25,1,1
"912346372",25,2606.11617756051,2508.31006470251,2287.34065519221,15,10,1,1
"912346373",45,2781.73829212979,2733.09976116674,2579.33597919865,26,19,1,1
"912346527",55,3043.12320887647,3638.9197829402,2687.33120998132,23,32,1,1
"912346528",52,2995.52246724746,3655.45460530255,2656.6981055205,24,28,1,1
"912346542",37,2629.6856093344,3141.51473997264,2478.17471526668,16,21,1,1
"912346551",47,2969.4968402372,3381.30848556629,2602.36394728806,21,26,1,1
"912346641",45,2819.07957143817,3342.07694265407,2579.33597919865,28,17,1,1
"912346642",37,2611.56821530804,2917.89231100291,2478.17471526668,24,13,1,1
"912346643",40,3249.57542262955,3041.23628779835,2517.98110851286,22,18,1,1
"912346644",39,2782.6236758716,2700.39460334236,2504.98447234734,23,16,1,1
"912346645",54,3683.43281301053,4685.76737666553,2677.2712016452,27,27,1,1
"912346646",48,3305.67410198077,3834.11998061046,2613.58673801098,28,20,1,1
"912346647",28,2285.68769362822,2585.91106107947,2340.94327947849,17,11,1,1
"912346648",37,2801.0767532602,2941.58477542231,2478.17471526668,19,18,1,1
"912346649",35,2898.86165426179,3849.42234100223,2450.1860183293,17,18,1,1
"912346650",29,2583.12558919178,3323.71811933769,2357.79423966008,19,10,1,1
"912346651",41,2903.38019403872,4181.40558674026,2530.72175773865,20,21,1,1
"912346652",40,2864.40308880643,4146.84889015395,2517.98110851286,19,21,1,1
"912346653",36,2881.70558353573,3700.0247771212,2464.33502634194,20,16,1,1
"912346654",34,2830.30027416142,4065.88507087307,2435.71163614839,17,17,1,1
"912346655",33,2987.2993072643,4003.50448927361,2420.89448855093,16,17,1,1
"912346656",42,3015.8714961161,3698.14252996566,2543.21752514954,19,23,1,1
"912346657",33,2688.66125602783,3500.24728370614,2420.89448855093,17,16,1,1
"912346658",35,2934.06118920289,4437.75367948169,2450.1860183293,22,13,1,1
"912346659",40,3029.35226680014,4050.84849534533,2517.98110851286,20,20,1,1
"912346660",36,3064.46376904125,4019.00016909701,2464.33502634194,17,19,1,1
"912346661",23,2540.4560773444,2392.88574416836,2248.68783741607,10,13,1,1
"912346662",44,2655.86124910815,3377.89454107395,2567.51523707907,20,24,1,1
"912346663",36,2895.38316778317,3689.99125953602,2464.33502634194,20,16,1,1
"912346664",33,2869.65272403951,3540.92505148932,2420.89448855093,16,17,1,1
"912346665",24,2462.51368095222,2710.18719644541,2268.33468283819,12,12,1,1
"912346666",20,2163.55049264806,2316.9441671949,2185.35845629437,11,9,1,1
"912346667",32,2594.35119240653,3301.22572485972,2405.71569249515,18,14,1,1
"912346668",25,2519.55996447987,2915.242231071,2287.34065519221,12,13,1,1
"912346669",70,3168.37649055302,3792.31480797952,2823.11677003184,34,36,1,1
"912346670",56,3130.16619643945,3538.11386088496,2697.24673169728,33,23,1,1
"912346671",54,3135.84715763797,3497.72496260711,2677.2712016452,27,27,1,1
"912346672",44,2603.30693808463,2517.91685095459,2567.51523707907,24,20,1,1
"912346673",40,2592.16132914135,3301.65136100299,2517.98110851286,22,18,1,1
"912346674",44,3189.11406294567,3951.34265952883,2567.51523707907,24,20,1,1
"912346675",28,2500.67535612921,2759.62949243898,2340.94327947849,17,11,1,1
"912346676",42,2947.43997704241,4056.62611464788,2543.21752514954,24,18,1,1
"912346677",46,3150.43081929331,4127.57670664246,2590.94954296761,23,23,1,1
"912346678",37,2405.83483448209,2023.89871604439,2478.17471526668,15,22,1,1
"912346679",39,3181.73232375357,3480.81967313753,2504.98447234734,20,19,1,1
"912346680",34,2669.87933435913,2419.54305749355,2435.71163614839,13,21,1,1
"912346681",49,3312.32753456645,4469.90726474586,2624.62502504328,29,20,1,1
"912346682",33,2449.55462992463,2990.82529789545,2420.89448855093,19,14,1,1
"912346683",31,2370.94103561153,2635.07429581454,2390.15469389133,15,16,1,1
"912346684",36,3037.20040878759,3494.54435101745,2464.33502634194,18,18,1,1
"912346685",30,2219.27072306339,2030.35904620997,2374.18906024059,13,17,1,1
"912346686",53,3567.39077308896,4113.85211506708,2667.061866114,32,21,1,1
"912346687",41,2943.29893881311,3238.79695992392,2530.72175773865,24,17,1,1
"912346688",50,3241.05887285886,3436.6892519037,2635.48551585152,23,27,1,1
"912346689",53,3609.78160311353,4091.44431311528,2667.061866114,29,24,1,1
"912346690",42,2704.29616030053,2625.46804873178,2543.21752514954,19,23,1,1
"912346691",51,3174.98089165677,3237.1065145253,2646.17454577679,26,25,1,1
"912346692",37,2464.38004184886,2832.51455097844,2478.17471526668,19,18,1,1
"912346693",30,2637.95681629763,3333.2182626333,2374.18906024059,17,13,1,1
"912346694",31,2683.96596029147,2765.16477224916,2390.15469389133,13,18,1,1
"912346695",30,2605.08248007326,2949.79958935968,2374.18906024059,16,14,1,1
"912346696",36,2793.59991477103,3425.35195300934,2464.33502634194,19,17,1,1
"912346697",26,2531.34652200113,2680.22942318833,2305.75108410937,13,13,1,1
"912346698",42,3253.70676774851,3679.90964951154,2543.21752514954,20,22,1,1
"912346699",32,2952.45038923564,3001.96753908136,2405.71569249515,16,16,1,1
"912346700",22,2273.49618858331,2390.85396797571,2228.3491786518,9,13,1,1
"912346701",45,2670.61991984332,3258.11912800956,2579.33597919865,21,24,1,1
"912346702",38,2596.14784758235,2314.52049704492,2491.71993967651,18,20,1,1
"912346703",32,2651.10990455063,2520.59847036456,2405.71569249515,21,11,1,1
"912346704",31,2775.10873731422,3160.51336912085,2390.15469389133,18,13,1,1
"912346705",25,2373.09506301073,2855.73966204151,2287.34065519221,13,12,1,1
"912346706",23,2188.211071647,2544.72428367636,2248.68783741607,9,14,1,1
"912346707",11,1930.43704777077,2057.55471523161,1933.98659929558,2,9,1,1
"912346708",31,2745.00314922716,3038.1700515656,2390.15469389133,16,15,1,1
"912346709",34,2778.45852213385,3118.82476042483,2435.71163614839,23,11,1,1
"912346710",26,2512.04455011603,2741.32786906862,2305.75108410937,14,12,1,1
"912346711",48,3042.16794260461,3482.42980059264,2613.58673801098,24,24,1,1
"912346712",30,2563.03965445533,3024.89636136841,2374.18906024059,16,14,1,1
"912346713",36,2556.41874574666,2931.70909661259,2464.33502634194,19,17,1,1
"912346714",33,2636.6277736174,2845.09249724908,2420.89448855093,19,14,1,1
"912346715",27,2460.51206350124,2831.63000597199,2323.60649590586,13,14,1,1
"912346716",25,2264.13607749065,2380.96365034327,2287.34065519221,12,13,1,1
"912346719",36,2660.176160674,2776.33754829046,2464.33502634194,17,19,1,1
"912346720",29,2708.91833998449,3114.51276181562,2357.79423966008,16,13,1,1
"912346721",25,2492.63398465306,2725.00016743311,2287.34065519221,14,11,1,1
"912346722",30,2459.01433085042,2809.37877119429,2374.18906024059,14,16,1,1
"912346723",22,2310.24805815691,2542.48483339009,2228.3491786518,12,10,1,1
"912346724",33,2622.37104726551,2571.38415833553,2420.89448855093,18,15,1,1
"912346725",30,2516.49019028456,2474.65049269766,2374.18906024059,15,15,1,1
"912346726",32,2554.81817867533,2755.77512410056,2405.71569249515,17,15,1,1
"912346727",28,2338.71170871019,2627.46376488683,2340.94327947849,17,11,1,1
"912346728",28,2459.08373794484,2579.36545135418,2340.94327947849,18,10,1,1
"912346729",25,2409.58412200069,2421.66849977254,2287.34065519221,14,11,1,1
"912346730",32,2807.4848582164,2950.63509128973,2405.71569249515,14,18,1,1
"912346731",26,2513.75561762498,2440.24382622672,2305.75108410937,13,13,1,1
"912346732",34,2656.94059783984,2728.64937836122,2435.71163614839,18,16,1,1
"912346733",35,2459.3972103595,2587.151762833,2450.1860183293,19,16,1,1
"912346734",30,2562.22851189255,2697.12787013015,2374.18906024059,17,13,1,1
"912346735",27,2587.86455476075,2645.48654270215,2323.60649590586,12,15,1,1
"912346736",39,2623.32885505015,2979.00896649413,2504.98447234734,22,17,1,1
"912346737",30,2553.01135289842,2625.13776300813,2374.18906024059,15,15,1,1
"912346738",28,2432.03182652857,2461.99101426217,2340.94327947849,15,13,1,1
"912346739",36,2452.82487005605,2483.12180125193,2464.33502634194,17,19,1,1
"912346740",29,2472.5850102889,2519.14438881651,2357.79423966008,15,14,1,1
"912346741",27,2350.58558861477,2595.35454331633,2323.60649590586,15,12,1,1
"912346742",28,2519.96738743378,2688.3437813307,2340.94327947849,13,15,1,1
"912346743",34,2591.62011083915,2812.7875632212,2435.71163614839,17,17,1,1
"912346744",24,2510.1005807948,2711.47548299968,2268.33468283819,12,12,1,1
"912346745",24,2420.29277657872,2625.95740868943,2268.33468283819,14,10,1,1
"912346746",27,2316.30791152073,2503.12782515293,2323.60649590586,14,13,1,1
"912346747",36,2533.69849570598,2342.5795128041,2464.33502634194,15,21,1,1
"912346748",36,2521.05970870779,2690.08492177538,2464.33502634194,18,18,1,1
"912346749",26,2509.42582068106,2532.42555553839,2305.75108410937,14,12,1,1
"912346759",43,3004.10147562104,2833.8534588894,2555.47878346624,24,19,1,1
"912346761",39,2479.27543192537,2416.05587883167,2504.98447234734,21,18,1,1
"912346762",33,2557.29835395665,2587.45887155654,2420.89448855093,17,16,1,1
"912346763",46,3015.50648057137,3245.20124980604,2590.94954296761,27,19,1,1
"912346764",57,3222.54254025568,2964.27526321276,2707.02236739438,35,22,1,1
"912346765",39,2853.00044905279,2972.08879796048,2504.98447234734,27,12,1,1
"912346767",57,3119.47024705136,2752.65930513484,2707.02236739438,30,27,1,1
"912346768",60,3228.19547198792,3000.19437910532,2735.5526890818,24,36,1,1
"912346769",59,3186.03540269728,3413.35775468648,2726.17127719361,31,28,1,1
"912346770",51,2983.12943172074,2381.43613531441,2646.17454577679,26,25,1,1
"912346771",59,3122.00091262822,2966.8002407448,2726.17127719361,29,30,1,1
"912346772",54,2891.04137615829,2462.05270835299,2677.2712016452,22,32,1,1
"912346773",49,2835.88151349404,2720.32121412008,2624.62502504328,22,27,1,1
"912346774",60,3055.01859875157,2855.85009052682,2735.5526890818,26,34,1,1
"912346775",44,3002.17542503627,2933.501049875,2567.51523707907,27,17,1,1
"912346776",60,3255.11446540916,3144.26850986861,2735.5526890818,34,26,1,1
"912346777",32,2613.9508684457,2508.86643053979,2405.71569249515,13,19,1,1
"912346778",28,2493.71339089265,2500.13909567261,2340.94327947849,15,13,1,1
"912346780",60,3250.79024610012,4152.69952835262,2735.5526890818,27,33,1,1
"912346781",68,3297.85341529333,2890.76097241931,2806.43931339586,32,36,1,1
"912346782",51,2850.84854610859,2250.11177426188,2646.17454577679,22,29,1,1
"912346783",53,2950.63873380147,3443.25312472039,2667.061866114,28,25,1,1
"912346785",43,3000.33806915832,3080.97629514437,2555.47878346624,24,19,1,1
"912346786",44,2651.92608103931,1744.17325956747,2567.51523707907,23,21,1,1
"912346787",36,2823.04465796418,3015.8679535001,2464.33502634194,21,15,1,1
"912346788",43,2846.98798304221,3185.68294029315,2555.47878346624,23,20,1,1
"912346789",49,3020.66941905599,3281.01831241196,2624.62502504328,25,24,1,1
"912346790",41,2746.09535880956,2804.86185492137,2530.72175773865,19,22,1,1
"912346791",31,2660.23406690032,2756.57583080176,2390.15469389133,19,12,1,1
"912346792",46,2755.70489697014,3081.13640267151,2590.94954296761,25,21,1,1
"912346793",41,2774.77627224647,2791.56543041716,2530.72175773865,22,19,1,1
"912346794",43,3047.5097510157,3069.01849140866,2555.47878346624,21,22,1,1
"912346795",37,3018.91608318381,2661.95279290983,2478.17471526668,18,19,1,1
"912346796",52,2921.69070564308,2059.76353645979,2656.6981055205,32,20,1,1
"912346799",60,3383.20812039379,3033.035296293,2735.5526890818,32,28,1,1
"912346800",58,3652.5997006654,3825.95455705046,2716.66249357165,26,32,1,1
"912346801",57,3124.62681781063,2785.07428718898,2707.02236739438,33,24,1,1
"912346802",55,3630.58378440348,2934.20446078766,2687.33120998132,33,22,1,1
"912346803",38,2961.21292445587,2603.93377714585,2491.71993967651,19,19,1,1
"912346804",50,2823.700470652,2468.81791759758,2635.48551585152,26,24,1,1
"912346805",66,3217.33648849653,3145.990651519,2789.3669207067,30,36,1,1
"912346806",69,3374.41405754356,3979.57893783519,2814.82611826518,41,28,1,1
"912346807",73,3463.51194437038,4024.75024001601,2847.4358582506,46,27,1,1
"912346808",61,3184.8795945046,3117.98565728892,2744.81051624266,37,24,1,1
"912346809",101,3505.89926473412,3727.40929853317,3042.80202352452,52,49,1,1
"912346810",51,3040.46289559447,2998.57984300434,2646.17454577679,27,24,1,1
"912346811",43,2717.32227818957,2758.81513071999,2555.47878346624,26,17,1,1
"912346812",41,2852.16591828829,2617.11121419036,2530.72175773865,25,16,1,1
"912346813",33,2823.48679444689,2542.98012536957,2420.89448855093,19,14,1,1
"912346814",43,3251.36149453137,2968.15874711738,2555.47878346624,23,20,1,1
"912346815",46,3274.01898872568,3260.15904798354,2590.94954296761,27,19,1,1
"912346817",77,3790.37217510346,4236.82383694834,2878.65357631343,46,31,1,1
"912346818",59,3551.9176663801,3215.13778398812,2726.17127719361,31,28,1,1
"912346819",65,3544.80153964726,3859.67403140584,2780.67589681985,36,29,1,1
"912346820",48,3215.51077689225,3247.76224704295,2613.58673801098,29,19,1,1
"912346821",59,3342.78066203813,3377.03681607607,2726.17127719361,32,27,1,1
"912346822",58,3554.16870462112,3792.77081214676,2716.66249357165,32,26,1,1
"912346823",63,3113.69477508438,3826.01349354871,2762.96971264875,33,30,1,1
"912346824",49,3275.626695058,2857.99637302221,2624.62502504328,23,26,1,1
"912346825",58,3406.79291354732,3254.05186678619,2716.66249357165,24,34,1,1
"912346826",48,3130.69426190438,3010.32439344044,2613.58673801098,29,19,1,1
"912346827",44,2891.60786040051,2774.71275757148,2567.51523707907,25,19,1,1
"912346828",58,3158.64645576005,2914.06032650615,2716.66249357165,33,25,1,1
"912346829",45,2869.10218518404,3361.84888491936,2579.33597919865,23,22,1,1
"912346830",64,3802.00058175221,4187.51514554509,2771.87783482774,36,28,1,1
"912346831",62,3616.66977594731,3800.76703428682,2753.94837323248,36,26,1,1
"912346832",46,3040.23621222555,2908.82905138231,2590.94954296761,24,22,1,1
"912346833",49,3149.91359692621,3238.32532219765,2624.62502504328,26,23,1,1
"912346834",61,3341.58305751665,3235.95974251988,2744.81051624266,31,30,1,1
"912346835",58,3620.69174791369,4113.82132177026,2716.66249357165,29,29,1,1
"912346836",80,3685.23188365045,4414.61464769996,2901.2306171403,41,39,1,1
"912346837",55,2857.52972310103,2606.39447338766,2687.33120998132,27,28,1,1
"912346838",79,4335.14092732949,4496.18142186269,2893.78092561085,44,35,1,1
"912346839",70,3850.03553246767,3638.38438805705,2823.11677003184,41,29,1,1
"912346840",57,3357.7708038796,3648.48451200036,2707.02236739438,30,27,1,1
"912346841",55,3766.86591501997,4169.45629296384,2687.33120998132,31,24,1,1
"912346842",86,2988.37928942096,3609.80579956632,2944.43562859908,46,40,1,1
"912346844",15,1928.23131906004,1789.52372531061,2060.56118614118,9,6,1,1
"912346845",46,2778.0476636814,2126.97899299655,2590.94954296761,24,22,1,1
"912346846",71,3436.67283486977,4297.14264160062,2831.31372136695,38,33,1,1
"912346847",72,3314.35720533536,3434.97111021283,2839.4193288992,32,40,1,1
"912346848",62,2880.12111301376,2504.23040089114,2753.94837323248,32,30,1,1
"912346849",77,3751.36801798027,4090.41375460729,2878.65357631343,37,40,1,1
"912346850",60,3175.6201368167,3914.99799744094,2735.5526890818,32,28,1,1
"912346851",83,2989.50146672412,2844.66388361615,2923.1438046077,40,43,1,1
"912346852",62,3983.19808365838,4884.24976819838,2753.94837323248,35,27,1,1
"912346853",66,3858.99749030038,3457.86527513616,2789.3669207067,35,31,1,1
"912346854",58,3886.80471586445,4839.08465449193,2716.66249357165,30,28,1,1
"912346855",58,3471.88515116394,3539.2853466206,2716.66249357165,28,30,1,1
"912346857",77,4281.41878577828,4841.35150565629,2878.65357631343,44,33,1,1
"912346858",60,3642.9092481628,5580.5180899815,2735.5526890818,36,24,1,1
"912346859",29,2680.89240513631,2639.20593054761,2357.79423966008,13,16,1,1
"912346860",54,3422.73225933839,3655.13970670635,2677.2712016452,29,25,1,1
"912346864",36,2518.26593123931,2742.43646168531,2464.33502634194,20,16,1,1
"912346865",59,3472.83437564706,3945.398793855,2726.17127719361,30,29,1,1
"912346866",58,2802.39132904769,2524.98285098794,2716.66249357165,29,29,1,1
"912346867",46,2841.28016702248,2506.97547377592,2590.94954296761,24,22,1,1
"912346869",50,3070.35755191626,2846.17017403423,2635.48551585152,32,18,1,1
"912346870",53,2759.46194522881,2997.54967455882,2667.061866114,27,26,1,1
"912346871",41,2586.98402005809,1860.89153368206,2530.72175773865,21,20,1,1
"912346872",27,2437.81765905874,2289.839976752,2323.60649590586,16,11,1,1
"912347043",52,3507.12817613418,4072.50028109729,2656.6981055205,27,25,1,1
"912347044",51,3154.33077185482,3810.47169712759,2646.17454577679,19,32,1,1
"912347045",32,2812.87516956168,3317.70834827285,2405.71569249515,19,13,1,1
"912347046",41,2920.64199060674,3270.09378699079,2530.72175773865,23,18,1,1
"912347047",38,2863.13981200989,3188.2447757041,2491.71993967651,21,17,1,1
"912347048",43,3123.20480658477,3453.46456855888,2555.47878346624,19,24,1,1
"912347049",47,3232.12089326758,3068.31659586389,2602.36394728806,20,27,1,1
"912347050",42,3113.28039051096,3110.20458326018,2543.21752514954,20,22,1,1
"912347051",35,2801.55587169299,3259.9459221062,2450.1860183293,16,19,1,1
"912347052",45,2729.73261362635,2882.93285130095,2579.33597919865,22,23,1,1
"912347053",43,2928.43292918867,3097.72791858072,2555.47878346624,21,22,1,1
"912347054",40,3108.89162489273,3357.65274635547,2517.98110851286,21,19,1,1
"912347055",51,3045.5604556472,3100.46208546549,2646.17454577679,27,24,1,1
"912347056",44,3071.95534753386,3438.06635580479,2567.51523707907,20,24,1,1
"912347057",30,2635.51041591296,3092.41743303734,2374.18906024059,15,15,1,1
"912347058",32,2558.89614764542,2769.39831139008,2405.71569249515,12,20,1,1
"912347059",43,3115.3451701315,3338.59006723267,2555.47878346624,21,22,1,1
"912347060",36,2962.57541963204,3191.18651909215,2464.33502634194,17,19,1,1
"912347061",35,2939.30469798044,2934.55834190859,2450.1860183293,17,18,1,1
"912347062",26,2450.21980212369,2611.33003683295,2305.75108410937,15,11,1,1
"912347063",50,2920.30179104022,3116.84221234966,2635.48551585152,23,27,1,1
"912347064",38,3145.18278317457,3090.72664865888,2491.71993967651,20,18,1,1
"912347065",36,3110.36982994353,3104.19989763807,2464.33502634194,16,20,1,1
"912347066",29,2822.07805331459,3175.06170441538,2357.79423966008,11,18,1,1
"912347067",40,3077.04422564616,3443.91645287875,2517.98110851286,18,22,1,1
"912347068",31,2885.09271983466,3509.842728206,2390.15469389133,14,17,1,1
"912347069",40,3037.34883017775,3258.58717031895,2517.98110851286,16,24,1,1
"912347070",49,3597.12562338195,4062.26642216115,2624.62502504328,22,27,1,1
"912347071",42,3410.40522089415,3627.30780313107,2543.21752514954,25,17,1,1
"912347072",45,3330.22270741692,3486.92112813332,2579.33597919865,26,19,1,1
"912347073",44,3085.13622352521,3382.89193344888,2567.51523707907,25,19,1,1
"912347074",45,3252.94806727373,3538.43285042681,2579.33597919865,23,22,1,1
"912347075",36,2935.6734280135,3228.75663856792,2464.33502634194,19,17,1,1
"912347076",39,3004.65250843639,3630.66380260014,2504.98447234734,22,17,1,1
"912347077",28,2619.44931240399,2757.52020160015,2340.94327947849,16,12,1,1
"912347078",41,2951.51927025253,2928.37585487074,2530.72175773865,26,15,1,1
"912347079",42,2712.2253277526,3205.68926181905,2543.21752514954,20,22,1,1
"912347080",42,2947.13530692087,3227.39160598143,2543.21752514954,25,17,1,1
"912347081",38,2922.58786025903,3522.85515902685,2491.71993967651,20,18,1,1
"912347082",42,2946.38851554332,3168.10156193021,2543.21752514954,22,20,1,1
"912347083",51,2944.4544427883,2859.97445857211,2646.17454577679,28,23,1,1
"912347084",34,2893.45440903808,2876.14276454378,2435.71163614839,22,12,1,1
"912347085",58,3279.33521103122,2843.81781829623,2716.66249357165,36,22,1,1
"912347086",58,3499.8487299169,2920.11903326271,2716.66249357165,33,25,1,1
"912347087",45,2769.43518985354,2442.14110809415,2579.33597919865,25,20,1,1
"912347088",37,2979.17275074691,2997.45230604302,2478.17471526668,19,18,1,1
"912347089",44,3500.57040321487,3768.00980144728,2567.51523707907,21,23,1,1
"912347090",36,2988.43201596033,3543.44675027558,2464.33502634194,17,19,1,1
"912347091",41,2635.67509544334,2366.01441696378,2530.72175773865,21,20,1,1
"912347092",47,2665.25446279206,2740.78473205011,2602.36394728806,27,20,1,1
"912347093",40,2666.53895465499,2733.07355461281,2517.98110851286,21,19,1,1
"912347094",38,2654.58667787086,2783.8654065408,2491.71993967651,18,20,1,1
"912347095",40,2584.78224609005,2865.33610190261,2517.98110851286,21,19,1,1
"912347096",30,2560.08348480457,2665.97629864782,2374.18906024059,16,14,1,1
"912347097",43,2858.88602807266,3182.24611438522,2555.47878346624,25,18,1,1
"912347098",35,2567.47927571228,2546.11336873351,2450.1860183293,17,18,1,1
"912347099",43,3375.70932153812,3452.57440072178,2555.47878346624,24,19,1,1
"912347100",37,3276.91777289139,3578.17583849218,2478.17471526668,17,20,1,1
"912347101",37,2823.56266934071,3204.31843950793,2478.17471526668,18,19,1,1
"912347102",43,2961.98021745393,3470.25763567673,2555.47878346624,21,22,1,1
"912347103",17,2231.05343476105,2240.08117582429,2113.95669457394,8,9,1,1
"912347104",16,2148.5821471003,2123.51681950757,2087.92318348224,7,9,1,1
"912347105",38,2756.40778265457,3244.80875259974,2491.71993967651,18,20,1,1
"912347106",42,2874.71623871199,3504.19336141288,2543.21752514954,21,21,1,1
"912347107",58,3499.10901164409,3772.32784792939,2716.66249357165,28,30,1,1
"912347108",57,2879.8513348901,2968.06156722559,2707.02236739438,28,29,1,1
"912347109",53,2814.72261944645,2689.04478764723,2667.061866114,27,26,1,1
"912347110",44,3159.71324295694,3274.84200586529,2567.51523707907,21,23,1,1
"912347111",41,2998.87354541759,3297.51603867137,2530.72175773865,20,21,1,1
"912347112",37,2446.56119337119,2436.74147314705,2478.17471526668,23,14,1,1
"912347113",63,3297.96381532497,3572.11242787023,2762.96971264875,29,34,1,1
"912347114",42,3169.52661710758,3480.32990964358,2543.21752514954,26,16,1,1
"912347115",45,2976.59130296108,3304.78705971202,2579.33597919865,26,19,1,1
"912347116",59,2883.82465275608,2985.75142868312,2726.17127719361,25,34,1,1
"912347117",55,3370.46117195101,3614.84770168828,2687.33120998132,29,26,1,1
"912347118",50,3064.16994216852,3676.21218728723,2635.48551585152,28,22,1,1
"912347119",62,3243.48365571894,3396.39678993793,2753.94837323248,31,31,1,1
"912347120",26,2468.79361252656,2569.02642427868,2305.75108410937,14,12,1,1
"912347121",41,2577.32664036306,2517.40779127838,2530.72175773865,26,15,1,1
"912347122",53,3268.94764594697,2715.97953687209,2667.061866114,29,24,1,1
"912347123",44,3043.18316427411,3732.74846715547,2567.51523707907,22,22,1,1
"912347124",49,3459.71008016869,3791.94084223377,2624.62502504328,25,24,1,1
"912347125",37,2821.95571244232,3494.32292774257,2478.17471526668,17,20,1,1
"912347126",49,3312.06969700135,3804.86397297501,2624.62502504328,18,31,1,1
"912347127",46,3122.7259350284,3661.29728324451,2590.94954296761,26,20,1,1
"912347128",63,3405.10804639801,4276.14902141294,2762.96971264875,34,29,1,1
"912347129",42,3097.82652510793,3309.39040174119,2543.21752514954,25,17,1,1
"912347130",40,2592.09642327888,2484.50560231488,2517.98110851286,22,18,1,1
"912347131",41,2812.43397587135,2780.70674358152,2530.72175773865,26,15,1,1
"912347132",41,2915.33715379869,2904.55441499596,2530.72175773865,19,22,1,1
"912347133",49,2739.35735397346,2724.32126429168,2624.62502504328,26,23,1,1
"912347135",55,3443.37677432593,2729.6781347911,2687.33120998132,34,21,1,1
"912347136",75,3900.0438687563,4593.07988789652,2863.21031780169,44,31,1,1
"912347390",60,3233.71255865105,3451.89491701685,2735.5526890818,32,28,1,1
"912347391",52,3471.46272118762,3741.15704149819,2656.6981055205,30,22,1,1
"912347392",83,3845.13688588533,3725.37170098375,2923.1438046077,48,35,1,1
"912347393",60,3334.66754342582,3432.03351916614,2735.5526890818,28,32,1,1
"912347394",77,3529.99584575384,3165.83140829397,2878.65357631343,42,35,1,1
"912347395",70,3669.84131790437,4322.00374750063,2823.11677003184,37,33,1,1
"912347396",56,3303.48908314608,3638.89940859084,2697.24673169728,35,21,1,1
"912347397",61,3399.20345469414,4177.25657099486,2744.81051624266,36,25,1,1
"912347398",60,3285.14919642119,3490.73578693288,2735.5526890818,34,26,1,1
"912347399",57,3221.35357514095,3160.56005222515,2707.02236739438,28,29,1,1
"912347400",28,2755.25630374167,2869.53820137032,2340.94327947849,20,8,1,1
"912347401",45,3102.11008814478,3100.92531381772,2579.33597919865,27,18,1,1
"912347402",87,3558.49717836126,3505.37364556783,2951.40156710974,47,40,1,1
"912347403",54,3295.46807201858,3948.44682416194,2677.2712016452,28,26,1,1
"912347404",62,3391.16840552112,4352.54772615497,2753.94837323248,37,25,1,1
"912347405",54,3403.02073380824,4561.57219879198,2677.2712016452,28,26,1,1
"912347407",61,3298.67100164351,3716.02440362375,2744.81051624266,35,26,1,1
"912347408",49,2573.73101030769,2670.2116474662,2624.62502504328,29,20,1,1
"912347409",49,2944.10324546895,2974.99541207407,2624.62502504328,28,21,1,1
"912347410",88,2954.58505391353,3032.1336806684,2958.30409156145,47,41,1,1
"912347412",86,3689.49453991015,3563.82957129308,2944.43562859908,50,36,1,1
"912347413",63,2890.66632450255,2979.74592458323,2762.96971264875,36,27,1,1
"912347414",67,3341.30635235108,3511.98731801841,2797.95380131742,42,25,1,1
"912347415",70,3484.96415524264,3290.91028602707,2823.11677003184,36,34,1,1
"912347416",50,3085.98937765676,3595.26496772695,2635.48551585152,30,20,1,1
"912347417",41,3195.66900524866,3323.3091275802,2530.72175773865,22,19,1,1
"912347418",50,3018.90906986424,3401.19398058887,2635.48551585152,22,28,1,1
"912347419",65,3441.04471414474,4432.45882627702,2780.67589681985,34,31,1,1
"912347420",49,3322.23973532823,2832.11022653429,2624.62502504328,27,22,1,1
"912347421",71,3919.13716400154,3913.58261569544,2831.31372136695,30,41,1,1
"912347422",58,3082.41592502948,3503.21509420318,2716.66249357165,31,27,1,1
"912347423",52,3325.51635203826,3781.15306368746,2656.6981055205,25,27,1,1
"912347424",39,2808.18942560581,2819.48838477641,2504.98447234734,24,15,1,1
"912347425",41,2647.55601537183,2981.40734270337,2530.72175773865,24,17,1,1
"912347426",54,3165.3816969827,2797.4793821744,2677.2712016452,31,23,1,1
"912347427",51,2491.87357349905,2284.17472396365,2646.17454577679,31,20,1,1
"912347428",52,3010.50241703245,2449.92865038819,2656.6981055205,27,25,1,1
"912347429",31,2511.44050052575,2492.71598944909,2390.15469389133,22,9,1,1
"912347430",69,3632.33778367134,4107.55736910265,2814.82611826518,37,32,1,1
"912347431",66,3230.57745357942,3575.82798350596,2789.3669207067,33,33,1,1
"912347432",71,3317.50551207713,3340.50848677412,2831.31372136695,36,35,1,1
"912347433",53,3300.4411020921,3484.31603032298,2667.061866114,28,25,1,1
"912347434",73,3580.01151563822,3497.73883227934,2847.4358582506,40,33,1,1
"912347435",65,3247.40478389526,2471.62282198829,2780.67589681985,34,31,1,1
"912347436",63,3071.69904155936,3236.35986318763,2762.96971264875,35,28,1,1
"912347437",68,3233.09590705271,3479.87379758814,2806.43931339586,37,31,1,1
"912347438",73,3571.4676108621,3344.51042747513,2847.4358582506,35,38,1,1
"912347439",69,3456.90223585135,3011.78224977376,2814.82611826518,36,33,1,1
"912347442",51,2975.03143855019,2745.9208620966,2646.17454577679,30,21,1,1
"912347443",38,2836.20606365396,2382.28536682325,2491.71993967651,22,16,1,1
"912347444",69,3320.2313707237,3200.25402106135,2814.82611826518,37,32,1,1
"912347446",51,3386.05334118579,3856.53447415158,2646.17454577679,28,23,1,1
"912347447",65,3623.5482930962,3552.05663051142,2780.67589681985,35,30,1,1
"912347448",63,3521.5726679646,3582.93782214223,2762.96971264875,37,26,1,1
"912347449",55,2999.19409667038,3088.49294491069,2687.33120998132,33,22,1,1
"912347450",43,2818.25757798938,2650.81192460575,2555.47878346624,27,16,1,1
"912347451",40,2660.69657037488,2285.98556163591,2517.98110851286,26,14,1,1
"912347452",75,3340.72602358238,4013.70323689223,2863.21031780169,42,33,1,1
"912347453",61,3277.08066547967,3789.92251134718,2744.81051624266,31,30,1,1
"912347454",60,3226.54482569795,3490.21128566056,2735.5526890818,30,30,1,1
"912347455",71,3897.55849256265,4895.72030901606,2831.31372136695,43,28,1,1
"912347456",81,3536.80116159997,4657.52064506628,2908.60658576875,41,40,1,1
"912347457",80,3855.80081066789,5161.84906611692,2901.2306171403,43,37,1,1
"912347458",55,2926.81136944935,2933.35080157043,2687.33120998132,29,26,1,1
"912347459",82,3670.39344170953,4418.73771296481,2915.91045786314,47,35,1,1
"912347460",78,3510.39733912124,3866.66023286199,2886.25582696583,43,35,1,1
"912347461",44,2752.66254556762,2305.47479092751,2567.51523707907,21,23,1,1
"912347462",52,3109.73567464937,2665.64387193215,2656.6981055205,31,21,1,1
"912347463",55,3055.62663105295,2674.10242923068,2687.33120998132,30,25,1,1
"912347464",59,3193.37640486991,3362.68241825984,2726.17127719361,33,26,1,1
"912347465",54,2679.51734470574,2780.00950552169,2677.2712016452,34,20,1,1
"912347466",64,2879.33242390831,2732.00753843389,2771.87783482774,38,26,1,1
"912347467",67,3506.77946432643,3243.44583777722,2797.95380131742,38,29,1,1
"912347468",68,3426.8200300547,3611.06656991294,2806.43931339586,37,31,1,1
"912347469",31,2443.27572244582,2347.91457424256,2390.15469389133,14,17,1,1
"912347470",27,2300.87803528326,2372.80000147761,2323.60649590586,14,13,1,1
"912347471",32,2710.26011351646,2688.15508472157,2405.71569249515,13,19,1,1
"912347472",24,2381.49928107504,2233.0970351017,2268.33468283819,14,10,1,1
"912347473",54,3063.25082388775,3112.89966720127,2677.2712016452,26,28,1,1
"912347474",55,2963.51120412659,3098.9831973457,2687.33120998132,28,27,1,1
"912347475",68,3555.0340885782,3828.13275520768,2806.43931339586,43,25,1,1
"912347476",67,3132.80125193069,2975.94303710781,2797.95380131742,38,29,1,1
"912347477",38,3017.80839278976,3106.4308595572,2491.71993967651,23,15,1,1
"912347478",51,2905.82738649866,3198.19707102115,2646.17454577679,31,20,1,1
"912347479",31,2484.41300893862,2342.05365046648,2390.15469389133,19,12,1,1
"912347480",28,2241.07010074777,2048.75053845177,2340.94327947849,20,8,1,1
"912347481",58,2872.41745671453,2679.26842202165,2716.66249357165,27,31,1,1
"912347482",59,3245.45289818684,3352.81897927198,2726.17127719361,37,22,1,1
"912347483",60,3101.33855960722,3407.4523165145,2735.5526890818,35,25,1,1
"912347485",66,3109.80329358861,3063.41100505346,2789.3669207067,39,27,1,1
"912347486",68,3552.9941618329,3123.94755914983,2806.43931339586,36,32,1,1
"912347487",43,3045.1123131382,3191.7774202297,2555.47878346624,26,17,1,1
"912347488",68,3540.14424848466,2980.51013069501,2806.43931339586,35,33,1,1
"912347489",54,3178.94650571842,2707.57254298443,2677.2712016452,30,24,1,1
"912347490",37,2689.81756116619,2480.89831290538,2478.17471526668,21,16,1,1
"912347491",51,2630.38180448268,2394.29888035738,2646.17454577679,31,20,1,1
"912347497",48,2501.90339641087,2089.98935715346,2613.58673801098,25,23,1,1
"912347498",36,2467.51250257378,2640.92439227945,2464.33502634194,20,16,1,1
"912347499",44,2718.60297324691,2459.09271916774,2567.51523707907,25,19,1,1
"912347500",39,2522.17576517571,2407.93318080343,2504.98447234734,23,16,1,1
"912347501",38,2471.27260899737,2543.20787202942,2491.71993967651,22,16,1,1
"912347502",18,2145.5743495367,2241.91781636498,2138.79896507223,11,7,1,1
"912347503",32,2410.1420678079,2118.34925025697,2405.71569249515,19,13,1,1
"912347504",39,2718.77760467875,2660.00643940964,2504.98447234734,24,15,1,1
"912347505",32,2458.92983054621,2503.03580421653,2405.71569249515,15,17,1,1
"912347506",88,4186.45993048372,5178.26649280568,2958.30409156145,46,42,1,1
"912347507",72,3261.62680525632,4492.59577237737,2839.4193288992,38,34,1,1
"912347508",63,3612.28720774667,4071.55808618854,2762.96971264875,34,29,1,1
"912347510",52,3206.9401720132,3460.6837146103,2656.6981055205,28,24,1,1
"912347511",61,3681.45272140059,3901.47877877946,2744.81051624266,30,31,1,1
"912347512",63,3602.00641135158,5076.00520036992,2762.96971264875,31,32,1,1
"912347513",44,2380.21845082589,2342.58787494651,2567.51523707907,26,18,1,1
"912347514",44,2499.91584913693,2499.26723890972,2567.51523707907,28,16,1,1
"912347515",39,2632.17398052073,2621.94646012692,2504.98447234734,25,14,1,1
"912347516",36,2693.65186248666,2434.85023725603,2464.33502634194,25,11,1,1
"912347517",28,2273.26240346696,2403.81223522364,2340.94327947849,16,12,1,1
"912347518",34,2385.23908092713,2132.81540374124,2435.71163614839,20,14,1,1
"912347519",54,3127.36469851434,3435.02311995787,2677.2712016452,33,21,1,1
"912347520",49,2735.66200043941,2669.13921623995,2624.62502504328,30,19,1,1
"912347521",48,2605.12460090855,2117.64771597585,2613.58673801098,28,20,1,1
"912347522",86,4052.44311826378,4658.01023057165,2944.43562859908,50,36,1,1
"912347523",88,3824.78412375041,4789.84393758049,2958.30409156145,51,37,1,1
"912347524",67,3357.03514557435,3353.10804684983,2797.95380131742,34,33,1,1
"912347525",62,3204.76579315571,3497.40196288633,2753.94837323248,34,28,1,1
"912347526",64,3055.2907375373,3745.74173727618,2771.87783482774,37,27,1,1
"912347527",88,3698.9998792354,5174.39005528154,2958.30409156145,58,30,1,1
"912347528",86,3128.62108464292,2861.23586834131,2944.43562859908,50,36,1,1
"912347529",74,3143.88529430959,3646.19221507107,2855.36548874306,44,30,1,1
"912347530",35,2641.64235098812,2811.8142396325,2450.1860183293,24,11,1,1
"912347531",64,3087.00041397734,2867.64128048865,2771.87783482774,38,26,1,1
"912347532",54,3124.69083846902,2985.55058484591,2677.2712016452,33,21,1,1
"912347533",85,3439.7052086138,2773.65597672657,2937.40494579778,45,40,1,1
"912347534",59,2928.11163813912,2508.76346554125,2726.17127719361,34,25,1,1
"912347535",46,2671.09319149749,2291.6003362312,2590.94954296761,24,22,1,1
"912347536",50,2686.35283387831,2327.01760036442,2635.48551585152,29,21,1,1
"912347537",63,3553.43923747055,3236.3186947714,2762.96971264875,37,26,1,1
"912347538",59,2790.28966306445,3040.06194915853,2726.17127719361,36,23,1,1
"912347539",61,2921.77072873723,3021.01186105218,2744.81051624266,33,28,1,1
"912347540",47,2745.91837085172,3055.47491799233,2602.36394728806,30,17,1,1
"912347541",43,2875.10793762539,2886.59091477754,2555.47878346624,25,18,1,1
"912347542",57,3194.33172225425,3457.11779779553,2707.02236739438,33,24,1,1
"912347543",76,3215.56058218818,3449.65918102594,2870.97236507783,34,42,1,1
"912347544",61,2937.60339899269,2897.6589634191,2744.81051624266,34,27,1,1
"912347545",65,3265.04685986081,3363.77111321014,2780.67589681985,38,27,1,1
"912347546",79,3431.26658727592,2640.98110338704,2893.78092561085,45,34,1,1
"912347547",64,3129.24745646193,2674.47658093911,2771.87783482774,36,28,1,1
"912347549",47,2842.5558575608,3028.77328296887,2602.36394728806,29,18,1,1
"912347550",62,2676.03581869007,2254.78267379839,2753.94837323248,29,33,1,1
"912347551",37,2610.53051349128,2561.14298498543,2478.17471526668,19,18,1,1
"912347552",34,2615.46271123375,2689.61829518141,2435.71163614839,21,13,1,1
"912347553",34,2667.81607712195,2660.09680465078,2435.71163614839,20,14,1,1
"912347554",34,2856.10675649701,2813.94571679246,2435.71163614839,17,17,1,1
"912347555",34,2564.06349321991,2490.5392169578,2435.71163614839,21,13,1,1
"912347556",38,2503.84866105581,2560.00661428618,2491.71993967651,23,15,1,1
"912347557",44,2544.47317398659,2399.5135933522,2567.51523707907,32,12,1,1
"912347558",42,2601.99539587146,2254.42140989541,2543.21752514954,28,14,1,1
"912347559",57,3525.28958455438,4742.48998537421,2707.02236739438,38,19,1,1
"912347560",50,3118.22058646309,3666.06224320083,2635.48551585152,31,19,1,1
"912347561",49,2918.43971453495,3088.54125690477,2624.62502504328,25,24,1,1
"912347562",55,3401.505870557,3357.03541860604,2687.33120998132,33,22,1,1
"912347563",74,3726.30948678603,3604.54316367261,2855.36548874306,37,37,1,1
"912347564",76,3720.66797670016,3203.10192245442,2870.97236507783,39,37,1,1
"912347565",45,2996.53398643282,2778.09657679978,2579.33597919865,26,19,1,1
"912347566",53,3027.3846116933,2581.21997284756,2667.061866114,30,23,1,1
"912347567",59,3843.1902746145,3685.17944703084,2726.17127719361,33,26,1,1
"912347568",51,3433.34383452931,3554.96476714586,2646.17454577679,31,20,1,1
"912347569",45,2296.99463606389,2298.59594666175,2579.33597919865,27,18,1,1
"912347570",38,2446.94121509625,2573.88723223894,2491.71993967651,22,16,1,1
"912347571",78,3678.94367266223,4214.26148973107,2886.25582696583,45,33,1,1
"912347572",73,3735.43868060984,3843.43312285941,2847.4358582506,38,35,1,1
"912347573",75,3598.92889142971,3167.20598880826,2863.21031780169,41,34,1,1
"912347574",69,3480.6201181837,2838.35287184301,2814.82611826518,40,29,1,1
"912347575",45,2616.23641488109,2678.57300859377,2579.33597919865,26,19,1,1
"912347576",45,2553.67484292804,2426.42636152261,2579.33597919865,21,24,1,1
"912347577",42,2863.12654865683,2553.55956907355,2543.21752514954,26,16,1,1
"912347578",44,2969.01456558448,2922.40925260472,2567.51523707907,29,15,1,1
"912347579",31,2349.61576245522,1966.51223003304,2390.15469389133,18,13,1,1
"912347580",44,2579.04552292601,1982.20209078123,2567.51523707907,22,22,1,1
"912347581",39,2434.92526288421,2365.1050025957,2504.98447234734,21,18,1,1
"912347582",67,3035.14030839955,3172.46955284837,2797.95380131742,37,30,1,1
"912347583",36,2729.30549971706,2722.68080367591,2464.33502634194,20,16,1,1
"912347584",44,2717.10705709879,2707.43606919252,2567.51523707907,21,23,1,1
"912347585",47,3116.47053338345,3830.57148151702,2602.36394728806,22,25,1,1
"912347586",45,2935.83216864277,2508.49790245863,2579.33597919865,21,24,1,1
"912347587",36,2956.60205013264,2844.76985278537,2464.33502634194,19,17,1,1
"912347588",64,3250.59711791488,3384.26019781005,2771.87783482774,31,33,1,1
"912347589",65,3713.75965789951,3471.81716791294,2780.67589681985,34,31,1,1
"912347624",53,3199.2196054262,2953.67895094231,2667.061866114,29,24,1,1
"912347625",55,3222.87731306379,4221.46733298679,2687.33120998132,31,24,1,1
"912347627",66,3533.89286736382,3039.67022914666,2789.3669207067,30,36,1,1
"912347628",50,2834.13811795255,2658.98836689087,2635.48551585152,24,26,1,1
"912347629",67,3390.68292973191,3677.10314687662,2797.95380131742,35,32,1,1
"912347630",45,2791.26468259563,3230.27933560505,2579.33597919865,25,20,1,1
"912347631",45,3233.38959185722,3143.17378944803,2579.33597919865,18,27,1,1
"912347632",52,3045.10183051893,3022.6465752065,2656.6981055205,23,29,1,1
"912347633",54,2731.01179426509,3145.55457800508,2677.2712016452,26,28,1,1
"912347634",57,2944.67329663125,2922.37368943439,2707.02236739438,30,27,1,1
"912347635",68,3230.8168844,3821.3906032303,2806.43931339586,32,36,1,1
"912347637",65,3491.05278224705,4090.07642673632,2780.67589681985,28,37,1,1
"912347638",55,3273.96011450461,3623.73433681771,2687.33120998132,28,27,1,1
"912347639",47,2763.94681312514,2840.94600203728,2602.36394728806,23,24,1,1
"912347640",59,2862.67145156196,2597.5698919717,2726.17127719361,27,32,1,1
"912347641",61,3171.66285489086,3598.61160902267,2744.81051624266,25,36,1,1
"912347642",57,3622.97934393774,3810.1910815461,2707.02236739438,27,30,1,1
"912347643",57,2827.72625168998,3255.84140778628,2707.02236739438,31,26,1,1
"912347644",48,2723.20002951881,3162.16581192081,2613.58673801098,25,23,1,1
"912347645",73,3076.14965732488,3073.21814000441,2847.4358582506,32,41,1,1
"912347646",72,3670.07077367126,3866.03205301357,2839.4193288992,29,43,1,1
"912347647",56,2932.85962450865,3243.90181372017,2697.24673169728,27,29,1,1
"912347648",72,3633.19723810653,3594.35552041064,2839.4193288992,29,43,1,1
"912347649",60,3374.73810835436,3840.33877496771,2735.5526890818,31,29,1,1
"912347650",70,3743.17126447221,3993.3659690429,2823.11677003184,31,39,1,1
"912347651",74,2976.80440468968,3321.53777509786,2855.36548874306,37,37,1,1
"912347652",68,3311.2789559849,3465.88732004527,2806.43931339586,38,30,1,1
"912347653",78,4171.35905607256,4383.65239387242,2886.25582696583,39,39,1,1
"912347654",44,3017.86787944337,2765.49499480278,2567.51523707907,26,18,1,1
"912347655",53,3462.53494492004,3360.37289190912,2667.061866114,24,29,1,1
"912347656",61,3598.1619082292,3518.29941695784,2744.81051624266,38,23,1,1
"912347657",59,3376.66831578023,3012.12975796564,2726.17127719361,32,27,1,1
"912347658",49,2881.11189688366,2726.7222270846,2624.62502504328,17,32,1,1
"912347659",48,3242.13326970446,2620.03603616716,2613.58673801098,24,24,1,1
"912347660",38,2622.91612361788,2726.29804507114,2491.71993967651,16,22,1,1
"912347661",38,2406.47175554352,2472.24424800952,2491.71993967651,18,20,1,1
"912347662",43,2849.25900795957,2910.60887950149,2555.47878346624,20,23,1,1
"912347663",52,3552.37671083969,3266.82046016746,2656.6981055205,24,28,1,1
"912347664",60,3377.90287912948,3388.78411703973,2735.5526890818,30,30,1,1
"912347665",58,3150.39445601343,3169.83991225023,2716.66249357165,25,33,1,1
"912347666",33,2953.17976738802,3047.88514154978,2420.89448855093,14,19,1,1
"912347667",63,3410.9902910118,3779.00436990621,2762.96971264875,32,31,1,1
"912347668",50,3193.51548153206,3335.53087806661,2635.48551585152,22,28,1,1
"912347669",34,2600.75510368143,2571.62049630398,2435.71163614839,16,18,1,1
"912347670",53,3013.44868019584,3031.88013371085,2667.061866114,26,27,1,1
"912347671",53,3063.25564048428,2957.46533747789,2667.061866114,24,29,1,1
"912347672",53,2704.89243713852,2923.48642517357,2667.061866114,27,26,1,1
"912347673",40,3003.63040665485,3552.62941728927,2517.98110851286,19,21,1,1
"912347674",52,2579.32769873174,3097.34446033702,2656.6981055205,26,26,1,1
"912347675",66,3739.12922827866,3220.80460375726,2789.3669207067,32,34,1,1
"912347676",65,3293.36802012656,3020.20724415719,2780.67589681985,28,37,1,1
"912347677",52,3262.38487394759,3026.37025099,2656.6981055205,25,27,1,1
"912347678",64,3258.91909195387,3227.77732842716,2771.87783482774,29,35,1,1
"912347679",49,3505.83661106637,3295.97632290877,2624.62502504328,25,24,1,1
"912347680",41,2728.17185390323,2937.34768605086,2530.72175773865,19,22,1,1
"912347681",59,2738.99197799289,2449.42307269691,2726.17127719361,32,27,1,1
"912347682",62,3133.58706719112,3417.33969053567,2753.94837323248,38,24,1,1
"912347683",68,4108.77641510922,3511.25363131526,2806.43931339586,34,34,1,1
"912347684",44,3052.46205522031,2906.00168836932,2567.51523707907,25,19,1,1
"912347685",64,3232.16615565023,2454.707616386,2771.87783482774,34,30,1,1
"912347686",62,2978.97971299874,3125.95757715966,2753.94837323248,34,28,1,1
"912347687",63,2974.67602931902,2884.02736076389,2762.96971264875,31,32,1,1
"912347688",46,2581.25046428932,2897.13587799479,2590.94954296761,25,21,1,1
"912347689",52,3131.86099823683,3370.40758036375,2656.6981055205,26,26,1,1
"912347690",40,2783.87745756331,3001.22561796381,2517.98110851286,19,21,1,1
"912347692",56,3207.29578213757,2899.39337386339,2697.24673169728,29,27,1,1
"912347693",35,2602.74199853901,2822.75146433023,2450.1860183293,22,13,1,1
"912347694",52,2616.57204080769,3046.37696289325,2656.6981055205,32,20,1,1
"912347695",37,2601.8497518145,2583.55724440089,2478.17471526668,24,13,1,1
"912347696",30,2662.54655824644,2802.61669971027,2374.18906024059,20,10,1,1
"912347697",47,2536.54437752075,2586.06885030513,2602.36394728806,22,25,1,1
"912347698",46,3027.9490229958,3190.23428656862,2590.94954296761,26,20,1,1
"912347699",52,3141.74286584093,3676.15458533306,2656.6981055205,25,27,1,1
"912347700",39,2973.05328326789,3179.83264507215,2504.98447234734,15,24,1,1
"912347701",56,2655.28612158092,2860.74776112305,2697.24673169728,29,27,1,1
"912347702",37,2713.86978398311,2953.92253881655,2478.17471526668,22,15,1,1
"912347703",52,2742.44638123598,2874.75441593685,2656.6981055205,31,21,1,1
"912347704",44,2868.05393975607,2842.21807637921,2567.51523707907,24,20,1,1
"912347705",39,2830.10454114927,2795.09960026222,2504.98447234734,18,21,1,1
"912347706",48,2830.99218544185,2890.18728520771,2613.58673801098,28,20,1,1
"912347707",57,2904.83708364199,2601.97415981013,2707.02236739438,29,28,1,1
"912347708",49,2668.2360920761,2278.44145332185,2624.62502504328,23,26,1,1
"912347709",45,2778.18441132314,3364.77912431009,2579.33597919865,20,25,1,1
"912347710",26,2370.05877608757,2607.82416965176,2305.75108410937,13,13,1,1
"912347711",24,2398.36558161943,2736.9884584014,2268.33468283819,10,14,1,1
"912347712",58,3211.27252142099,3185.08335318599,2716.66249357165,32,26,1,1
"912347713",35,2710.99014264436,2746.59799266194,2450.1860183293,17,18,1,1
"912347714",59,2813.82475417936,2786.64343168751,2726.17127719361,34,25,1,1
"912347715",52,3098.58193033378,3382.36510270172,2656.6981055205,28,24,1,1
"912347716",43,3163.86067849258,3916.32933246078,2555.47878346624,24,19,1,1
"912347717",30,2743.33846432885,3190.34967376589,2374.18906024059,17,13,1,1
"912347718",30,2730.77834001118,3353.27426266102,2374.18906024059,13,17,1,1
"912347719",42,3082.26160009447,3907.48207968885,2543.21752514954,23,19,1,1
"912347720",33,2793.44654268053,3448.21074547223,2420.89448855093,20,13,1,1
"912347721",47,2743.97419833259,2677.49185030989,2602.36394728806,27,20,1,1
"912347724",50,3160.38944571151,3637.0327488683,2635.48551585152,24,26,1,1
"912347725",46,3416.55148043858,3444.74259986731,2590.94954296761,26,20,1,1
"912347726",41,2957.16928466972,2766.68400887388,2530.72175773865,20,21,1,1
"912347727",48,3086.54076672643,3542.07254564096,2613.58673801098,28,20,1,1
"912347728",39,2624.42360634809,2904.24933516805,2504.98447234734,19,20,1,1
"912347729",39,2806.33251824117,3326.8106949296,2504.98447234734,20,19,1,1
"912347730",32,2858.81944944559,3093.49138218059,2405.71569249515,17,15,1,1
"912347731",51,3139.07108553278,3624.48201951926,2646.17454577679,26,25,1,1
"912347732",50,3346.19935315148,3432.16335438846,2635.48551585152,26,24,1,1
"912347733",48,2976.11384744028,2782.22524077228,2613.58673801098,23,25,1,1
"912347734",58,3407.78203604696,4162.08306766151,2716.66249357165,30,28,1,1
"912347735",63,3598.31144028807,5077.23189975599,2762.96971264875,29,34,1,1
"912347736",63,3298.13772090258,4843.76942872289,2762.96971264875,30,33,1,1
"912347737",49,3235.90057966527,4111.83623750735,2624.62502504328,28,21,1,1
"912347738",43,2853.56687175743,2758.95405949332,2555.47878346624,20,23,1,1
"912347739",55,3128.53529911498,3333.87581802696,2687.33120998132,24,31,1,1
"912347740",52,3313.88254530962,3481.89706295426,2656.6981055205,25,27,1,1
"912347741",46,2988.51034972552,3168.41749588246,2590.94954296761,17,29,1,1
"912347742",56,2937.15502722951,3284.38298105068,2697.24673169728,26,30,1,1
"912347743",51,3067.44456878972,3482.95047906126,2646.17454577679,24,27,1,1
"912347744",34,2551.30328977618,2704.01999322006,2435.71163614839,16,18,1,1
"912347745",52,2938.06342502768,3348.79989044287,2656.6981055205,22,30,1,1
"912347746",53,3510.53470869952,3753.94290819339,2667.061866114,27,26,1,1
"912347747",58,3221.78045809292,3542.85119506109,2716.66249357165,29,29,1,1
"912347749",53,3442.59310486259,3151.42698249595,2667.061866114,23,30,1,1
"912347750",45,3083.75769729885,3147.86012064198,2579.33597919865,24,21,1,1
"912347751",52,3212.70699459952,3812.37335806605,2656.6981055205,26,26,1,1
"912347752",48,2968.98382493663,3085.45869481854,2613.58673801098,25,23,1,1
"912347753",71,3248.27849870879,3660.51946362188,2831.31372136695,37,34,1,1
"912347754",66,3276.34268895708,3831.97720233248,2789.3669207067,33,33,1,1
"912347755",70,3559.60018394728,4270.62641176224,2823.11677003184,43,27,1,1
"912347756",45,3241.07721972167,3283.27262746663,2579.33597919865,23,22,1,1
"912347757",48,2744.62084981679,3324.16656536916,2613.58673801098,21,27,1,1
"912347758",76,3448.478641657,4154.75003525257,2870.97236507783,42,34,1,1
"912347759",85,3889.13107096766,5618.65529630637,2937.40494579778,48,37,1,1
"912347760",86,4265.69933974193,5724.03290102655,2944.43562859908,46,40,1,1
"912347761",78,3551.84725428978,4960.96830186788,2886.25582696583,48,30,1,1
"912347762",52,2825.37190195047,3095.40681338628,2656.6981055205,30,22,1,1
"912347763",53,3223.60880265237,3758.91017691807,2667.061866114,34,19,1,1
"912347764",47,2755.69432536305,2712.12270063655,2602.36394728806,28,19,1,1
"912347765",47,2993.48074206915,3050.82338358012,2602.36394728806,24,23,1,1
"912347766",52,3224.87072547416,3609.1827015635,2656.6981055205,28,24,1,1
"912347767",53,3091.84102186573,3216.96816482484,2667.061866114,31,22,1,1
"912347768",46,2891.84757881155,2981.02775750201,2590.94954296761,26,20,1,1
"912347769",54,2798.21580097426,3258.12395453663,2677.2712016452,32,22,1,1
"912347770",49,3130.32811519819,3945.69444928416,2624.62502504328,29,20,1,1
"912347771",53,2957.52791460704,2923.84427587605,2667.061866114,32,21,1,1
"912347772",60,3392.01645907159,4004.34780265772,2735.5526890818,38,22,1,1
"912347773",60,3026.52268205938,3280.48010219857,2735.5526890818,38,22,1,1
"912347774",43,2794.0042118516,3078.12090322495,2555.47878346624,30,13,1,1
"912347775",56,3203.95510676908,3676.09785879295,2697.24673169728,34,22,1,1
"912347776",57,3015.81501054922,3916.28141688508,2707.02236739438,33,24,1,1
"912347781",45,2665.6865973316,2780.99964430891,2579.33597919865,28,17,1,1
"912347782",56,2667.2102155136,2676.13311936485,2697.24673169728,29,27,1,1
"912347783",45,2620.30640874896,2590.8279822026,2579.33597919865,26,19,1,1
"912347784",45,2728.6845083626,2982.95736187259,2579.33597919865,25,20,1,1
"912347786",38,2518.44106756613,2394.1982596664,2491.71993967651,26,12,1,1
"912347787",38,2534.80828634828,2522.46071959427,2491.71993967651,24,14,1,1
"912347788",63,2758.41271247604,2471.84145138763,2762.96971264875,34,29,1,1
"912347789",54,3046.54709206202,3045.64828596802,2677.2712016452,30,24,1,1
"912347790",69,3064.23208128349,3477.85861655547,2814.82611826518,41,28,1,1
"912347791",76,3515.19191682172,4406.22494066752,2870.97236507783,45,31,1,1
"912347792",55,3161.49894973363,3446.22459443131,2687.33120998132,35,20,1,1
"912347793",80,3600.43073724975,4368.50091312114,2901.2306171403,45,35,1,1
"912347794",63,3111.80861892924,3051.50621721917,2762.96971264875,39,24,1,1
"912347795",30,2344.99947022562,2254.81932671723,2374.18906024059,19,11,1,1
"912347796",23,2246.38289237947,2197.5618280264,2248.68783741607,12,11,1,1
"912347797",22,2242.63172329079,2040.72731016382,2228.3491786518,14,8,1,1
"912347798",12,1982.29859582917,2110.60272459171,1968.69006049611,7,5,1,1
"912347799",13,1970.08494044034,1976.31327790317,2001.16379457045,7,6,1,1
"912347802",59,2819.33448056965,3915.1041977289,2726.17127719361,25,34,1,1
"912347803",47,2621.4965291469,2686.80737433694,2602.36394728806,19,28,1,1
"912347808",55,3018.70743640219,3823.1086315239,2687.33120998132,26,29,1,1
"912347809",37,2793.28570385591,3210.67903979226,2478.17471526668,17,20,1,1
"912347816",32,2675.37866456986,3478.25489575733,2405.71569249515,12,20,1,1
"912347817",41,2818.23282801805,3288.35255277192,2530.72175773865,21,20,1,1
"912347822",60,2502.4886964898,2951.78670671244,2735.5526890818,26,34,1,1
"912347823",67,2812.8734947269,2414.64860642941,2797.95380131742,36,31,1,1
"912349252",7,1736.13374417005,1655.85862132745,1763.32076508842,1,6,1,1
"912349253",7,1800.37089199842,1921.32768271563,1763.32076508842,0,7,1,1
"912349254",9,1828.88724938397,2129.13168844699,1856.26587460569,1,8,1,1
"912349255",5,1679.50104732665,1939.68071223106,1646.12614877363,1,4,1,1
"912349256",6,1756.31576273589,1922.15645068542,1708.62817714657,0,6,1,1
"912349257",13,1781.35814924813,1707.86141742817,2001.16379457045,2,11,1,1
"912349258",7,1791.50190253212,2028.08362691395,1763.32076508842,1,6,1,1
"912349259",7,1754.94842010142,1998.4767404928,1763.32076508842,2,5,1,1
"912349260",8,1824.17955680403,1916.09843625313,1812.11073017574,1,7,1,1
"912349261",7,1765.32606916313,2036.83790737654,1763.32076508842,0,7,1,1
"912349262",6,1768.7396495308,1959.35292957162,1708.62817714657,0,6,1,1
"912349263",6,1718.51255047346,1857.23068630841,1708.62817714657,0,6,1,1
"912349264",9,1788.16252299677,1878.26304781759,1856.26587460569,1,8,1,1
"912349265",10,1822.52516160943,1834.7558566398,1896.67490607898,1,9,1,1
"912349266",10,1843.09271115119,1915.8934897156,1896.67490607898,2,8,1,1
"912349267",10,1734.05858434899,1720.01334520329,1896.67490607898,1,9,1,1
"912349268",9,1848.68133679814,1808.95247005635,1856.26587460569,1,8,1,1
"912349269",10,1767.99683782689,1573.00374887101,1896.67490607898,2,8,1,1
"912349270",10,1817.77056899608,1961.91435901077,1896.67490607898,1,9,1,1
"912349271",6,1720.82851818857,1702.78006086182,1708.62817714657,0,6,1,1
"912349272",6,1711.62683872933,1858.52831838939,1708.62817714657,0,6,1,1
"912349273",8,1756.43083513334,1756.28634007991,1812.11073017574,2,6,1,1
"912349274",5,1689.76450035473,1854.90335687768,1646.12614877363,0,5,1,1
"912349275",11,1799.65539806336,1609.5143855146,1933.98659929558,2,9,1,1
"912349276",9,1777.91327213067,1736.0267738138,1856.26587460569,1,8,1,1
"912349277",9,1823.51470283836,1920.00077198962,1856.26587460569,1,8,1,1
"912349278",12,1792.09777334353,1517.23648855967,1968.69006049611,3,9,1,1
"912349279",6,1685.71356394216,1488.93755678851,1708.62817714657,1,5,1,1
"912349280",8,1680.08218140183,1636.54272487269,1812.11073017574,2,6,1,1
"912349281",7,1748.05232374569,1804.50371702055,1763.32076508842,0,7,1,1
"912349282",10,1744.96918760682,1759.20705323046,1896.67490607898,1,9,1,1
"912349283",11,1755.81228564419,1449.87787177759,1933.98659929558,2,9,1,1
"912349285",6,1711.62683872933,1787.94546830864,1708.62817714657,0,6,1,1
"912349286",7,1747.23067888069,1533.11339246986,1763.32076508842,1,6,1,1
"912349287",7,1747.23067888069,1573.41012136036,1763.32076508842,1,6,1,1
"912349288",9,1832.35120885396,2078.89318889975,1856.26587460569,2,7,1,1
"912349289",9,1777.86755591402,1593.96205102433,1856.26587460569,2,7,1,1
"912349290",5,1684.74990748949,1797.84272749762,1646.12614877363,0,5,1,1
"912349291",5,1684.74990748949,1828.08084064182,1646.12614877363,0,5,1,1
"912349292",3,1520.15924598997,1662.75423133866,1482.92019466158,0,3,1,1
"912349293",6,1751.80004777052,1902.92491236796,1708.62817714657,0,6,1,1
"912349616",34,2890.21440628083,3618.16746402458,2435.71163614839,20,14,1,1
"912349617",45,2815.96342961602,3591.2308997364,2579.33597919865,25,20,1,1
"912349618",41,2713.54200603054,3463.45205457628,2530.72175773865,23,18,1,1
"912349619",34,2722.47120639472,3657.21833703791,2435.71163614839,17,17,1,1
"912349620",29,2500.48661531211,2839.04065768894,2357.79423966008,15,14,1,1
"912349621",39,2804.3878349372,3487.5614633954,2504.98447234734,18,21,1,1
"912349622",48,3418.0670911897,4537.03195152607,2613.58673801098,20,28,1,1
"912349623",38,2179.27328895324,2621.82934502225,2491.71993967651,16,22,1,1
"912349624",37,2909.5164147442,3664.58185183705,2478.17471526668,20,17,1,1
"912349625",37,2885.97074509154,3794.91034730323,2478.17471526668,19,18,1,1
"912349626",47,3114.09287506857,3902.36441823584,2602.36394728806,22,25,1,1
"912349627",26,2200.66151368315,2414.99219625422,2305.75108410937,12,14,1,1
"912349628",38,2695.35400520642,2738.51763217834,2491.71993967651,20,18,1,1
"912349630",51,3134.97172622907,3686.31314141873,2646.17454577679,28,23,1,1
"912349632",26,2519.19816164528,3005.14461249468,2305.75108410937,14,12,1,1
"912349633",32,2464.32124049372,2721.90670615101,2405.71569249515,17,15,1,1
"912349634",32,2434.66004437023,2220.73040440325,2405.71569249515,18,14,1,1
"912349635",38,2748.64271663441,2871.55789229021,2491.71993967651,18,20,1,1
"912349636",46,3124.92968779554,4095.23654948268,2590.94954296761,22,24,1,1
"912349637",36,2817.50910240194,3895.04936967242,2464.33502634194,21,15,1,1
"912349639",59,3332.35862903733,3783.93517972875,2726.17127719361,31,28,1,1
"912349640",26,2247.70687547562,2361.57642753071,2305.75108410937,14,12,1,1
"912349641",42,2965.29388721331,3609.16847124954,2543.21752514954,20,22,1,1
"912349642",54,3146.40394283102,3498.87469374854,2677.2712016452,25,29,1,1
"912349643",56,3369.49167963272,4200.79402355679,2697.24673169728,27,29,1,1
"912349644",15,2121.66623032468,2084.56499093076,2060.56118614118,8,7,1,1
"912349645",31,2227.44338002815,2566.8446105621,2390.15469389133,16,15,1,1
"912349646",43,2751.70638705111,2828.59479979614,2555.47878346624,24,19,1,1
"912349647",36,2646.40460893926,3008.45521022825,2464.33502634194,20,16,1,1
"912349648",49,3216.13472481843,4232.71587211246,2624.62502504328,30,19,1,1
"912349649",42,3217.04741775784,4618.35377572505,2543.21752514954,22,20,1,1
"912349650",35,2686.28162719774,3524.79356892117,2450.1860183293,20,15,1,1
"912349651",61,3730.24160869367,5765.92600687153,2744.81051624266,33,28,1,1
"912349652",50,3271.15762501259,4622.5177943825,2635.48551585152,26,24,1,1
"912349653",29,2608.01304329551,2890.53850613663,2357.79423966008,18,11,1,1
"912349654",31,2473.17973847154,2871.50359802704,2390.15469389133,17,14,1,1
"912349655",32,2759.33989114989,3372.07407970311,2405.71569249515,16,16,1,1
"912349656",54,2834.82829809797,3480.67088147275,2677.2712016452,30,24,1,1
"912349657",44,2831.8783863173,3700.77007128197,2567.51523707907,22,22,1,1
"912349658",61,3549.95259038227,6583.54361871827,2744.81051624266,33,28,1,1
"912349659",23,2141.19260383595,2194.31032989802,2248.68783741607,13,10,1,1
"912349660",42,2805.53136064283,2896.75202777683,2543.21752514954,25,17,1,1
"912349661",48,2962.66051880667,3176.42873642933,2613.58673801098,28,20,1,1
"912349662",34,2674.54754382154,2943.06216988776,2435.71163614839,18,16,1,1
"912349663",49,2826.41605072694,3174.03077657608,2624.62502504328,27,22,1,1
"912349664",29,2488.67285369235,2606.76692154463,2357.79423966008,16,13,1,1
"912349665",41,3194.9411404229,4205.54128088042,2530.72175773865,20,21,1,1
"912349666",31,2830.27083027913,3209.40180824157,2390.15469389133,18,13,1,1
"912349667",44,3019.22140514693,3858.27479181813,2567.51523707907,21,23,1,1
"912349668",42,3153.16988467149,4183.66929595636,2543.21752514954,24,18,1,1
"912349669",36,3129.56679905513,3266.95252011378,2464.33502634194,21,15,1,1
"912349670",45,2988.39259562735,3624.35688309765,2579.33597919865,25,20,1,1
"912349671",43,2379.83783116417,2184.73004920925,2555.47878346624,23,20,1,1
"912349672",60,3410.53128766392,3374.11612920664,2735.5526890818,32,28,1,1
"912349673",53,3196.1377049219,4524.97853812345,2667.061866114,27,26,1,1
"912349674",45,2715.57945501817,3093.89798496662,2579.33597919865,19,26,1,1
"912349675",47,2903.37995426388,3395.62288982063,2602.36394728806,24,23,1,1
"912349676",38,2729.27164390527,3635.43789117397,2491.71993967651,22,16,1,1
"912349677",41,3261.40263632232,3702.04821734564,2530.72175773865,21,20,1,1
"912349678",40,3032.8425742556,2805.35755310171,2517.98110851286,18,22,1,1
"912349679",45,2825.78521788861,3350.82465432238,2579.33597919865,22,23,1,1
"912349680",29,2558.03653922607,2877.06025887481,2357.79423966008,13,16,1,1
"912349681",38,2811.87717133921,3362.2921657006,2491.71993967651,19,19,1,1
"912349682",31,2592.57137411921,2683.52581346116,2390.15469389133,15,16,1,1
"912349683",41,2953.80222372333,2783.63914159204,2530.72175773865,22,19,1,1
"912349684",37,2447.645421898,2908.62764754323,2478.17471526668,15,22,1,1
"912349685",43,2928.92089895161,3789.67644229687,2555.47878346624,24,19,1,1
"912349686",45,3097.94709598157,3723.85614793687,2579.33597919865,24,21,1,1
"912349687",41,2794.98182487392,2469.27597842887,2530.72175773865,22,19,1,1
"912349688",39,2501.32265907816,2924.43237316291,2504.98447234734,22,17,1,1
"912349711",54,3135.84715763797,3497.72496260711,2677.2712016452,27,27,1,1
"912349712",44,2603.30693808463,2517.91685095459,2567.51523707907,24,20,1,1
"912349713",32,2651.10990455063,2520.59847036456,2405.71569249515,21,11,1,1
"912350196",92,3848.92885057396,3726.71311967475,2985.30521778333,39,53,1,1
"912350198",39,2659.69622847595,2299.83443585454,2504.98447234734,22,17,1,1
"912350199",24,2372.45102170557,1940.80435612944,2268.33468283819,12,12,1,1
"912350200",16,2092.25621353931,1665.51644752293,2087.92318348224,8,8,1,1
"912350201",13,2065.76470863251,1982.79452980701,2001.16379457045,7,6,1,1
"912350202",34,2719.71659297802,3162.80753186646,2435.71163614839,20,14,1,1
"912350203",27,2522.5820672412,2948.79007644371,2323.60649590586,16,11,1,1
"912350204",44,2940.12101620071,3511.30722466928,2567.51523707907,25,19,1,1
"912350205",29,2743.93654865364,3177.69219510739,2357.79423966008,16,13,1,1
"912350206",38,2634.68381478136,3244.46004574332,2491.71993967651,21,17,1,1
"912350207",31,2539.40378112797,2446.64316167381,2390.15469389133,18,13,1,1
"912350208",20,2380.67833323796,2649.7637069172,2185.35845629437,10,10,1,1
"912350209",29,2559.43414958936,2772.72002180071,2357.79423966008,15,14,1,1
"912350211",22,2291.79884535948,2167.03046895494,2228.3491786518,14,8,1,1
"912350212",41,2889.18560652244,2918.16483438361,2530.72175773865,19,22,1,1
"912350213",40,2833.52631017822,3182.88576612557,2517.98110851286,21,19,1,1
"912350214",27,2385.65209732991,2186.31679956132,2323.60649590586,18,9,1,1
"912350216",33,2592.41836836751,2034.90461859555,2420.89448855093,16,17,1,1
"912350217",23,2290.88657236639,2028.71977360363,2248.68783741607,12,11,1,1
"912350218",26,2377.69371104384,2483.44221842719,2305.75108410937,14,12,1,1
"912350219",24,2506.16775297983,2784.40104765916,2268.33468283819,12,12,1,1
"912350220",35,2524.23754420443,2390.28196973137,2450.1860183293,19,16,1,1
"912350221",28,2431.52409407272,2272.29841864701,2340.94327947849,18,10,1,1
"912350222",33,2224.77814025385,1942.81222777977,2420.89448855093,21,12,1,1
"912350223",16,2025.37231669744,1776.24007881096,2087.92318348224,10,6,1,1
"912350224",31,2605.99584323074,2478.39354699852,2390.15469389133,18,13,1,1
"912350225",27,2471.96920129093,2265.49563572998,2323.60649590586,15,12,1,1
"912350226",27,2660.51412018471,2965.79313216166,2323.60649590586,14,13,1,1
"912350227",29,2831.65190927041,3016.53387614788,2357.79423966008,15,14,1,1
"912350228",17,2218.05377911496,2554.45816510647,2113.95669457394,14,3,1,1
"912350229",29,2512.10068469097,2797.29748050539,2357.79423966008,16,13,1,1
"912350230",45,3279.58622739831,3489.73587850797,2579.33597919865,26,19,1,1
"912350231",37,2963.6405408416,3319.47827935898,2478.17471526668,23,14,1,1
"912350232",40,2783.65564797653,2677.01159837423,2517.98110851286,22,18,1,1
"912350233",35,2543.36220447773,2642.22480978057,2450.1860183293,23,12,1,1
"912350234",33,2497.0873102838,2557.6199427833,2420.89448855093,15,18,1,1
"912350235",36,2949.36973580838,2931.52333735982,2464.33502634194,19,17,1,1
"912350236",39,2918.71338216277,3846.216002991,2504.98447234734,21,18,1,1
"912350237",40,3149.46473320211,3736.28686654793,2517.98110851286,22,18,1,1
"912350238",28,2444.92991127153,2242.77193281754,2340.94327947849,16,12,1,1
"912350239",35,2527.63291287576,2141.89749715453,2450.1860183293,19,16,1,1
"912350240",30,2510.01999343888,2019.40199088433,2374.18906024059,18,12,1,1
"912350241",39,2550.42253420924,2524.18999243135,2504.98447234734,20,19,1,1
"912350243",28,2486.80787919094,2242.74351771473,2340.94327947849,15,13,1,1
"912350244",20,2177.39624003217,1776.86149611676,2185.35845629437,9,11,1,1
"912350245",28,2095.0584982065,1926.93433146271,2340.94327947849,15,13,1,1
"912350246",36,2602.23426377684,2409.16654298307,2464.33502634194,20,16,1,1
"912350247",13,2002.38349349647,1724.4172097309,2001.16379457045,5,8,1,1
"912350248",22,2248.54370375175,1932.85861449907,2228.3491786518,10,12,1,1
"912350250",17,2138.89110563294,1804.58184272989,2113.95669457394,7,10,1,1
"912350252",9,1735.76583786105,1599.53662912579,1856.26587460569,3,6,1,1
"912350253",49,2726.68416381562,2278.96698203455,2624.62502504328,28,21,1,1
"912350254",49,2935.41172919103,2379.06700552692,2624.62502504328,31,18,1,1
"912350255",49,2866.97755426702,2406.64121427895,2624.62502504328,29,20,1,1
"912350256",54,2878.26099777982,2782.4232065741,2677.2712016452,26,28,1,1
"912350257",20,2202.90983361132,1788.36113850626,2185.35845629437,11,9,1,1
"912350258",18,2131.31148907826,1706.57288926944,2138.79896507223,11,7,1,1
"912350259",12,1903.35275340232,1636.20313911168,1968.69006049611,4,8,1,1
"912350260",10,1833.49464878237,1615.31689307593,1896.67490607898,6,4,1,1
"912350261",33,2378.15596191143,2050.72255795728,2420.89448855093,15,18,1,1
"912350262",27,2458.24000331875,2227.75576848236,2323.60649590586,12,15,1,1
"912350263",24,2131.38301657704,1909.46511059614,2268.33468283819,12,12,1,1
"912350264",24,2137.89733624455,1841.68892891276,2268.33468283819,14,10,1,1
"912350265",19,1995.89108039589,1597.87819827662,2162.56636020013,9,10,1,1
"912350266",12,1835.52205282642,1722.62524962574,1968.69006049611,5,7,1,1
"912350267",18,2013.55719487192,1654.27347647521,2138.79896507223,6,12,1,1
"912350268",19,1995.8104327476,1796.29127868147,2162.56636020013,8,11,1,1
"912350273",43,2658.11147637945,2384.90809512203,2555.47878346624,24,19,1,1
"912350274",26,2240.03625382891,2292.21838483448,2305.75108410937,16,10,1,1
"912350276",24,2475.667546102,2763.06911896312,2268.33468283819,14,10,1,1
"912350277",22,2390.64546603438,2543.68515037234,2228.3491786518,11,11,1,1
"912350280",34,2571.56505165899,2387.12793512964,2435.71163614839,19,15,1,1
"912350281",25,2341.17195465891,2053.96861303883,2287.34065519221,13,12,1,1
"912350282",46,2838.73543389087,2195.68101035963,2590.94954296761,26,20,1,1
"912350283",18,1987.58433357185,1787.71328291125,2138.79896507223,10,8,1,1
"912350284",40,2622.72930685716,2348.69832286758,2517.98110851286,25,15,1,1
"912350285",30,2234.34050479675,1572.83615733523,2374.18906024059,17,13,1,1
"912350286",35,2488.01475159335,2004.23254370951,2450.1860183293,20,15,1,1
"912350287",14,1954.80192755601,1813.26368066224,2031.70713799962,8,6,1,1
"912350288",57,3116.69221337902,2682.39395302042,2707.02236739438,33,24,1,1
"912350294",65,3183.54028085803,2759.91291424597,2780.67589681985,32,33,1,1
"912350295",57,2808.61916350558,2324.66008003338,2707.02236739438,30,27,1,1
"912350296",85,3571.65953706008,3200.72925651971,2937.40494579778,37,48,1,1
"912350297",92,3548.50932945318,2394.068140387,2985.30521778333,42,50,1,1
"912350298",70,3621.90563168967,2708.75238006647,2823.11677003184,31,39,1,1
"912350299",93,3558.95419094147,2321.14890837002,2991.90921350397,46,47,1,1
"912350300",56,3452.52340935586,2989.01929072992,2697.24673169728,24,32,1,1
"912350301",46,2842.11412130475,2273.79208279342,2590.94954296761,23,23,1,1
"912350302",84,3718.65905866235,3269.87041984536,2930.30814451558,40,44,1,1
"912350303",77,3618.34745260885,2873.85580076569,2878.65357631343,36,41,1,1
"912350304",67,3321.90433456853,3265.60306664084,2797.95380131742,32,35,1,1
"912350305",67,2971.37043970485,2893.96659328825,2797.95380131742,32,35,1,1
"912350306",87,3575.47032004538,2381.69782569884,2951.40156710974,38,49,1,1
"912350307",71,3804.74804507985,3457.98377777896,2831.31372136695,36,35,1,1
"912350308",74,3502.35829595172,3143.3613241214,2855.36548874306,36,38,1,1
"912350309",79,3687.25337671069,3088.34781170855,2893.78092561085,36,43,1,1
"912350310",65,4032.34050447832,3485.64261739175,2780.67589681985,33,32,1,1
"912350311",61,3274.91480905576,3324.37887490265,2744.81051624266,31,30,1,1
"912350312",65,3261.09125015737,2732.02576116621,2780.67589681985,36,29,1,1
"912350313",30,2733.67857424708,2621.35877199205,2374.18906024059,14,16,1,1
"912350314",41,2787.79942742146,2523.71205707919,2530.72175773865,12,29,1,1
"912350315",41,2916.26639087024,3354.86279965404,2530.72175773865,18,23,1,1
"912350316",50,3280.11875656614,3300.15152325122,2635.48551585152,23,27,1,1
"912350317",65,3487.61306767951,3107.31711835607,2780.67589681985,34,31,1,1
"912350318",86,3310.80291677401,2762.77862272615,2944.43562859908,43,43,1,1
"912350319",78,2758.30174358662,1937.78400021015,2886.25582696583,33,45,1,1
"912350320",63,3093.74587082548,2563.23937121596,2762.96971264875,24,39,1,1
"912350321",63,2983.62542890354,2324.2108708774,2762.96971264875,26,37,1,1
"912350322",72,3466.6726004442,2743.00529294115,2839.4193288992,35,37,1,1
"912350323",74,3259.33137725592,2397.83887224385,2855.36548874306,36,38,1,1
"912350324",59,3037.70078315742,2282.46921615251,2726.17127719361,27,32,1,1
"912350325",59,3302.70086656655,2437.28098081145,2726.17127719361,30,29,1,1
"912350326",61,3299.8730508267,2786.5462991416,2744.81051624266,27,34,1,1
"912350327",75,2664.92506842294,2374.82152870017,2863.21031780169,31,44,1,1
"912350328",100,3367.83228232436,2169.92614648549,3036.61979185145,43,57,1,1
"912350329",65,3346.36991142048,3100.6747193456,2780.67589681985,32,33,1,1
"912350330",54,3181.39582644905,3067.81531273389,2677.2712016452,27,27,1,1
"912350331",77,3108.54339616302,2634.97125741381,2878.65357631343,39,38,1,1
"912350332",66,3046.84661558384,2593.22834604819,2789.3669207067,32,34,1,1
"912350334",32,2648.33511670196,2500.5600884559,2405.71569249515,13,19,1,1
"912350335",80,3496.95359889275,2853.26720306871,2901.2306171403,36,44,1,1
"912350336",55,2903.93503856645,2741.239608489,2687.33120998132,24,31,1,1
"912350337",42,2709.03085321698,2688.52149756792,2543.21752514954,19,23,1,1
"912350338",26,2436.15004156123,2491.93254768799,2305.75108410937,11,15,1,1
"912350339",66,2844.88471337187,1923.55778056788,2789.3669207067,25,41,1,1
"912350340",53,2842.80561184431,1990.58779317906,2667.061866114,25,28,1,1
"912350341",96,4004.64463095049,2955.37263061757,3011.38790884243,38,58,1,1
"912350342",68,3440.43941147349,3604.28993072409,2806.43931339586,30,38,1,1
"912350343",59,3249.32190068991,2494.43942559592,2726.17127719361,30,29,1,1
"912350344",50,3088.03663473911,2526.18956347041,2635.48551585152,25,25,1,1
"912350345",72,3169.43873551029,2480.163523689,2839.4193288992,35,37,1,1
"912350346",80,3955.10094192491,3560.35729432324,2901.2306171403,34,46,1,1
"912350347",83,3568.96199919463,2702.94081223589,2923.1438046077,37,46,1,1
"912350348",86,3689.28879644666,2887.71098557464,2944.43562859908,43,43,1,1
"912350349",65,3818.05707179953,2788.61228325645,2780.67589681985,27,38,1,1
"912350350",56,3771.32473016296,3874.27832001715,2697.24673169728,21,35,1,1
"912350351",88,3874.45987226606,2699.92535277895,2958.30409156145,39,49,1,1
"912350352",74,3167.85737629371,2486.41298249513,2855.36548874306,39,35,1,1
"912350353",52,2990.74174916183,2602.55329899395,2656.6981055205,21,31,1,1
"912350354",59,3245.12026815442,2645.41781782883,2726.17127719361,25,34,1,1
"912350355",79,3349.58516684929,2455.26260200828,2893.78092561085,38,41,1,1
"912350686",100,4105.50239186771,4874.84668178643,3036.61979185145,45,55,1,1
"912350687",59,3114.5714160206,2728.81965871097,2726.17127719361,27,32,1,1
"912350688",42,2936.47352922373,2956.06671747516,2543.21752514954,19,23,1,1
"912350806",27,1911.23940739159,1225.03040377734,2323.60649590586,15,12,1,1
"912350836",40,2708.97211567976,2803.42377089854,2517.98110851286,23,17,1,1
"912350837",45,2855.21173229334,2953.88801404113,2579.33597919865,22,23,1,1
"912350838",25,1958.37749191237,1626.5688618257,2287.34065519221,8,17,1,1
"912350851",21,2000.20742904483,1805.01595800857,2207.26116887512,7,14,1,1
"912350859",29,2616.76849611374,2305.4902978322,2357.79423966008,13,16,1,1
"912350860",21,2300.18530133912,2200.1976763253,2207.26116887512,9,12,1,1
"912350861",20,2249.51760768727,2108.26756685703,2185.35845629437,9,11,1,1
"912350862",26,2345.96895930324,2133.35854119156,2305.75108410937,11,15,1,1
"912350863",19,2135.69343849861,2046.31155602381,2162.56636020013,9,10,1,1
"912350864",21,2353.53204574094,2217.25620502294,2207.26116887512,10,11,1,1
"912350865",22,2276.23213552459,2114.20048887006,2228.3491786518,12,10,1,1
"912350866",26,2385.03503415258,2195.39941058728,2305.75108410937,13,13,1,1
"912350867",25,2310.96288922831,1810.73860464466,2287.34065519221,10,15,1,1
"912350868",24,2364.50084872513,1847.13050832052,2268.33468283819,13,11,1,1
"912350869",28,2649.50976170271,2723.3995836828,2340.94327947849,13,15,1,1
"912350870",33,2602.0080241803,2467.23644881536,2420.89448855093,14,19,1,1
"912350871",19,2177.44451030455,2106.52259483809,2162.56636020013,7,12,1,1
"912350872",21,2242.39596843999,2233.74417391975,2207.26116887512,9,12,1,1
"912350873",23,2018.2452741271,1595.18126144159,2248.68783741607,11,12,1,1
"912350874",30,2325.43815873991,1949.4979691212,2374.18906024059,14,16,1,1
"912350875",16,2024.3841119872,1927.73900103392,2087.92318348224,5,11,1,1
"912350876",15,2019.48655710952,1819.18246006358,2060.56118614118,4,11,1,1
"912350878",25,2127.55833226571,1861.55730371146,2287.34065519221,12,13,1,1
"912350879",22,2345.12567680709,2127.35454519209,2228.3491786518,12,10,1,1
"912350880",26,2409.47405575579,2267.20841964941,2305.75108410937,12,14,1,1
"912350881",24,2267.05161073628,2061.04805494831,2268.33468283819,10,14,1,1
"912351273",10,1920.67985312388,2012.20462004151,1896.67490607898,4,6,1,1
"912351274",3,1527.60869315728,1482.06977558335,1482.92019466158,2,1,1,1
"912351275",16,2175.9305903476,2107.78738750775,2087.92318348224,8,8,1,1
"912351276",9,1939.11374696457,1892.49912248993,1856.26587460569,2,7,1,1
"912351287",13,1849.29454787436,1795.75012217352,2001.16379457045,3,10,1,1
"912351288",15,1738.92428784802,1504.64694056004,2060.56118614118,2,13,1,1
"912351289",19,1871.03217658292,1433.73055640095,2162.56636020013,6,13,1,1
"912351316",76,4167.3629634955,4642.49425847858,2870.97236507783,44,32,1,1
"912351317",73,3698.89973359782,4146.47506451519,2847.4358582506,46,27,1,1
"912351318",62,3083.72972990552,3116.8457433234,2753.94837323248,32,30,1,1
"912351319",47,2859.57676532178,2671.24947687499,2602.36394728806,23,24,1,1
"912351320",39,2863.87859665712,3388.31132653917,2504.98447234734,20,19,1,1
"912351321",28,2486.2609815947,2853.47300358663,2340.94327947849,14,14,1,1
"912351322",8,1891.48492232284,1923.5054779158,1812.11073017574,3,5,1,1
"912351323",8,1822.25456260493,1883.5830955816,1812.11073017574,4,4,1,1
"912351324",9,1835.83364708935,1857.53640403204,1856.26587460569,5,4,1,1
"912351423",29,2588.59720786625,2453.39824385115,2357.79423966008,15,14,1,1
"912351424",27,2569.32103265225,2877.900608522,2323.60649590586,21,6,1,1
"912351425",35,2787.30348687126,2910.49524199694,2450.1860183293,23,12,1,1
"912351426",30,2591.54452258819,2836.280671186,2374.18906024059,18,12,1,1
"912351427",36,2845.64564856996,2810.42157251199,2464.33502634194,23,13,1,1
"912351428",32,2534.70849994531,2505.69888421481,2405.71569249515,22,10,1,1
"912351429",32,2521.95064570093,2386.42752314561,2405.71569249515,20,12,1,1
"912351430",32,2707.35700631034,2757.81380211688,2405.71569249515,21,11,1,1
"912351431",16,1999.10676026748,1893.72283073595,2087.92318348224,7,9,1,1
"912351432",30,2331.92521507469,2269.79803238407,2374.18906024059,18,12,1,1
"912351448",20,2140.31359952744,2099.81420322071,2185.35845629437,10,10,1,1
"912351449",15,1983.40855880371,2022.07429810924,2060.56118614118,8,7,1,1
"912351450",19,2046.6237708689,1794.2304855929,2162.56636020013,9,10,1,1
"912351451",21,2095.34659278627,1942.48119938802,2207.26116887512,10,11,1,1
"912351452",17,2061.46316000291,2009.54028765868,2113.95669457394,8,9,1,1
"912351453",24,2217.01968852552,1904.32609382282,2268.33468283819,12,12,1,1
"912351454",24,2164.76213902432,2047.29581678062,2268.33468283819,12,12,1,1
"912351455",22,2005.15521029789,1745.96580629077,2228.3491786518,9,13,1,1
"912351731",25,2627.16271244051,2799.21211356624,2287.34065519221,15,10,1,1
"912351732",21,2389.23542447203,2193.02456983213,2207.26116887512,11,10,1,1
"912351733",13,2213.94409143616,2101.00858235582,2001.16379457045,5,8,1,1
"912351734",32,2708.17459712259,2643.33768151568,2405.71569249515,17,15,1,1
"912351735",59,3134.54112429244,3461.25581974017,2726.17127719361,32,27,1,1
"912351736",43,2795.22288637997,2867.29498912541,2555.47878346624,21,22,1,1
"912351737",45,2850.52324625304,2832.74745383662,2579.33597919865,23,22,1,1
"912351738",21,2098.88508743747,1890.41319707515,2207.26116887512,9,12,1,1
"912351739",17,1997.45540210241,1866.91316055909,2113.95669457394,6,11,1,1
"912351740",17,2023.36449498748,1860.89552261285,2113.95669457394,11,6,1,1
"912351741",16,2100.87227776482,2142.86146395575,2087.92318348224,10,6,1,1
"912351742",26,2341.82372585636,2434.4162652879,2305.75108410937,13,13,1,1
"912351743",29,2227.84268717108,2398.6771167982,2357.79423966008,16,13,1,1
"912351744",40,2610.07167715785,2570.86318629546,2517.98110851286,19,21,1,1
"912351745",50,2621.7186835728,2633.28615040442,2635.48551585152,27,23,1,1
"912351746",31,2620.36940143753,2553.46557537696,2390.15469389133,18,13,1,1
"912351747",50,2898.12464644908,2780.85327361759,2635.48551585152,30,20,1,1
"912351748",48,2615.78246533221,2547.24545328947,2613.58673801098,26,22,1,1
"912351749",34,2914.71408628384,3151.57227868507,2435.71163614839,15,19,1,1
"912351750",39,2990.06489854405,3101.99510652059,2504.98447234734,17,22,1,1
"912351751",27,2485.24341863463,2331.72100784735,2323.60649590586,14,13,1,1
"912351752",27,2556.86919768705,2428.2730498841,2323.60649590586,13,14,1,1
"912351753",41,2715.35294853222,2828.86885669491,2530.72175773865,22,19,1,1
"912351754",42,2796.36030403668,3016.55040350951,2543.21752514954,19,23,1,1
"912351755",48,3144.6612877215,3076.64161661863,2613.58673801098,22,26,1,1
"912351756",52,3228.069602576,3167.56179233873,2656.6981055205,26,26,1,1
"912351757",47,3264.12284699288,3415.01637003527,2602.36394728806,21,26,1,1
"912351758",47,3351.40864361213,3565.73646414209,2602.36394728806,21,26,1,1
"912351759",39,2900.09318539547,3023.99401659013,2504.98447234734,22,17,1,1
"912351760",32,2757.60082890882,2989.2382873743,2405.71569249515,16,16,1,1
"912351761",50,2659.33462423134,3052.82944651126,2635.48551585152,28,22,1,1
"912351762",49,2924.48145291058,3241.91328557101,2624.62502504328,31,18,1,1
"912351764",25,2339.61925614609,2362.3381597245,2287.34065519221,15,10,1,1
"912351766",21,2233.29447269113,2209.47366155519,2207.26116887512,13,8,1,1
"912351767",33,2457.98805492549,2453.02443593755,2420.89448855093,20,13,1,1
"912351768",25,2366.12117572981,2355.01542928004,2287.34065519221,16,9,1,1
"912351769",34,2482.96907270189,2549.91637456871,2435.71163614839,20,14,1,1
"912351770",42,2685.86812304719,2871.0579000108,2543.21752514954,31,11,1,1
"912351771",58,2797.79339878431,2582.18111146559,2716.66249357165,37,21,1,1
"912351772",49,3065.5702344363,3193.43618800852,2624.62502504328,24,25,1,1
"912351773",31,2768.01508540362,3011.79465191581,2390.15469389133,14,17,1,1
"912351774",39,2941.71276428771,2941.11762407063,2504.98447234734,18,21,1,1
"912351775",45,3029.14928829801,3552.14749145664,2579.33597919865,17,28,1,1
"912351776",48,3193.44368912409,3190.34266111723,2613.58673801098,21,27,1,1
"912351777",45,3331.43011033703,3806.45967371131,2579.33597919865,23,22,1,1
"912351778",36,2723.1787790374,3195.1221690087,2464.33502634194,18,18,1,1
"912351779",47,3161.96043435416,3325.32122913998,2602.36394728806,22,25,1,1
"912351780",42,2694.62902646339,2517.06275416428,2543.21752514954,19,23,1,1
"912351781",64,4119.14260195687,3914.947689855,2771.87783482774,28,36,1,1
"912351782",56,3465.92756370917,3660.09106185689,2697.24673169728,30,26,1,1
"912351783",42,2993.84594614145,3090.70454386212,2543.21752514954,23,19,1,1
"912351784",62,3357.2644948561,3017.5079544354,2753.94837323248,30,32,1,1
"912351785",49,3100.03817827657,3153.79325141754,2624.62502504328,22,27,1,1
"912351786",35,2611.39457724822,2760.61591357331,2450.1860183293,22,13,1,1
"912351787",30,2528.65631590387,2707.32024711013,2374.18906024059,19,11,1,1
"912351788",41,2523.85204746167,2568.72958012926,2530.72175773865,22,19,1,1
"912351789",39,2531.20797561501,2414.4707405083,2504.98447234734,23,16,1,1
"912351790",51,3074.75248581816,3382.85651285252,2646.17454577679,29,22,1,1
"912351791",52,2740.03809026907,2941.64259032783,2656.6981055205,28,24,1,1
"912351792",39,2939.29391828593,3816.04090988454,2504.98447234734,15,24,1,1
"912351793",46,2966.82259601176,3516.18689211636,2590.94954296761,20,26,1,1
"912351794",54,3449.7966836469,4270.7313151565,2677.2712016452,23,31,1,1
"912351795",54,3372.73850608171,4031.87185632797,2677.2712016452,27,27,1,1
"912351796",40,2728.13421660215,2853.65126823086,2517.98110851286,20,20,1,1
"912351797",35,2774.52984723809,2982.25159699382,2450.1860183293,18,17,1,1
"912351798",44,3295.42463746077,3266.26857518027,2567.51523707907,18,26,1,1
"912351799",31,2513.38825213466,2837.3825736813,2390.15469389133,14,17,1,1
"912351801",37,2434.22118478181,2537.18581327005,2478.17471526668,18,19,1,1
"912351802",42,2415.15765005588,2050.00391763794,2543.21752514954,25,17,1,1
"912351804",21,2290.87543448604,2465.86971262368,2207.26116887512,11,10,1,1
"912351805",17,2072.61530612618,1962.79041883373,2113.95669457394,8,9,1,1
"912351806",26,2381.16672728408,2418.59960839123,2305.75108410937,16,10,1,1
"912351807",22,2231.80066729096,2039.50489778737,2228.3491786518,13,9,1,1
"912351808",30,2230.33606900068,2346.94507090847,2374.18906024059,14,16,1,1
"912351809",45,2495.77597902432,2522.2580002373,2579.33597919865,30,15,1,1
"912351810",43,2543.67452537964,2858.11437371937,2555.47878346624,25,18,1,1
"912351811",43,2746.47007185091,2800.60408932661,2555.47878346624,30,13,1,1
"912351812",28,2817.9515168125,2988.94396498838,2340.94327947849,14,14,1,1
"912351813",39,2644.34121102376,3003.67291524485,2504.98447234734,15,24,1,1
"912351814",41,2986.28660899135,3228.73249141326,2530.72175773865,22,19,1,1
"912351815",38,2968.27779612219,3442.43317504749,2491.71993967651,14,24,1,1
"912351816",42,2978.68103351956,3256.58208243816,2543.21752514954,15,27,1,1
"912351817",47,3284.59432240234,3409.54395226708,2602.36394728806,23,24,1,1
"912351818",53,3230.01755361453,3492.60252782911,2667.061866114,26,27,1,1
"912351819",65,3300.32573620285,4304.21417563544,2780.67589681985,36,29,1,1
"912351820",48,2868.40050775576,3510.86822161566,2613.58673801098,24,24,1,1
"912351821",45,3086.30825481114,3359.16947539345,2579.33597919865,25,20,1,1
"912351822",51,3367.755874004,3508.72702806251,2646.17454577679,25,26,1,1
"912351823",37,2404.85891812503,2383.76383202288,2478.17471526668,24,13,1,1
"912351824",37,2410.17521977475,2851.10847621649,2478.17471526668,26,11,1,1
"912351825",51,2552.43115019264,2656.30952544742,2646.17454577679,35,16,1,1
"912351826",39,2612.07000460543,2866.98068678311,2504.98447234734,26,13,1,1
"912351827",40,2601.85222335931,2767.86137465026,2517.98110851286,24,16,1,1
"912351828",41,2739.52304273294,2585.8337184547,2530.72175773865,25,16,1,1
"912351829",44,2775.03406781464,2549.91686183412,2567.51523707907,28,16,1,1
"912351830",32,2484.50798418589,2550.94721975351,2405.71569249515,20,12,1,1
"912351831",54,2689.55100014973,2350.67000494078,2677.2712016452,28,26,1,1
"912351832",55,2566.73621957101,2345.82568067728,2687.33120998132,32,23,1,1
"912351833",30,2214.84399032386,2188.24072366179,2374.18906024059,18,12,1,1
"912351834",36,2314.78038936095,2202.55353471946,2464.33502634194,22,14,1,1
"912351835",43,2816.23732332352,2637.75553976295,2555.47878346624,24,19,1,1
"912351836",37,2491.12066443698,2361.12452809878,2478.17471526668,22,15,1,1
"912351837",45,2832.9443684933,3025.26572722283,2579.33597919865,29,16,1,1
"912351838",40,2539.40040306943,3000.17242061451,2517.98110851286,23,17,1,1
"912351839",38,2613.71554092397,2452.66548382287,2491.71993967651,22,16,1,1
"912351840",41,2613.15388718182,2540.48557779363,2530.72175773865,25,16,1,1
"912351841",49,2720.70028662058,2967.65765835269,2624.62502504328,32,17,1,1
"912351842",53,2700.22069943477,2765.98689830414,2667.061866114,31,22,1,1
"912351843",43,2608.17343028735,2931.91542602298,2555.47878346624,26,17,1,1
"912351844",47,2631.62746279267,2675.88115682538,2602.36394728806,29,18,1,1
"912351845",42,2545.249685827,2532.87127532377,2543.21752514954,20,22,1,1
"912351846",37,2584.55302175395,2689.83251046683,2478.17471526668,20,17,1,1
"912351847",33,2469.05682240889,2649.93955265939,2420.89448855093,20,13,1,1
"912351848",39,2590.37073513485,2792.18138757509,2504.98447234734,26,13,1,1
"912351849",39,2404.85116626669,2223.22817301649,2504.98447234734,23,16,1,1
"912351850",31,2477.43281647454,2382.5150897168,2390.15469389133,19,12,1,1
"912351851",41,2816.8458003827,2826.49711235495,2530.72175773865,29,12,1,1
"912351852",26,2482.12113538558,2400.10750148973,2305.75108410937,14,12,1,1
"912351853",31,2302.15271958772,2396.95621498335,2390.15469389133,17,14,1,1
"912351854",31,2437.7499644714,2456.13527910672,2390.15469389133,14,17,1,1
"912351855",37,2882.50496552896,2945.83185706926,2478.17471526668,17,20,1,1
"912351856",34,2785.05561045852,2892.23889045722,2435.71163614839,14,20,1,1
"912351857",35,2666.46560617448,2840.16523801552,2450.1860183293,15,20,1,1
"912351858",50,3121.78226363347,3437.40966471874,2635.48551585152,21,29,1,1
"912351859",28,2626.71099261463,2688.05448641087,2340.94327947849,14,14,1,1
"912351860",34,2564.94693542054,2820.43268314659,2435.71163614839,17,17,1,1
"912351861",40,3090.58464466658,3240.59504435635,2517.98110851286,23,17,1,1
"912351862",34,2974.70759242509,3304.2359619667,2435.71163614839,16,18,1,1
"912351863",48,2873.34951323197,3014.66629366268,2613.58673801098,25,23,1,1
"912351864",41,2798.70999525346,3064.62718407324,2530.72175773865,19,22,1,1
"912351865",38,2748.22078949707,2857.28170976038,2491.71993967651,19,19,1,1
"912351866",39,2636.94829550209,2719.09697113853,2504.98447234734,20,19,1,1
"912351867",47,2827.54543005442,2854.7082113554,2602.36394728806,28,19,1,1
"912351868",43,2871.56808377466,2811.17097853082,2555.47878346624,27,16,1,1
"912351869",50,2721.10742449388,2916.17621216771,2635.48551585152,30,20,1,1
"912351870",27,2350.55216378358,2495.28729476947,2323.60649590586,19,8,1,1
"912351871",33,2580.12690351436,2854.56379193129,2420.89448855093,17,16,1,1
"912351872",45,3117.72827447576,3154.05417177634,2579.33597919865,22,23,1,1
"912351873",42,3045.20238154158,3342.0795534265,2543.21752514954,21,21,1,1
"912351874",36,2854.95480083614,3184.01968363715,2464.33502634194,19,17,1,1
"912351875",46,3140.89511714497,3549.3942049644,2590.94954296761,23,23,1,1
"912351876",35,2823.6456885818,3225.0236633724,2450.1860183293,18,17,1,1
"912351877",74,3812.40681228203,3802.47108268791,2855.36548874306,29,45,1,1
"912351878",59,3084.997544971,3063.94884763525,2726.17127719361,24,35,1,1
"912351879",56,2914.1601000534,2771.2166050297,2697.24673169728,20,36,1,1
"912351880",48,3019.69949585542,3074.48625728636,2613.58673801098,20,28,1,1
"912351881",46,2914.58988244017,2736.8040642396,2590.94954296761,21,25,1,1
"912351882",53,3405.06334968704,3579.65305969724,2667.061866114,25,28,1,1
"912351883",43,3311.21614206441,2839.06616602965,2555.47878346624,16,27,1,1
"912351884",55,3339.67468503926,3540.53930216093,2687.33120998132,25,30,1,1
"912351885",61,3333.77575406427,2571.1125260609,2744.81051624266,26,35,1,1
"912351886",38,2694.92200009015,2924.64134665605,2491.71993967651,20,18,1,1
"912351887",62,3166.47231448576,3534.08941723572,2753.94837323248,31,31,1,1
"912351888",43,2987.83076757311,3021.04587798561,2555.47878346624,17,26,1,1
"912351889",44,2863.54835257567,3111.69377678482,2567.51523707907,16,28,1,1
"912351890",70,3626.87266504533,3847.57813492712,2823.11677003184,31,39,1,1
"912351891",62,3450.22200696745,3579.26650541364,2753.94837323248,28,34,1,1
"912351892",45,2773.59421317018,2990.60721559818,2579.33597919865,18,27,1,1
"912351893",53,3338.94421047433,3729.18252679821,2667.061866114,24,29,1,1
"912351894",56,3342.92360461865,3542.45905491552,2697.24673169728,31,25,1,1
"912351895",65,3228.46768755223,3436.57359935184,2780.67589681985,28,37,1,1
"912351896",45,3415.67531133176,4253.6968472401,2579.33597919865,20,25,1,1
"912351897",48,3285.81684680353,4462.77151706595,2613.58673801098,22,26,1,1
"912351898",51,3156.59392152475,3307.7536050436,2646.17454577679,14,37,1,1
"912351899",55,3396.80257583665,3810.19298043585,2687.33120998132,21,34,1,1
"912351900",57,3228.59485503827,3369.1897931383,2707.02236739438,20,37,1,1
"912351901",54,3205.85186235854,3033.61729552636,2677.2712016452,21,33,1,1
"912351902",40,2811.56987117076,2960.25372831443,2517.98110851286,20,20,1,1
"912351903",44,2952.48819178505,3232.94566860435,2567.51523707907,18,26,1,1
"912351904",39,2606.0886082178,2621.69266662755,2504.98447234734,19,20,1,1
"912351905",51,3108.1231644973,3239.74533610703,2646.17454577679,25,26,1,1
"912351906",37,2824.24298050376,3022.32187544938,2478.17471526668,16,21,1,1
"912351907",36,2695.38173943972,3028.79707107112,2464.33502634194,15,21,1,1
"912351908",44,3147.00905203991,3145.02744078548,2567.51523707907,23,21,1,1
"912351909",43,2980.42816655983,3197.85022483397,2555.47878346624,20,23,1,1
"912351910",46,2942.01428440605,2927.55260210249,2590.94954296761,19,27,1,1
"912351911",61,3626.2820468857,3883.82432804277,2744.81051624266,27,34,1,1
"912351912",56,3870.63614966597,3677.60113124318,2697.24673169728,24,32,1,1
"912351913",42,3097.20556736608,3304.12100369929,2543.21752514954,21,21,1,1
"912351914",54,3214.58779301198,4033.81848081318,2677.2712016452,23,31,1,1
"912351915",44,2937.72955550412,3434.63602857107,2567.51523707907,18,26,1,1
"912351916",34,2603.302915277,2592.44370361655,2435.71163614839,12,22,1,1
"912351917",52,3169.03818190818,3027.86137927085,2656.6981055205,20,32,1,1
"912351918",41,2876.87166194745,3405.75881515024,2530.72175773865,20,21,1,1
"912351919",42,2818.95559371311,3211.65142268236,2543.21752514954,21,21,1,1
"912351920",46,2868.10916731106,3185.62710537956,2590.94954296761,21,25,1,1
"912351921",49,3421.20800338114,3588.08225932726,2624.62502504328,20,29,1,1
"912351922",38,2903.78229505307,2997.83340914441,2491.71993967651,18,20,1,1
"912351923",49,3529.8195512422,3445.20245324605,2624.62502504328,22,27,1,1
"912351924",52,3270.62802064704,3215.86345793766,2656.6981055205,24,28,1,1
"912351925",53,3321.3029863644,3468.53014394328,2667.061866114,26,27,1,1
"912351926",42,2767.22609914129,3010.86768558108,2543.21752514954,18,24,1,1
"912351927",52,3292.31610070246,3824.40698215755,2656.6981055205,24,28,1,1
"912351928",29,2688.57118364817,3108.93753781637,2357.79423966008,11,18,1,1
"912351929",38,2995.90355368094,3504.95628936748,2491.71993967651,16,22,1,1
"912351930",51,3294.34066327529,3791.85348532383,2646.17454577679,24,27,1,1
"912351931",56,3344.49048102508,3876.22985389717,2697.24673169728,23,33,1,1
"912351932",66,3146.66262771384,2980.52571245676,2789.3669207067,24,42,1,1
"912351933",57,3045.08698512932,3204.0587736611,2707.02236739438,19,38,1,1
"912351934",53,3043.16747685268,3084.26033861742,2667.061866114,20,33,1,1
"912351935",46,2964.73081062308,2665.11635629292,2590.94954296761,16,30,1,1
"912351936",52,3156.3175660736,2653.07749932929,2656.6981055205,20,32,1,1
"912351937",59,3374.29642282128,3739.18230562406,2726.17127719361,24,35,1,1
"912351938",59,3301.28683704453,3371.31739089337,2726.17127719361,24,35,1,1
"912351939",49,2898.19889678093,3237.58725573796,2624.62502504328,16,33,1,1
"912351940",47,2954.8406774471,3041.28059051642,2602.36394728806,19,28,1,1
"912351941",38,2920.42946822346,4029.46120320713,2491.71993967651,16,22,1,1
"912351942",30,2416.61737352666,3392.31180506277,2374.18906024059,14,16,1,1
"912351943",53,3178.49845121527,3408.69123040959,2667.061866114,24,29,1,1
"912351944",42,2960.75680980724,3164.45746207887,2543.21752514954,17,25,1,1
"912351945",49,3158.71714914119,3421.59803809513,2624.62502504328,21,28,1,1
"912351946",41,2861.46913298535,2914.39270986117,2530.72175773865,18,23,1,1
"912351947",61,3351.30106852389,3170.58179798914,2744.81051624266,30,31,1,1
"912351948",39,3031.37643236704,2718.33629593268,2504.98447234734,18,21,1,1
"912351949",59,3074.12796318111,3012.42883507948,2726.17127719361,23,36,1,1
"912351950",54,3264.8731785915,4246.83329835843,2677.2712016452,22,32,1,1
"912351951",56,3110.59943926194,3018.35509154787,2697.24673169728,26,30,1,1
"912351952",45,2689.21484046759,2422.06698894618,2579.33597919865,16,29,1,1
"912351953",65,3663.61586477668,3813.56337886208,2780.67589681985,27,38,1,1
"912351954",61,3307.12068582529,3891.21967574577,2744.81051624266,27,34,1,1
"912351955",61,3413.40780495919,4122.38129624651,2744.81051624266,25,36,1,1
"912351956",52,3761.87765968913,4232.18854358179,2656.6981055205,21,31,1,1
"912351957",41,2739.82816221318,2884.48442551511,2530.72175773865,19,22,1,1
"912351958",42,2921.26485009246,3215.60301397786,2543.21752514954,17,25,1,1
"912351959",60,3263.59035065492,2942.79859068314,2735.5526890818,21,39,1,1
"912351960",37,2957.06378425732,3036.04909692531,2478.17471526668,16,21,1,1
"912351961",38,2555.10538115111,2597.4611102602,2491.71993967651,15,23,1,1
"912351962",41,2677.34845627495,2839.13737430838,2530.72175773865,20,21,1,1
"912351963",47,2824.88024827031,2722.57433734466,2602.36394728806,18,29,1,1
"912351964",35,2736.63755524603,2775.3428967188,2450.1860183293,17,18,1,1
"912351965",71,3486.59840945975,3536.50808707133,2831.31372136695,28,43,1,1
"912351966",59,3161.40064868733,3010.15947673892,2726.17127719361,23,36,1,1
"912351967",40,2829.7902982459,3758.79157208185,2517.98110851286,17,23,1,1
"912351968",27,2508.85756374349,3073.48242501022,2323.60649590586,12,15,1,1
"912351969",37,2835.4739169259,2835.27618282189,2478.17471526668,17,20,1,1
"912351970",34,2865.07795721368,2995.92244245703,2435.71163614839,16,18,1,1
"912351971",68,3098.15836139707,3014.03581310724,2806.43931339586,23,45,1,1
"912351972",59,3183.65092364199,3032.71208493235,2726.17127719361,19,40,1,1
"912351973",50,3217.71009055248,3880.19267132263,2635.48551585152,22,28,1,1
"912351974",44,3016.57578521624,3066.11948983357,2567.51523707907,21,23,1,1
"912351975",62,3336.62182959684,4056.02627724274,2753.94837323248,28,34,1,1
"912351976",50,3175.95286515929,4008.99921076462,2635.48551585152,23,27,1,1
"912351977",27,2265.78294826705,2064.34666775628,2323.60649590586,14,13,1,1
"912351978",21,2224.33925584285,1963.26343123255,2207.26116887512,12,9,1,1
"912351979",23,2097.49179412153,1977.59712718559,2248.68783741607,11,12,1,1
"912351980",28,2253.6401248702,1865.84685970655,2340.94327947849,14,14,1,1
"912351981",19,2235.22735565931,2286.7929578916,2162.56636020013,9,10,1,1
"912351982",18,2217.1917538374,2253.77041375935,2138.79896507223,10,8,1,1
"912351983",23,2380.47113577975,2375.9673335467,2248.68783741607,10,13,1,1
"912351984",30,2349.46104582368,2441.88959924037,2374.18906024059,15,15,1,1
"912351985",28,2246.76433995126,2155.6306171412,2340.94327947849,12,16,1,1
"912351986",30,2692.2403384134,2931.71966082297,2374.18906024059,13,17,1,1
"912351987",29,2736.74444375267,2885.30034321219,2357.79423966008,17,12,1,1
"912351988",76,3842.17115447411,3426.26881859276,2870.97236507783,34,42,1,1
"912351989",66,3506.78489833679,3485.46991319093,2789.3669207067,31,35,1,1
"912351990",23,2281.9578633675,2281.63583175147,2248.68783741607,12,11,1,1
"912351991",23,2275.10856304214,2101.64914060122,2248.68783741607,11,12,1,1
"912351992",23,2122.30503079809,1931.47717050755,2248.68783741607,11,12,1,1
"912351993",26,2244.42839621319,2109.16275712865,2305.75108410937,11,15,1,1
"912351994",55,3450.87275616724,3897.33908131732,2687.33120998132,26,29,1,1
"912351995",53,3065.75139121593,3424.77322266951,2667.061866114,22,31,1,1
"912351996",43,2790.26108347348,2646.14825800083,2555.47878346624,20,23,1,1
"912351997",51,2855.75654595729,3331.33211891609,2646.17454577679,23,28,1,1
"912351998",46,3134.59512620833,3128.3812118496,2590.94954296761,22,24,1,1
"912351999",49,3208.59678305941,3023.84835927685,2624.62502504328,22,27,1,1
"912352000",48,3321.80613685753,3738.63539353543,2613.58673801098,17,31,1,1
"912352001",47,3214.01206104835,3828.67063871482,2602.36394728806,21,26,1,1
"912352002",37,2972.19751581113,3199.82222801498,2478.17471526668,20,17,1,1
"912352003",40,2878.22252236201,3031.965936196,2517.98110851286,16,24,1,1
"912352004",57,2826.04152299507,2465.97845214109,2707.02236739438,29,28,1,1
"912352005",76,3168.93843922565,2570.30927658259,2870.97236507783,34,42,1,1
"912352006",69,3663.98036191954,4508.57358539428,2814.82611826518,24,45,1,1
"912352007",66,4108.34950429605,4165.78599360948,2789.3669207067,25,41,1,1
"912352008",54,3363.56338998803,3558.4669470391,2677.2712016452,19,35,1,1
"912352009",61,3200.73282956623,3699.39589938987,2744.81051624266,22,39,1,1
"912352010",59,3648.49451002549,3751.08962062734,2726.17127719361,19,40,1,1
"912352011",48,3447.11497840824,3351.55838940039,2613.58673801098,19,29,1,1
"912352012",64,2848.95739037456,2308.86715601568,2771.87783482774,30,34,1,1
"912352013",63,2606.88142646347,2397.02531948504,2762.96971264875,28,35,1,1
"912352014",66,2922.66475302283,2863.72053038231,2789.3669207067,23,43,1,1
"912352015",47,2860.53788449942,3284.58109884095,2602.36394728806,23,24,1,1
"912352016",33,2737.73714512839,2807.54869314016,2420.89448855093,16,17,1,1
"912352017",23,2334.47517226017,2343.62496504132,2248.68783741607,13,10,1,1
"912352018",60,3362.18816336489,3436.23993820728,2735.5526890818,28,32,1,1
"912352019",44,2784.4274006592,2963.83206900871,2567.51523707907,23,21,1,1
"912352020",57,3065.65921329726,2751.92784371369,2707.02236739438,25,32,1,1
"912352021",52,3736.11948688899,3184.87576789153,2656.6981055205,24,28,1,1
"912352022",57,3001.15887583651,2647.33456128446,2707.02236739438,28,29,1,1
"912352023",41,2768.24102327901,3322.2010130095,2530.72175773865,21,20,1,1
"912352024",72,2951.6995749603,2445.93053803616,2839.4193288992,34,38,1,1
"912352025",67,3516.87304561857,2951.02623468019,2797.95380131742,27,40,1,1
"912352026",68,3680.32025056371,4144.29014417772,2806.43931339586,27,41,1,1
"912352027",47,2927.6513718605,3543.61077606338,2602.36394728806,15,32,1,1
"912352028",48,3033.26973076209,3302.71919080517,2613.58673801098,24,24,1,1
"912352029",57,3515.59964853018,3823.03961255075,2707.02236739438,21,36,1,1
"912352030",55,2579.90838528912,2264.34628009197,2687.33120998132,27,28,1,1
"912352031",62,2721.77389674577,2076.91537817211,2753.94837323248,30,32,1,1
"912352032",62,2837.88548524858,2443.19262544633,2753.94837323248,31,31,1,1
"912352033",56,2500.29466302459,2138.82795142592,2697.24673169728,22,34,1,1
"912352034",60,2975.79205502789,2892.32719855178,2735.5526890818,27,33,1,1
"912352035",67,3052.80668913558,2747.20419026656,2797.95380131742,36,31,1,1
"912352036",55,3704.09615778105,3924.97540725414,2687.33120998132,25,30,1,1
"912352037",46,3162.96438283333,3124.2539381197,2590.94954296761,25,21,1,1
"912352038",32,2791.47081869346,2876.50670166448,2405.71569249515,10,22,1,1
"912352039",53,3560.30660158575,4031.87670693762,2667.061866114,25,28,1,1
"912352040",47,3064.7927774335,3085.75365116506,2602.36394728806,21,26,1,1
"912352041",55,3291.34205800621,3242.45740214943,2687.33120998132,25,30,1,1
"912352042",66,3471.83034691702,3181.95228624325,2789.3669207067,29,37,1,1
"912352043",84,3295.2281839631,3425.48489241179,2930.30814451558,40,44,1,1
"912352044",55,3365.62457359961,3184.75958210653,2687.33120998132,21,34,1,1
"912352045",49,3264.25870325077,3268.85122774878,2624.62502504328,23,26,1,1
"912352046",32,2474.81301051482,2420.19845572027,2405.71569249515,15,17,1,1
"912352047",39,2718.43891552676,2554.04833042868,2504.98447234734,21,18,1,1
"912352048",27,2337.68710516183,2601.61068131647,2323.60649590586,11,16,1,1
"912352049",36,2466.28781345667,2346.29401221045,2464.33502634194,16,20,1,1
"912352050",27,2437.41600268358,2526.30296736679,2323.60649590586,12,15,1,1
"912352051",36,2646.13237088838,2343.32315502835,2464.33502634194,11,25,1,1
"912352052",14,1850.36285471523,1663.09049892114,2031.70713799962,5,9,1,1
"912352053",30,2378.74777104067,2115.12820752678,2374.18906024059,13,17,1,1
"912352054",53,3038.93858035594,2745.58008817247,2667.061866114,21,32,1,1
"912352055",45,3226.65416658507,3058.10489155308,2579.33597919865,24,21,1,1
"912352056",59,3182.77241772089,3175.38956996402,2726.17127719361,27,32,1,1
"912352057",63,2890.0555234696,2701.84831171292,2762.96971264875,26,37,1,1
"912352058",37,2610.24931376911,2625.52644286206,2478.17471526668,18,19,1,1
"912352059",39,2629.80356617974,2451.21664067307,2504.98447234734,21,18,1,1
"912352060",46,3179.54167325479,3566.54299034651,2590.94954296761,23,23,1,1
"912352061",47,2873.50106162023,2788.50545152534,2602.36394728806,23,24,1,1
"912352062",2,1373.38353544474,1411.30410483304,1364.97646362037,1,1,1,1
"912352063",62,2870.35809422718,3172.7314382423,2753.94837323248,29,33,1,1
"912352064",46,2840.08317531274,2735.89755762322,2590.94954296761,19,27,1,1
"912352065",33,2411.65754754354,2510.56257997415,2420.89448855093,19,14,1,1
"912352066",45,2499.76570536201,2706.52218195949,2579.33597919865,24,21,1,1
"912352067",25,2191.56846568885,2190.52836248364,2287.34065519221,13,12,1,1
"912352068",22,2189.67562971348,2073.98157455006,2228.3491786518,12,10,1,1
"912352069",29,2263.48870951199,1946.41710485369,2357.79423966008,16,13,1,1
"912352070",39,2424.5052431409,2440.47023417001,2504.98447234734,22,17,1,1
"912352071",40,2478.86340221709,2502.73228236218,2517.98110851286,21,19,1,1
"912352072",30,2375.72194578934,2223.67797571883,2374.18906024059,16,14,1,1
"912352073",50,3256.59275693844,3118.84691224166,2635.48551585152,18,32,1,1
"912352074",40,2766.07622162998,2661.69245346956,2517.98110851286,17,23,1,1
"912352075",62,4167.30423393399,4203.31925089771,2753.94837323248,27,35,1,1
"912352076",32,2799.3853253238,3283.48195919985,2405.71569249515,16,16,1,1
"912352077",40,2902.98965746816,3146.21444150625,2517.98110851286,17,23,1,1
"912352078",35,2573.71429236187,2605.54527726494,2450.1860183293,17,18,1,1
"912352079",40,2695.42564795475,2589.37739400542,2517.98110851286,14,26,1,1
"912352080",33,2531.15567008049,2538.56937514529,2420.89448855093,15,18,1,1
"912352081",49,3182.0795875619,2862.1375019189,2624.62502504328,18,31,1,1
"912352082",39,3090.96527031237,2819.19242330471,2504.98447234734,17,22,1,1
"912352083",48,2904.22456972056,2896.12651224404,2613.58673801098,25,23,1,1
"912352084",52,2893.31287456737,2689.08217968478,2656.6981055205,30,22,1,1
"912352085",69,3256.49283343051,3547.91181388301,2814.82611826518,36,33,1,1
"912352086",19,2321.24533461259,2504.79722486234,2162.56636020013,11,8,1,1
"912352087",50,2949.03040219149,2625.48480942823,2635.48551585152,28,22,1,1
"912352088",41,2829.67759188083,3180.36536652534,2530.72175773865,22,19,1,1
"912352089",75,2959.50342477938,3075.03353612931,2863.21031780169,37,38,1,1
"912352090",65,3014.61232459363,2504.48302705824,2780.67589681985,30,35,1,1
"912352091",70,3180.34849064804,2754.9443838142,2823.11677003184,38,32,1,1
"912352092",49,3106.05110954774,3006.94467928786,2624.62502504328,25,24,1,1
"912352094",62,3032.77082015161,3377.87944451519,2753.94837323248,27,35,1,1
"912352095",49,3133.49450544858,3820.36134649287,2624.62502504328,25,24,1,1
"912352096",36,2921.84833383297,3272.33651743964,2464.33502634194,16,20,1,1
"912352097",62,3307.77507631905,3197.29213912305,2753.94837323248,28,34,1,1
"912352098",72,3513.9060692873,3429.061872207,2839.4193288992,32,40,1,1
"912352099",30,2329.59021253518,2617.87632349263,2374.18906024059,14,16,1,1
"912352100",79,3198.31250889047,2616.70192277017,2893.78092561085,37,42,1,1
"912352101",47,3095.15231629958,3138.94640020443,2602.36394728806,18,29,1,1
"912352103",29,2457.67259934699,2341.49411837002,2357.79423966008,15,14,1,1
"912352104",32,2625.31938187855,2549.9621087917,2405.71569249515,14,18,1,1
"912352105",51,3439.86727345451,3593.10606186322,2646.17454577679,19,32,1,1
"912352106",42,3114.04866955385,3556.09812748761,2543.21752514954,17,25,1,1
"912352107",59,3360.80057640782,3887.89562013753,2726.17127719361,24,35,1,1
"912352108",45,3014.89128786288,3022.7324388591,2579.33597919865,21,24,1,1
"912352109",38,2723.78878680802,3014.63377799574,2491.71993967651,16,22,1,1
"912352110",38,2476.69746507355,2468.71552827136,2491.71993967651,16,22,1,1
"912352111",49,3149.25000487021,3529.9451451903,2624.62502504328,20,29,1,1
"912352112",58,3058.59631947103,2732.73821340024,2716.66249357165,23,35,1,1
"912352113",64,3449.60255967851,3577.21503073327,2771.87783482774,28,36,1,1
"912352114",45,2693.49517178431,2889.10872231949,2579.33597919865,22,23,1,1
"912352115",49,2724.09865903042,2652.44140395196,2624.62502504328,19,30,1,1
"912352116",73,3515.02257497989,4721.40173231553,2847.4358582506,37,36,1,1
"912352117",38,2808.66747405061,3043.95796045268,2491.71993967651,18,20,1,1
"912352118",61,2549.86921150387,2701.82737729738,2744.81051624266,29,32,1,1
"912352119",39,2794.01018222204,3253.02392414547,2504.98447234734,20,19,1,1
"912352120",56,2741.63906300535,3207.43462466575,2697.24673169728,26,30,1,1
"912352121",71,3205.17156682362,3814.38061346867,2831.31372136695,32,39,1,1
"912352122",64,3003.94994547489,3421.12880819785,2771.87783482774,34,30,1,1
"912352123",54,2866.0627014964,3005.52418423967,2677.2712016452,30,24,1,1
"912352124",62,3151.01272370619,3710.29206716617,2753.94837323248,27,35,1,1
"912352125",61,3507.98886966092,4320.06590179059,2744.81051624266,27,34,1,1
"912352126",73,3316.22716600348,3716.92963118838,2847.4358582506,28,45,1,1
"912352127",54,3113.88778880109,4296.04012918933,2677.2712016452,24,30,1,1
"912352128",40,2712.35620385383,3245.51504800702,2517.98110851286,15,25,1,1
"912352129",63,3548.40265087376,3784.12494025246,2762.96971264875,25,38,1,1
"912352130",53,3128.75279586765,3515.54770056801,2667.061866114,24,29,1,1
"912352131",42,3112.73504627689,3411.79460138739,2543.21752514954,19,23,1,1
"912352132",75,3466.98198427525,3917.09673455795,2863.21031780169,31,44,1,1
"912352133",88,3900.71580527254,3841.19132735228,2958.30409156145,35,53,1,1
"912352134",41,3009.70781012944,3784.24337017094,2530.72175773865,20,21,1,1
"912352187",8,1822.25456260493,1883.5830955816,1812.11073017574,4,4,1,1
"912352188",9,1835.83364708935,1857.53640403204,1856.26587460569,5,4,1,1
"912352274",57,2809.960867021,3061.5143371365,2707.02236739438,29,28,1,1
"912352275",51,3044.95437886247,3821.87292529555,2646.17454577679,28,23,1,1
"912352280",49,3016.40436067953,3300.22469568175,2624.62502504328,26,23,1,1
"912352286",55,2985.50063354519,3310.9344997981,2687.33120998132,25,30,1,1
"912352287",55,3143.73234261484,3306.77220118632,2687.33120998132,26,29,1,1
"912352290",54,2908.95516054389,3005.5358767033,2677.2712016452,25,29,1,1
"912352291",52,2549.91333615635,2690.34879351489,2656.6981055205,28,24,1,1
"912352292",28,1976.08580071398,1394.73705691735,2340.94327947849,13,15,1,1
"912352294",40,2837.01436075395,2704.82294946898,2517.98110851286,15,25,1,1
"912352527",38,2600.4305649905,3027.70910183868,2491.71993967651,23,15,1,1
"912352528",33,2496.0947865523,2855.42660108254,2420.89448855093,19,14,1,1
"912352529",53,2664.37418883357,3051.0402138208,2667.061866114,29,24,1,1
"912352531",36,2471.89417824186,2428.04270742245,2464.33502634194,18,18,1,1
"912352532",28,2457.97784724697,2524.10598645932,2340.94327947849,13,15,1,1
"912352533",20,1998.10498003687,1831.42318520457,2185.35845629437,10,10,1,1
"912352534",26,2318.65440016423,2273.86937836608,2305.75108410937,12,14,1,1
"912352633",58,3554.2723622853,4709.43711152304,2716.66249357165,31,27,1,1
"912352634",34,2667.89322169256,3329.74091713244,2435.71163614839,15,19,1,1
"912352635",46,2929.97544156279,3861.64729513834,2590.94954296761,23,23,1,1
"912352636",36,2645.88848511665,3052.57379126157,2464.33502634194,19,17,1,1
"912352637",34,2874.18215244933,3655.5815417582,2435.71163614839,18,16,1,1
"912352638",22,2311.68716515978,2695.93832711357,2228.3491786518,11,11,1,1
"912352639",19,2234.25080295833,2528.92289551514,2162.56636020013,8,11,1,1
"912352640",29,2337.49137913835,2532.81905796705,2357.79423966008,14,15,1,1
"912352641",6,1723.74491446402,1806.63895080963,1708.62817714657,2,4,1,1
"912352642",35,2645.20576364551,3378.14852543311,2450.1860183293,15,20,1,1
"912352643",32,2682.49979795898,3096.49929824726,2405.71569249515,14,18,1,1
"912352644",41,2774.42847218366,3037.75784948071,2530.72175773865,18,23,1,1
"912352645",39,2542.35529965103,2690.82734082266,2504.98447234734,19,20,1,1
"912352646",23,2386.32001875884,2505.03488450609,2248.68783741607,9,14,1,1
"912352647",30,2476.03659712752,2739.13911835599,2374.18906024059,18,12,1,1
"912352648",54,3602.0879787111,4368.86508339326,2677.2712016452,30,24,1,1
"912352649",42,3215.27054488952,4779.22157354746,2543.21752514954,25,17,1,1
"912352650",24,2446.08691177886,2913.02260880616,2268.33468283819,14,10,1,1
"912352651",38,2897.46469025349,3856.30167743173,2491.71993967651,20,18,1,1
"912352652",24,2259.98182084882,2856.45477790905,2268.33468283819,12,12,1,1
"912352653",40,3049.57433505772,3399.78062371041,2517.98110851286,23,17,1,1
"912352654",47,2806.36940544455,3970.67378392212,2602.36394728806,25,22,1,1
"912352655",33,2790.81886462692,3453.17176792458,2420.89448855093,18,15,1,1
"912352656",23,2609.25797100981,3063.02203444621,2248.68783741607,11,12,1,1
"912352657",30,2644.72202693113,3705.01889644819,2374.18906024059,17,13,1,1
"912352658",50,3197.69134879858,3915.90531315626,2635.48551585152,26,24,1,1
"912352659",62,3405.03368560214,3912.47867451685,2753.94837323248,27,35,1,1
"912352660",27,2771.90849303191,3302.84005192635,2323.60649590586,15,12,1,1
"912352661",32,2745.05097539313,3145.8160046938,2405.71569249515,18,14,1,1
"912352662",27,2377.30993680216,2826.46387230313,2323.60649590586,10,17,1,1
"912352663",54,3013.42988998,4196.21671837413,2677.2712016452,26,28,1,1
"912352664",41,3248.80376013743,3991.74284338621,2530.72175773865,25,16,1,1
"912352665",38,2952.86074098488,3966.97834068948,2491.71993967651,20,18,1,1
"912352666",45,2677.09642163282,3754.36282649969,2579.33597919865,24,21,1,1
"912352667",23,2470.67756782688,3156.71172699006,2248.68783741607,11,12,1,1
"912352668",21,2503.4791327594,2793.29494974426,2207.26116887512,12,9,1,1
"912352669",21,2668.36588994074,2860.25775928336,2207.26116887512,14,7,1,1
"912352670",63,3473.47361297711,4319.51424205833,2762.96971264875,28,35,1,1
"912352671",55,2893.00898257191,4314.30348697557,2687.33120998132,22,33,1,1
"912352672",25,2522.1430684121,3233.82562741301,2287.34065519221,15,10,1,1
"912352673",37,2668.44034896989,2797.72027279561,2478.17471526668,22,15,1,1
"912352674",42,3033.63871729741,4053.87335555974,2543.21752514954,21,21,1,1
"912352675",21,2306.37342729867,2708.11887921597,2207.26116887512,12,9,1,1
"912352676",40,2611.65142222178,2971.09821889044,2517.98110851286,19,21,1,1
"912352677",37,2367.30879105017,2406.1619987077,2478.17471526668,21,16,1,1
"912352678",30,2594.40806999658,2658.3868627401,2374.18906024059,17,13,1,1
"912352679",33,2513.81072744303,2649.19777616214,2420.89448855093,16,17,1,1
"912352680",61,3579.7519453261,5046.43505250617,2744.81051624266,34,27,1,1
"912352681",51,3044.05781960059,3461.8171436623,2646.17454577679,29,22,1,1
"912352682",47,3133.84664934955,4116.2971521448,2602.36394728806,26,21,1,1
"912352683",31,2704.28688281284,3102.98875458744,2390.15469389133,17,14,1,1
"912352684",31,2167.13197374588,2328.18593164851,2390.15469389133,13,18,1,1
"912352685",44,3282.23920487582,3810.87071067896,2567.51523707907,27,17,1,1
"912352686",36,3015.44475597306,3313.6627364535,2464.33502634194,16,20,1,1
"912352687",37,2962.35312554846,3483.74807468267,2478.17471526668,22,15,1,1
"912352688",54,2853.85368279274,2979.74501018177,2677.2712016452,27,27,1,1
"912352689",52,3100.46857898538,3393.25571764461,2656.6981055205,27,25,1,1
"912352690",32,2731.16821536389,2799.38423290131,2405.71569249515,18,14,1,1
"912352691",34,2831.39478059787,3121.86557039513,2435.71163614839,20,14,1,1
"912352692",39,2824.73254989616,3608.9285630248,2504.98447234734,21,18,1,1
"912352693",32,2763.56499030383,3407.10086121053,2405.71569249515,15,17,1,1
"912352694",34,2771.91411980775,3995.92950573773,2435.71163614839,18,16,1,1
"912352695",45,3109.63242707219,3727.52251695926,2579.33597919865,24,21,1,1
"912352696",35,2770.37239675699,3748.59198956591,2450.1860183293,17,18,1,1
"912352697",38,2255.8592087607,2594.90045056564,2491.71993967651,17,21,1,1
"912352698",47,3268.64505886097,3937.63100848465,2602.36394728806,24,23,1,1
"912352699",32,2783.34247198764,3194.94064547275,2405.71569249515,12,20,1,1
"912352700",35,2489.29182603312,2860.79940640862,2450.1860183293,19,16,1,1
"912352701",39,2789.36793765387,3859.84773329003,2504.98447234734,24,15,1,1
"912352702",26,2793.39173439434,3665.7026608434,2305.75108410937,15,11,1,1
"912352703",36,2670.3410159891,3674.50363167977,2464.33502634194,19,17,1,1
"912352704",29,2720.24114514246,2673.45693860009,2357.79423966008,14,15,1,1
"912352705",36,2852.08753927439,3357.39387950526,2464.33502634194,18,18,1,1
"912352706",30,2758.7649716926,3260.93586835467,2374.18906024059,17,13,1,1
"912352707",33,2516.94399828804,3360.77468007007,2420.89448855093,20,13,1,1
"912352708",45,2730.88828113501,2975.73399013003,2579.33597919865,22,23,1,1
"912352709",23,2384.50286820381,2635.9662723412,2248.68783741607,11,12,1,1
"912352710",34,2631.44539195198,2841.64393146215,2435.71163614839,16,18,1,1
"912352711",41,2646.52278791167,2802.12747863779,2530.72175773865,24,17,1,1
"912352712",41,2680.81428001191,2932.1146676311,2530.72175773865,24,17,1,1
"912352713",35,2578.03203556992,2955.19285253986,2450.1860183293,17,18,1,1
"912353056",27,2553.07455706064,2538.17781763113,2323.60649590586,14,13,1,1
"912353057",28,2446.64062814974,2509.8561013507,2340.94327947849,16,12,1,1
"912353058",17,2132.40757992608,2020.18177119144,2113.95669457394,6,11,1,1
"912353059",13,2075.743023521,2122.08394728679,2001.16379457045,5,8,1,1
"912353060",10,1923.07017942333,1937.32548063662,1896.67490607898,7,3,1,1
"912353061",33,2694.45344565,2808.7753981907,2420.89448855093,14,19,1,1
"912353062",32,2647.20593958201,2903.85775984069,2405.71569249515,15,17,1,1
"912353063",19,2317.89651537074,2445.73854671648,2162.56636020013,10,9,1,1
"912353064",20,2281.11062006869,2542.4983130556,2185.35845629437,9,11,1,1
"912353065",19,2470.95278376184,2354.12890210879,2162.56636020013,11,8,1,1
"912353066",16,2188.70855120859,2239.83523211586,2087.92318348224,12,4,1,1
"912353067",28,2494.69570532648,2715.27893005413,2340.94327947849,16,12,1,1
"912353068",31,2614.5663266821,2870.72768632804,2390.15469389133,14,17,1,1
"912353295",36,2761.36020781052,3014.59368801599,2464.33502634194,17,19,1,1
"912353296",30,2380.18983446135,2668.68029784585,2374.18906024059,13,17,1,1
"912353297",32,2608.87383371654,2529.7377581879,2405.71569249515,20,12,1,1
"912353298",30,2621.50881447898,2602.31451923704,2374.18906024059,17,13,1,1
"912353299",33,2809.63481246606,2914.07181563254,2420.89448855093,17,16,1,1
"912353301",27,2541.67708720855,2506.49385106904,2323.60649590586,8,19,1,1
"912353302",22,2267.2038896785,2302.91666905391,2228.3491786518,9,13,1,1
"912353465",41,2565.56024570898,2519.95176756611,2530.72175773865,24,17,1,1
"912353466",36,2541.08072031886,2465.95889548149,2464.33502634194,21,15,1,1
"912353467",37,2604.23242135974,3000.14016237547,2478.17471526668,25,12,1,1
"912353468",44,2471.52834300515,2786.57008189188,2567.51523707907,24,20,1,1
"912353469",35,2310.07975919761,2337.48088499401,2450.1860183293,20,15,1,1
"912353470",39,2467.44994877078,2320.94161904648,2504.98447234734,23,16,1,1
"912353471",19,2092.65931567686,1999.83668903151,2162.56636020013,10,9,1,1
"912353472",18,2079.45503940829,1928.5470147543,2138.79896507223,11,7,1,1
"912353473",31,2475.11095089367,2185.54819720296,2390.15469389133,19,12,1,1
"912353474",35,2478.31368444344,2480.53232840861,2450.1860183293,15,20,1,1
"912353475",21,2187.19924752085,1927.75958363251,2207.26116887512,14,7,1,1
"912353476",29,2400.68916286641,2274.51179539493,2357.79423966008,21,8,1,1
"912353477",24,2164.0829610886,2166.60342652394,2268.33468283819,13,11,1,1
"912353478",25,2427.92748465252,2449.61410962805,2287.34065519221,14,11,1,1
"912353479",30,2153.50042588292,2478.702194465,2374.18906024059,18,12,1,1
"912353480",23,2359.96215303361,2593.21884935836,2248.68783741607,13,10,1,1
"912353534",40,2989.15309813264,3367.59050309018,2517.98110851286,21,19,1,1
"912353535",44,2940.61861409245,3378.84411610166,2567.51523707907,24,20,1,1
"912353536",40,2634.05310359805,2815.77198731621,2517.98110851286,23,17,1,1
"912353537",33,2667.20774774937,2728.13846957469,2420.89448855093,18,15,1,1
"912353538",25,2523.37570247791,2586.28654000305,2287.34065519221,15,10,1,1
"912353539",30,2544.66852387473,2813.88376837928,2374.18906024059,19,11,1,1
"912353540",30,2710.75212635061,2740.8914787226,2374.18906024059,15,15,1,1
"912353541",27,2553.53647036171,2573.26983445736,2323.60649590586,14,13,1,1
"912353542",45,2772.7339645766,2648.04838684026,2579.33597919865,23,22,1,1
"912353543",29,2687.71027084339,2539.44887910217,2357.79423966008,17,12,1,1
"912353544",20,2635.37016583944,2741.3318348654,2185.35845629437,10,10,1,1
"912353545",20,2460.04300594703,2525.3543074164,2185.35845629437,9,11,1,1
"912353546",38,2588.00196646122,2715.94257184543,2491.71993967651,21,17,1,1
"912353547",39,2803.5035291296,2940.87617927151,2504.98447234734,24,15,1,1
"912353548",31,2690.36277770947,2934.07760175915,2390.15469389133,14,17,1,1
"912353549",23,2490.12348619503,2653.76497924115,2248.68783741607,7,16,1,1
"912353550",43,3270.84609911925,3156.8289619856,2555.47878346624,18,25,1,1
"912353551",37,2791.77387641514,2611.89816239941,2478.17471526668,18,19,1,1
"912353552",31,2591.15324979262,2579.90215276361,2390.15469389133,15,16,1,1
"912353553",29,2670.35666347944,2847.89386706903,2357.79423966008,17,12,1,1
"912353554",46,3056.08573371288,3027.26161723898,2590.94954296761,21,25,1,1
"912353555",34,2809.99580917513,2817.69142183762,2435.71163614839,19,15,1,1
"912353556",32,3061.16864904656,3288.70018500582,2405.71569249515,18,14,1,1
"912353557",31,2791.94520175409,2998.7091521017,2390.15469389133,16,15,1,1
"912353558",39,2818.48376152127,3117.06551952787,2504.98447234734,23,16,1,1
"912353559",31,2595.97227056731,2763.46837262041,2390.15469389133,16,15,1,1
"912353560",30,2531.01651159949,2390.06760857069,2374.18906024059,14,16,1,1
"912353561",38,2706.46608231034,2654.08344936668,2491.71993967651,19,19,1,1
"912353562",37,2844.31202120462,3186.44896900569,2478.17471526668,17,20,1,1
"912353563",39,2809.5301377502,3178.30282811938,2504.98447234734,17,22,1,1
"912353564",41,2760.2209162486,2830.25940354525,2530.72175773865,23,18,1,1
"912353565",39,2769.90148933493,2786.54773404717,2504.98447234734,17,22,1,1
"912353566",42,3090.70987002488,3497.04940023153,2543.21752514954,19,23,1,1
"912353567",37,2981.82382138912,3429.86240543991,2478.17471526668,17,20,1,1
"912353568",51,2929.25225770048,2392.54531276989,2646.17454577679,26,25,1,1
"912353569",45,2825.81735681087,2548.87183162664,2579.33597919865,25,20,1,1
"912353570",35,2822.20330298936,2847.53029929591,2450.1860183293,18,17,1,1
"912353571",32,2557.23679118814,2516.82944860514,2405.71569249515,17,15,1,1
"912353572",33,2735.42417565775,2655.09249624523,2420.89448855093,19,14,1,1
"912353573",40,2530.74739859798,2410.6264893627,2517.98110851286,20,20,1,1
"912353574",33,2447.86223722357,2369.52483247383,2420.89448855093,16,17,1,1
"912353575",39,2701.5710173404,2808.67803506845,2504.98447234734,17,22,1,1
"912353576",49,2871.91804497553,2736.29783469696,2624.62502504328,23,26,1,1
"912353577",28,2532.34077668312,2621.41355522917,2340.94327947849,9,19,1,1
"912353578",31,2673.43395625199,2760.62395590443,2390.15469389133,13,18,1,1
"912353579",36,3086.31290963786,3241.90244251428,2464.33502634194,16,20,1,1
"912353580",40,3414.14630972302,3611.97691076099,2517.98110851286,22,18,1,1
"912353581",45,2950.76710405869,3469.21400206986,2579.33597919865,19,26,1,1
"912353582",41,3034.40655467636,3555.70211579591,2530.72175773865,19,22,1,1
"912353583",43,2716.47807912757,2368.04089013229,2555.47878346624,24,19,1,1
"912353584",51,3141.93855365476,3818.48085981897,2646.17454577679,30,21,1,1
"912353585",34,2652.30262966471,2572.07302779387,2435.71163614839,19,15,1,1
"912353586",29,2734.85070297361,2558.45346479107,2357.79423966008,17,12,1,1
"912353587",30,2374.56229956336,2501.18650440346,2374.18906024059,19,11,1,1
"912353588",37,2572.87081375078,2638.96909679785,2478.17471526668,24,13,1,1
"912353589",38,2805.63610308389,2641.39073463442,2491.71993967651,21,17,1,1
"912353590",38,2604.00110945502,2417.54350923923,2491.71993967651,20,18,1,1
"912353591",37,2582.29875802282,2650.03913512359,2478.17471526668,25,12,1,1
"912353592",34,2713.32013012783,2254.91761051285,2435.71163614839,19,15,1,1
"912353593",41,3100.90902304804,2763.58326387235,2530.72175773865,22,19,1,1
"912353594",45,3023.87035193888,3009.22936086633,2579.33597919865,19,26,1,1
"912353595",28,2574.75858915008,2692.91079702887,2340.94327947849,18,10,1,1
"912353596",45,2909.23823334139,2588.02622845654,2579.33597919865,27,18,1,1
"912353597",44,2936.90449748399,2708.97774409319,2567.51523707907,27,17,1,1
"912353598",33,2586.67011921615,2728.58120955967,2420.89448855093,19,14,1,1
"912353599",39,2911.77700599882,2884.77829448428,2504.98447234734,22,17,1,1
"912353600",50,3166.73397299179,2831.62372761337,2635.48551585152,30,20,1,1
"912353601",58,3144.0714302253,2973.59366902533,2716.66249357165,35,23,1,1
"912353602",52,3063.69885065989,2634.30863524341,2656.6981055205,30,22,1,1
"912353603",59,3209.61432736383,2492.8966639705,2726.17127719361,25,34,1,1
"912353604",56,3279.38892093296,3231.38582672049,2697.24673169728,31,25,1,1
"912353605",48,3388.19300487396,3428.83993821052,2613.58673801098,24,24,1,1
"912353606",49,2887.67566331454,3604.08982755436,2624.62502504328,26,23,1,1
"912353608",47,2873.03059198233,2550.90647843235,2602.36394728806,26,21,1,1
"912353609",44,2554.84236494894,2144.33455784246,2567.51523707907,23,21,1,1
"912353610",31,2422.31940071543,2396.24879657452,2390.15469389133,17,14,1,1
"912353611",22,2324.68488126388,2351.60521993518,2228.3491786518,11,11,1,1
"912353612",21,2188.54407014332,2216.46969803255,2207.26116887512,12,9,1,1
"912353613",25,2326.09832346594,2168.92754138197,2287.34065519221,14,11,1,1
"912353614",36,2712.13087811282,2871.15139489707,2464.33502634194,18,18,1,1
"912353615",19,2047.6170909551,1952.82490438608,2162.56636020013,11,8,1,1
"912353616",22,2083.14614813101,1921.99524280229,2228.3491786518,12,10,1,1
"912353617",10,1875.40643662926,1759.18211331319,1896.67490607898,6,4,1,1
"912353618",8,1724.85474711551,1751.4128971589,1812.11073017574,3,5,1,1
"912353619",29,2318.99246881442,2458.74137900311,2357.79423966008,14,15,1,1
"912353620",32,2451.19147964047,2610.06459752501,2405.71569249515,20,12,1,1
"912353621",21,2315.03871582373,2191.29793109167,2207.26116887512,9,12,1,1
"912353622",8,1739.28601222453,1758.32230958141,1812.11073017574,5,3,1,1
"912353623",25,2249.57637752386,2179.94645925469,2287.34065519221,15,10,1,1
"912353624",11,1933.24058900624,1889.91665303181,1933.98659929558,6,5,1,1
"912354050",33,2688.48282617502,3043.6292516514,2420.89448855093,17,16,1,1
"912354051",33,2722.65854292734,2755.13702880981,2420.89448855093,18,15,1,1
"912354052",27,2494.35476667186,2778.91295816461,2323.60649590586,13,14,1,1
"912354053",31,2670.33281987493,3037.17193474373,2390.15469389133,16,15,1,1
"912354054",29,2475.25991338044,2805.83478393436,2357.79423966008,15,14,1,1
"912354055",36,2580.30543367086,2809.31270398411,2464.33502634194,16,20,1,1
"912354056",33,2644.7524121647,2841.53837357524,2420.89448855093,17,16,1,1
"912354057",37,2452.47925425749,2495.03103659165,2478.17471526668,17,20,1,1
"912354058",27,2454.97616156464,2807.52181199901,2323.60649590586,14,13,1,1
"912354059",32,2598.29819774308,2862.67007538479,2405.71569249515,16,16,1,1
"912354060",24,2266.66510645054,2371.82468981783,2268.33468283819,13,11,1,1
"912354061",42,2923.67171855611,3116.27440051408,2543.21752514954,21,21,1,1
"912354062",33,2657.88148071336,2819.31106559053,2420.89448855093,17,16,1,1
"912354063",29,2558.03772480928,2536.40726463467,2357.79423966008,15,14,1,1
"912354064",13,2061.08812729848,1837.97568660404,2001.16379457045,2,11,1,1
"912354065",36,3056.0375130176,3560.85198626786,2464.33502634194,20,16,1,1
"912354066",39,2843.66710991068,3205.48409336854,2504.98447234734,19,20,1,1
"912354067",38,2506.91578371022,2921.70643329412,2491.71993967651,22,16,1,1
"912354068",36,2803.65749965861,3162.48918191131,2464.33502634194,21,15,1,1
"912354069",17,2193.99309059069,2168.23149296594,2113.95669457394,7,10,1,1
"912354070",31,2232.89855851329,2116.10859689751,2390.15469389133,14,17,1,1
"912354071",8,1664.56662876395,1644.85545791649,1812.11073017574,0,8,1,1
"912354072",18,2085.99150085713,1976.11493653059,2138.79896507223,8,10,1,1
"912354073",32,2397.01838118516,2059.09818573699,2405.71569249515,16,16,1,1
"912354074",36,2535.77099473795,2280.81194026211,2464.33502634194,17,19,1,1
"912354075",25,2253.40961423327,1951.33877029657,2287.34065519221,11,14,1,1
"912354076",39,2611.4358180531,2300.88329579248,2504.98447234734,17,22,1,1
"912354077",23,2204.78443456677,2227.62401664126,2248.68783741607,10,13,1,1
"912354078",18,2260.50230599714,2212.61491349297,2138.79896507223,8,10,1,1
"912354079",16,2033.97140666464,1712.21612270325,2087.92318348224,7,9,1,1
"912354080",23,2115.27437778065,1921.19142748567,2248.68783741607,12,11,1,1
"912354081",12,2024.88230129549,2173.41835537573,1968.69006049611,6,6,1,1
"912354082",10,1926.58176802248,1909.28553412144,1896.67490607898,7,3,1,1
"912354083",13,1903.39238444116,1625.41942423321,2001.16379457045,7,6,1,1
"912354084",15,1913.5486559648,1456.06679047366,2060.56118614118,6,9,1,1
"912354085",22,2121.12719725206,2356.83867877805,2228.3491786518,13,9,1,1
"912354086",21,2319.39611050821,2207.70584003838,2207.26116887512,11,10,1,1
"912354087",16,2125.31250876802,2129.26869845855,2087.92318348224,6,10,1,1
"912354088",18,2193.52582800128,2250.17852616688,2138.79896507223,8,10,1,1
"912354089",11,1994.80138618394,2005.6057659497,1933.98659929558,5,6,1,1
"912354090",7,1739.84948946234,1685.74297647926,1763.32076508842,4,3,1,1
"912354091",25,2307.18162863691,1888.08948331312,2287.34065519221,16,9,1,1
"912354092",23,2183.71360427228,1706.47308919426,2248.68783741607,12,11,1,1
"912354093",13,2039.60333123529,2326.9121710254,2001.16379457045,6,7,1,1
"912354094",14,2033.72715850479,2156.90041899205,2031.70713799962,5,9,1,1
"912354095",11,1982.7696452794,2000.12744983397,1933.98659929558,5,6,1,1
"912354096",12,1991.11520691029,2029.53336298782,1968.69006049611,4,8,1,1
"912354097",27,2224.37693752632,1693.67829550524,2323.60649590586,14,13,1,1
"912354098",16,2009.00950906226,1731.17731520636,2087.92318348224,9,7,1,1
"912354099",22,2062.41893804078,2072.40616491409,2228.3491786518,11,11,1,1
"912354100",19,2121.90168595463,1883.02795136833,2162.56636020013,7,12,1,1
"912354101",11,1916.19357233582,1906.20350919185,1933.98659929558,7,4,1,1
"912354102",13,2022.71960811766,1952.83134700044,2001.16379457045,8,5,1,1
"912354103",22,1958.00152665469,1595.8091963357,2228.3491786518,10,12,1,1
"912354104",23,1967.06686387315,1595.25385313701,2248.68783741607,13,10,1,1
"912354105",20,1828.67681144977,1150.24939229631,2185.35845629437,11,9,1,1
"912354106",9,1795.58935444758,1872.68458351441,1856.26587460569,4,5,1,1
"912354107",9,1880.29420368202,1842.88537938583,1856.26587460569,6,3,1,1
"912354108",14,2025.20632485855,1899.24460623928,2031.70713799962,6,8,1,1
"912354109",24,2150.4394820915,2179.07560215438,2268.33468283819,10,14,1,1
"912354110",26,2180.33854227911,1833.68744480326,2305.75108410937,12,14,1,1
"912354111",30,2457.01201650915,2098.52246314368,2374.18906024059,18,12,1,1
"912354112",20,2168.5285870177,2276.31528004693,2185.35845629437,9,11,1,1
"912354113",18,2122.2828392008,2096.53221154999,2138.79896507223,8,10,1,1
"912354114",16,2149.99040166,2025.89130857601,2087.92318348224,8,8,1,1
"912354115",28,2372.02204501485,2437.05234180236,2340.94327947849,18,10,1,1
"912354116",23,2343.53298820632,2468.35261756312,2248.68783741607,12,11,1,1
"912354117",21,2297.05366209873,1961.21194701524,2207.26116887512,10,11,1,1
"912354118",32,2647.43835979803,2279.73366860864,2405.71569249515,18,14,1,1
"912354119",20,2242.14939557781,2248.14415413523,2185.35845629437,7,13,1,1
"912354120",14,2043.48137663942,2146.90249799921,2031.70713799962,9,5,1,1
"912354121",18,2254.30091795588,2207.31829020078,2138.79896507223,9,9,1,1
"912354122",19,2157.07958928581,1984.75085898362,2162.56636020013,12,7,1,1
"912354123",22,2220.39387579393,2118.01598564032,2228.3491786518,10,12,1,1
"912354124",12,1967.58414915633,1879.8793937109,1968.69006049611,7,5,1,1
"912354125",11,1944.241603476,1826.33224702549,1933.98659929558,6,5,1,1
"912354126",10,2021.68530953731,2182.14044510712,1896.67490607898,6,4,1,1
"912354127",19,1974.09995802401,1565.2440711509,2162.56636020013,9,10,1,1
"912354128",15,1899.59168480869,1760.0458599257,2060.56118614118,5,10,1,1
"912354129",23,2067.80755077078,1561.9770842285,2248.68783741607,11,12,1,1
"912354130",12,1934.78920274911,1928.15399473228,1968.69006049611,4,8,1,1
"912354131",31,2740.05449997467,2683.92428535331,2390.15469389133,15,16,1,1
"912354132",31,2592.93777509637,2723.48382046819,2390.15469389133,14,17,1,1
"912354133",22,2121.34379755715,2100.40092751432,2228.3491786518,6,16,1,1
"912354134",32,2604.62990771796,2384.7436169733,2405.71569249515,13,19,1,1
"912354135",38,2319.24473073967,2088.49974472611,2491.71993967651,17,21,1,1
"912354136",34,2430.65292267002,2104.09291627067,2435.71163614839,14,20,1,1
"912354137",35,2406.51547187338,1873.61443350316,2450.1860183293,11,24,1,1
"912354138",25,2326.74441458811,2390.86348114856,2287.34065519221,11,14,1,1
"912354139",29,2337.50002790321,2464.63070335502,2357.79423966008,10,19,1,1
"912354140",25,2456.55737742385,2410.83377478524,2287.34065519221,11,14,1,1
"912354141",25,2366.24944478443,2430.2689481692,2287.34065519221,10,15,1,1
"912354142",13,1920.92819808999,1851.06428348471,2001.16379457045,1,12,1,1
"912354143",29,2311.21639630513,2108.34556702009,2357.79423966008,11,18,1,1
"912354151",14,2134.88928150128,2239.69962337935,2031.70713799962,8,6,1,1
"912354152",20,2383.36322105905,2824.90329342527,2185.35845629437,11,9,1,1
"912354153",16,2164.84063135871,2147.57407672007,2087.92318348224,10,6,1,1
"912354154",17,2184.01838564613,2439.35989883413,2113.95669457394,9,8,1,1
"912354155",25,2346.0977680784,2757.46820294491,2287.34065519221,14,11,1,1
"912354156",21,2101.20083559746,2246.16931017977,2207.26116887512,11,10,1,1
"912354157",20,2222.01849851746,2363.12022534261,2185.35845629437,11,9,1,1
"912354178",46,3034.23457635834,2984.97381251287,2590.94954296761,26,20,1,1
"912354179",36,2895.39299396751,2967.56580580861,2464.33502634194,18,18,1,1
"912354180",32,2605.39203745927,2418.64758217752,2405.71569249515,17,15,1,1
"912354181",19,2219.49832069097,2172.62033398177,2162.56636020013,9,10,1,1
"912354182",47,3256.35070517394,3018.05666275579,2602.36394728806,28,19,1,1
"912354183",54,3097.39037899322,3052.79887769246,2677.2712016452,31,23,1,1
"912354184",50,3410.97407953817,3219.96914700181,2635.48551585152,25,25,1,1
"912354186",57,3240.07850547007,3596.25629447378,2707.02236739438,30,27,1,1
"912354187",62,3526.70073330784,3304.00317553329,2753.94837323248,31,31,1,1
"912354188",45,3149.21669333502,3144.62886963064,2579.33597919865,24,21,1,1
"912354189",46,2862.51017982011,2635.49530171793,2590.94954296761,22,24,1,1
"912354190",58,3466.06052664842,4264.2163973991,2716.66249357165,37,21,1,1
"912354191",55,3029.00231771976,3100.59245450027,2687.33120998132,30,25,1,1
"912354192",19,2173.74597374901,2139.72614893356,2162.56636020013,7,12,1,1
"912354193",19,2233.50662319034,2144.41559046975,2162.56636020013,10,9,1,1
"912354194",45,2763.60596291687,3083.87813967427,2579.33597919865,17,28,1,1
"912354195",36,2692.19171969634,2868.70857112977,2464.33502634194,19,17,1,1
"912354196",36,2850.98004138667,3042.79530445913,2464.33502634194,17,19,1,1
"912354197",44,3174.87724748783,3413.87146427978,2567.51523707907,21,23,1,1
"912354198",37,2746.25596497234,2876.84775249905,2478.17471526668,21,16,1,1
"912354199",40,2614.66507806267,3071.29901105679,2517.98110851286,24,16,1,1
"912354200",50,2858.31546561006,2660.8477807164,2635.48551585152,23,27,1,1
"912354201",51,2823.88098052603,2396.76601376959,2646.17454577679,21,30,1,1
"912354202",63,3205.88151324521,2913.22992156606,2762.96971264875,33,30,1,1
"912354203",50,3069.70696829191,3237.09890011803,2635.48551585152,29,21,1,1
"912354204",42,2804.59517316554,2558.64494994046,2543.21752514954,22,20,1,1
"912354205",45,2563.0402506137,2073.05808367041,2579.33597919865,24,21,1,1
"912354206",73,3077.16756930517,3100.90779960985,2847.4358582506,32,41,1,1
"912354207",78,3400.3054051124,3324.03930761538,2886.25582696583,39,39,1,1
"912354208",49,2912.87332339129,2606.16673596338,2624.62502504328,27,22,1,1
"912354209",36,2651.98823415604,3031.24370183107,2464.33502634194,19,17,1,1
"912354210",60,3331.63556403403,3853.54066790811,2735.5526890818,33,27,1,1
"912354211",53,3103.68089723996,3242.97692696844,2667.061866114,28,25,1,1
"912354212",54,3182.65473178264,3273.82814397707,2677.2712016452,22,32,1,1
"912354213",58,2895.49925008006,3072.38673881156,2716.66249357165,31,27,1,1
"912354214",63,3108.39758915614,3651.07607303392,2762.96971264875,34,29,1,1
"912354215",56,3163.3452873918,3505.41167933075,2697.24673169728,31,25,1,1
"912354216",53,3368.09505585658,3335.84678772065,2667.061866114,25,28,1,1
"912354217",57,3330.39528913566,2801.61799375681,2707.02236739438,29,28,1,1
"912354218",74,3800.41361958285,4009.43888221799,2855.36548874306,42,32,1,1
"912354219",65,3685.64491120961,3665.20288021145,2780.67589681985,32,33,1,1
"912354220",60,3102.23511492374,3134.23325412098,2735.5526890818,34,26,1,1
"912354221",70,3440.60551565202,3437.87698767994,2823.11677003184,40,30,1,1
"912354222",76,3428.79657957012,3696.43480842563,2870.97236507783,45,31,1,1
"912354223",52,3430.41597036456,3741.01604852583,2656.6981055205,31,21,1,1
"912354224",39,3159.63789123374,3553.81668155504,2504.98447234734,20,19,1,1
"912354225",49,3082.88510973078,3520.00803524265,2624.62502504328,25,24,1,1
"912354226",51,3209.58069409437,3403.92515536439,2646.17454577679,29,22,1,1
"912354227",57,3522.03372048932,3783.16974812665,2707.02236739438,31,26,1,1
"912354228",75,2794.44110315436,2326.37822960119,2863.21031780169,38,37,1,1
"912354229",79,3498.35724511111,3201.92344912931,2893.78092561085,39,40,1,1
"912354230",40,3111.91618158904,3049.62845722827,2517.98110851286,18,22,1,1
"912354231",58,3109.13936322476,2792.21727475263,2716.66249357165,23,35,1,1
"912354232",66,3297.5213984182,3183.40545757459,2789.3669207067,33,33,1,1
"912354233",49,2979.7016081488,3352.95031746369,2624.62502504328,25,24,1,1
"912354234",71,3843.21592417165,4389.72280737975,2831.31372136695,36,35,1,1
"912354236",51,3050.26905248287,3229.10661342318,2646.17454577679,26,25,1,1
"912354237",49,3297.80489532061,3133.51308012862,2624.62502504328,28,21,1,1
"912354238",54,3175.54751478474,3229.17073344831,2677.2712016452,24,30,1,1
"912354239",60,2839.91431263005,2710.53005256462,2735.5526890818,26,34,1,1
"912354240",53,2798.16789928416,2646.66377451652,2667.061866114,29,24,1,1
"912354241",61,2930.46008531894,2444.90727376397,2744.81051624266,32,29,1,1
"912354242",68,3109.29322196651,3125.27287774678,2806.43931339586,35,33,1,1
"912354243",69,2967.39631359184,2461.2539613819,2814.82611826518,36,33,1,1
"912354244",72,3636.79965467004,3428.68192238422,2839.4193288992,39,33,1,1
"912354245",54,2914.57274092984,2385.98515548359,2677.2712016452,34,20,1,1
"912354246",32,2325.54332603775,2206.02699135152,2405.71569249515,20,12,1,1
"912354247",24,2289.75465986409,2370.61233504068,2268.33468283819,17,7,1,1
"912354248",26,2469.10106684754,2549.01787121412,2305.75108410937,14,12,1,1
"912354249",26,2366.64856842853,2394.67883776325,2305.75108410937,16,10,1,1
"912354250",46,2789.05473600504,2849.42986911441,2590.94954296761,24,22,1,1
"912354251",45,2646.86454629066,2696.27393262916,2579.33597919865,23,22,1,1
"912354252",29,2266.14799064784,2179.83280341964,2357.79423966008,18,11,1,1
"912354253",31,2375.14979312509,2257.56721952347,2390.15469389133,17,14,1,1
"912354254",21,2099.86221769591,2184.61317678892,2207.26116887512,12,9,1,1
"912354255",19,2169.98860669492,2120.58102351456,2162.56636020013,11,8,1,1
"912354256",22,2289.59886273771,2428.65627454036,2228.3491786518,14,8,1,1
"912354257",29,2421.04896105541,2520.97157375845,2357.79423966008,18,11,1,1
"912354258",52,3100.80012442125,2894.31063349966,2656.6981055205,24,28,1,1
"912354259",50,3365.87519181519,3431.09082750246,2635.48551585152,26,24,1,1
"912354260",51,3262.77976620414,3216.6798745632,2646.17454577679,22,29,1,1
"912354261",55,3251.14007846355,2944.58763120373,2687.33120998132,24,31,1,1
"912354263",56,3403.83726384384,3181.30085507407,2697.24673169728,29,27,1,1
"912354264",42,2573.80729536057,2232.82149685746,2543.21752514954,27,15,1,1
"912354265",39,2706.08256454801,2531.97285372358,2504.98447234734,23,16,1,1
"912354266",37,2710.72531332749,2530.48965827766,2478.17471526668,21,16,1,1
"912354267",45,2733.26775274648,2582.25773446648,2579.33597919865,23,22,1,1
"912354268",20,1970.34800676762,1932.83435247639,2185.35845629437,7,13,1,1
"912354269",13,2064.32238540808,1936.74654637128,2001.16379457045,5,8,1,1
"912354270",19,2156.23430239505,2083.61729114025,2162.56636020013,9,10,1,1
"912354271",26,2346.71269186955,2127.87523970699,2305.75108410937,12,14,1,1
"912354272",18,2235.65222930449,2055.15350793874,2138.79896507223,8,10,1,1
"912354273",21,2296.6461870351,2268.2085742699,2207.26116887512,11,10,1,1
"912354274",30,2546.02996827047,2845.84131098529,2374.18906024059,19,11,1,1
"912354275",59,3092.45640346079,2823.328622337,2726.17127719361,30,29,1,1
"912354276",38,2709.82483838908,2388.48418549964,2491.71993967651,20,18,1,1
"912354277",60,2573.36833474917,2494.1959793106,2735.5526890818,29,31,1,1
"912354278",41,2843.67774176713,2773.71679248603,2530.72175773865,22,19,1,1
"912354279",57,3132.21155791838,3302.1709788238,2707.02236739438,34,23,1,1
"912354280",60,2952.33758158869,2799.91811940272,2735.5526890818,33,27,1,1
"912354281",40,2643.11793168146,2924.58204292243,2517.98110851286,20,20,1,1
"912354282",19,2148.62668879568,2097.76930456381,2162.56636020013,7,12,1,1
"912354283",12,1942.13723421421,2120.26172694495,1968.69006049611,6,6,1,1
"912354284",29,2708.04981624532,2672.20860946028,2357.79423966008,14,15,1,1
"912354285",56,3567.96117940805,3237.41444878528,2697.24673169728,26,30,1,1
"912354286",13,1988.45438119308,1831.212972674,2001.16379457045,4,9,1,1
"912354287",10,1826.47057375934,1817.61711025553,1896.67490607898,5,5,1,1
"912354288",14,2049.55373443616,2125.80927626468,2031.70713799962,7,7,1,1
"912354289",16,2188.09890087018,2274.04710669651,2087.92318348224,6,10,1,1
"912354290",74,3469.63217014112,3056.40654122283,2855.36548874306,41,33,1,1
"912354291",59,3571.10958801495,3581.6967156658,2726.17127719361,33,26,1,1
"912354292",49,2503.57369874349,2503.11902393492,2624.62502504328,25,24,1,1
"912354293",47,2798.13281061906,2745.85528711925,2602.36394728806,23,24,1,1
"912354294",34,2621.43417836042,2583.35916644467,2435.71163614839,18,16,1,1
"912354295",39,2736.80228853939,2822.96078245049,2504.98447234734,22,17,1,1
"912354296",28,2307.76341004095,2109.31918053394,2340.94327947849,16,12,1,1
"912354297",39,2531.97095806867,2325.67997242307,2504.98447234734,21,18,1,1
"912354298",35,2521.15717978597,2673.35204003121,2450.1860183293,18,17,1,1
"912354299",36,2499.75623317545,2442.28422713782,2464.33502634194,20,16,1,1
"912354300",49,3078.1186909763,3036.71333636425,2624.62502504328,27,22,1,1
"912354301",41,2736.32512154822,2565.48650750122,2530.72175773865,23,18,1,1
"912354302",42,2691.51391679921,2403.0374288957,2543.21752514954,24,18,1,1
"912354303",46,2620.48952803145,2263.6599565623,2590.94954296761,25,21,1,1
"912354304",39,2460.50350562207,2450.55868331486,2504.98447234734,19,20,1,1
"912354305",52,2989.5356954268,3013.91760030354,2656.6981055205,26,26,1,1
"912354306",36,2577.58813493812,2361.32302662667,2464.33502634194,20,16,1,1
"912354307",32,2523.44479698032,2460.30304209324,2405.71569249515,22,10,1,1
"912354308",32,2532.6040669823,2360.77091067246,2405.71569249515,19,13,1,1
"912354309",36,2514.31566200697,2185.75524656947,2464.33502634194,19,17,1,1
"912354310",42,2263.8873539707,2025.1540047886,2543.21752514954,23,19,1,1
"912354311",41,2524.41710312193,2190.04794468474,2530.72175773865,22,19,1,1
"912354312",45,2849.17309114973,2494.01625760444,2579.33597919865,28,17,1,1
"912354313",51,2953.07904609155,2708.47454438131,2646.17454577679,30,21,1,1
"912354314",48,2908.95795733711,2521.73121841548,2613.58673801098,24,24,1,1
"912354315",39,2523.01611003304,2212.1450996774,2504.98447234734,19,20,1,1
"912354316",50,2876.05248602366,2598.02634900215,2635.48551585152,25,25,1,1
"912354317",50,2911.05611800534,2741.17235936917,2635.48551585152,25,25,1,1
"912354318",43,2686.5473453288,2397.88421912366,2555.47878346624,25,18,1,1
"912354319",45,2909.55944333777,3555.24826323086,2579.33597919865,27,18,1,1
"912354320",51,2972.31287714239,3333.54785309741,2646.17454577679,29,22,1,1
"912354321",55,3359.35837962344,3291.9018279486,2687.33120998132,27,28,1,1
"912354322",39,3117.97397921709,3308.98263897684,2504.98447234734,22,17,1,1
"912354323",67,3494.61739385421,3317.13386353234,2797.95380131742,33,34,1,1
"912354324",49,3117.19755475077,3308.22873059544,2624.62502504328,25,24,1,1
"912354325",51,3166.77079000347,3389.5514810037,2646.17454577679,27,24,1,1
"912354326",47,2768.53758541831,2623.62185751036,2602.36394728806,28,19,1,1
"912354327",45,3180.39668553658,3358.33342445795,2579.33597919865,24,21,1,1
"912354328",49,3248.55428528434,3493.78442583188,2624.62502504328,29,20,1,1
"912354329",42,2903.38941883448,2918.11960711524,2543.21752514954,20,22,1,1
"912354330",54,3121.5780840107,3308.69592918943,2677.2712016452,29,25,1,1
"912354331",32,2585.22460607591,2460.86739036912,2405.71569249515,19,13,1,1
"912354332",25,2415.0518504776,2582.78186464627,2287.34065519221,15,10,1,1
"912354333",62,3472.47222509046,3238.14066921805,2753.94837323248,31,31,1,1
"912354334",42,2955.0596311411,2844.11145971122,2543.21752514954,22,20,1,1
"912354335",44,3116.33589477369,2981.10594928978,2567.51523707907,26,18,1,1
"912354336",41,3139.20991284342,2705.1833784935,2530.72175773865,25,16,1,1
"912354337",42,3102.41622858316,3177.96644577341,2543.21752514954,21,21,1,1
"912354339",45,2919.59810620365,2939.91797876467,2579.33597919865,26,19,1,1
"912354340",49,2969.27715224604,3075.28707923386,2624.62502504328,25,24,1,1
"912354341",32,2441.27803732599,2584.36125514457,2405.71569249515,16,16,1,1
"912354342",25,2470.36035504388,2403.51371101226,2287.34065519221,17,8,1,1
"912354343",32,2432.71317205602,2241.0787002852,2405.71569249515,17,15,1,1
"912354344",42,2881.14537317362,2935.9954723373,2543.21752514954,20,22,1,1
"912354345",51,2928.83665673534,3363.33795303134,2646.17454577679,29,22,1,1
"912354346",51,3179.38328349841,3214.01460007171,2646.17454577679,29,22,1,1
"912354347",52,2926.10811385357,2646.28122157907,2656.6981055205,25,27,1,1
"912354348",36,2775.79133639826,2783.6436759835,2464.33502634194,19,17,1,1
"912354349",48,2779.04813369996,2956.99841382683,2613.58673801098,25,23,1,1
"912354350",39,2796.63631490183,3299.51607955723,2504.98447234734,20,19,1,1
"912354351",46,2862.82740367401,3040.05385595841,2590.94954296761,24,22,1,1
"912354352",37,2777.60552388349,2803.78146321401,2478.17471526668,19,18,1,1
"912354353",40,2857.72751068678,3194.27427293568,2517.98110851286,18,22,1,1
"912354354",43,2915.10167072165,3064.92449073197,2555.47878346624,20,23,1,1
"912354355",48,2800.8220726588,2870.86159067551,2613.58673801098,21,27,1,1
"912354356",39,2457.88783429002,2770.68287115761,2504.98447234734,17,22,1,1
"912354357",46,2980.99844127139,3248.34370305148,2590.94954296761,23,23,1,1
"912354358",40,2868.5706562944,2681.00941148492,2517.98110851286,21,19,1,1
"912354359",38,2644.77900959731,2518.79141459423,2491.71993967651,17,21,1,1
"912354360",37,2685.26355912262,3058.57514333529,2478.17471526668,19,18,1,1
"912354361",37,2887.73549810689,3105.37494928757,2478.17471526668,18,19,1,1
"912354362",35,2820.97409103664,3027.70004849679,2450.1860183293,19,16,1,1
"912354363",43,2964.69549140326,3118.08723451383,2555.47878346624,21,22,1,1
"912354364",37,2719.74778411133,3012.73275282771,2478.17471526668,20,17,1,1
"912354365",40,2869.56369203244,2627.66459241679,2517.98110851286,22,18,1,1
"912354366",43,2848.14795470247,2513.92597071372,2555.47878346624,24,19,1,1
"912354367",51,3167.90163275724,3194.9493032651,2646.17454577679,27,24,1,1
"912354368",32,2694.32041786172,3074.92572663143,2405.71569249515,14,18,1,1
"912354369",50,3463.28630531453,3856.29305851386,2635.48551585152,27,23,1,1
"912354370",49,2899.08561314299,2712.62095840445,2624.62502504328,25,24,1,1
"912354371",41,3091.88830647909,3289.06545985485,2530.72175773865,16,25,1,1
"912354372",41,2885.86774000215,3357.98074243909,2530.72175773865,17,24,1,1
"912354373",38,2494.74887284207,2512.06315328492,2491.71993967651,23,15,1,1
"912354374",39,2766.46457044997,2762.01541747909,2504.98447234734,21,18,1,1
"912354375",27,2348.96816210592,2417.75370630303,2323.60649590586,18,9,1,1
"912354376",9,1888.65399153079,2006.8636897838,1856.26587460569,4,5,1,1
"912354377",17,2161.06153819514,2361.80922428702,2113.95669457394,9,8,1,1
"912354378",22,2136.29067816174,2139.67686462128,2228.3491786518,12,10,1,1
"912354379",21,2163.54766858666,2167.97927155096,2207.26116887512,11,10,1,1
"912354380",21,2247.31850440372,2018.76453689102,2207.26116887512,12,9,1,1
"912354381",31,2475.28704620397,2291.21167997971,2390.15469389133,18,13,1,1
"912354382",18,2169.07128424424,1867.00282108909,2138.79896507223,12,6,1,1
"912354383",15,1910.84871614141,1851.02344845644,2060.56118614118,8,7,1,1
"912354384",63,3373.3223492623,2992.92156901526,2762.96971264875,39,24,1,1
"912354385",54,3482.97280264897,3949.84576863759,2677.2712016452,31,23,1,1
"912354386",37,3053.58168208207,3571.0129587724,2478.17471526668,25,12,1,1
"912354387",18,2012.44752392478,1925.6987927898,2138.79896507223,10,8,1,1
"912354388",42,2889.01112169961,3488.41447109472,2543.21752514954,24,18,1,1
"912354389",64,3565.67243942061,3640.10762100546,2771.87783482774,33,31,1,1
"912354390",17,2123.69817148853,2246.00578927288,2113.95669457394,9,8,1,1
"912354391",14,1933.44195693524,1962.3194394702,2031.70713799962,8,6,1,1
"912354392",20,2185.57786032116,2137.04040086858,2185.35845629437,12,8,1,1
"912354393",49,3089.32104068641,3342.12911072963,2624.62502504328,32,17,1,1
"912354394",58,3227.60048074642,2934.69174421663,2716.66249357165,33,25,1,1
"912354395",41,2733.51402479036,2829.3504499915,2530.72175773865,24,17,1,1
"912354396",46,2855.98069795793,2722.93537397298,2590.94954296761,27,19,1,1
"912354397",37,2674.15883301348,2983.95527739801,2478.17471526668,25,12,1,1
"912354398",47,2759.38729952255,2581.89418205042,2602.36394728806,24,23,1,1
"912354399",32,2440.63148343455,2142.3454197802,2405.71569249515,18,14,1,1
"912354400",38,2507.40919226382,2691.60321197587,2491.71993967651,24,14,1,1
"912354401",11,1820.40401388393,1770.88915078329,1933.98659929558,8,3,1,1
"912354402",14,2053.26179159518,2066.58974242166,2031.70713799962,8,6,1,1
"912354403",20,2281.05453226088,2425.27798926159,2185.35845629437,13,7,1,1
"912354404",27,2443.88887559307,2390.89701025858,2323.60649590586,15,12,1,1
"912354405",20,2043.6181560679,2093.21144435839,2185.35845629437,10,10,1,1
"912354406",30,2121.19981268498,1811.82216205707,2374.18906024059,16,14,1,1
"912354407",27,2397.65881865965,2007.99008618045,2323.60649590586,15,12,1,1
"912354408",34,2606.48612814955,2849.03087235206,2435.71163614839,19,15,1,1
"912354409",24,2484.81919051835,2682.69643218538,2268.33468283819,12,12,1,1
"912354410",23,2472.62691111423,2599.01935046803,2248.68783741607,11,12,1,1
"912354411",35,2597.73656107771,2442.97047618088,2450.1860183293,15,20,1,1
"912354412",54,3556.54588214258,4048.00197742099,2677.2712016452,35,19,1,1
"912354413",64,3456.50437488844,3740.00696624991,2771.87783482774,36,28,1,1
"912354414",37,3003.18432010507,3685.10112520816,2478.17471526668,22,15,1,1
"912354415",24,2129.22403532827,2085.07286317147,2268.33468283819,11,13,1,1
"912354416",11,1891.18681587534,1953.20851900661,1933.98659929558,9,2,1,1
"912354417",23,2341.7959501508,2155.12368023675,2248.68783741607,11,12,1,1
"912354418",12,1892.29081031564,1823.83283765052,1968.69006049611,6,6,1,1
"912354419",19,2145.40525526405,1991.419833524,2162.56636020013,11,8,1,1
"912354420",16,2017.47729268782,2051.12608134441,2087.92318348224,7,9,1,1
"912354421",50,3123.30380157996,3269.77705245204,2635.48551585152,28,22,1,1
"912354422",54,3191.50950154129,2986.29057539009,2677.2712016452,29,25,1,1
"912354423",46,3355.56978916658,4078.87563343943,2590.94954296761,23,23,1,1
"912354424",48,3381.28647008356,4175.68301748029,2613.58673801098,30,18,1,1
"912354425",54,2756.21667989534,3217.34049979443,2677.2712016452,33,21,1,1
"912354426",44,2874.17652217006,2957.53914776017,2567.51523707907,27,17,1,1
"912354427",54,2777.67194172507,2696.16587238684,2677.2712016452,28,26,1,1
"912354428",43,2414.87823530875,2197.44139351391,2555.47878346624,23,20,1,1
"912354440",52,3064.16678015639,3496.49543280172,2656.6981055205,31,21,1,1
"912354441",62,3315.31986743804,3800.20877330098,2753.94837323248,30,32,1,1
"912354442",48,2872.10108786709,3384.75039886468,2613.58673801098,28,20,1,1
"912354443",51,3132.20568135762,3298.27102659635,2646.17454577679,29,22,1,1
"912354444",47,3125.25794755138,3212.60320820346,2602.36394728806,28,19,1,1
"912354445",53,3541.28501703348,3532.22574928217,2667.061866114,32,21,1,1
"912354446",66,3682.70964644032,3961.4542337127,2789.3669207067,33,33,1,1
"912354447",61,3680.81885524417,3405.87557146336,2744.81051624266,31,30,1,1
"912354448",48,3123.96834388396,3121.05858655204,2613.58673801098,26,22,1,1
"912354449",45,3390.01298529065,3269.47501548133,2579.33597919865,26,19,1,1
"912354450",37,2824.37148119591,2712.62126733162,2478.17471526668,16,21,1,1
"912354451",40,3161.87209285561,3522.52043912926,2517.98110851286,19,21,1,1
"912354452",27,2503.49120295411,2700.11287708302,2323.60649590586,13,14,1,1
"912354453",34,2705.15271765572,2798.48742311357,2435.71163614839,18,16,1,1
"912354454",52,2608.21037490904,3549.79469650495,2656.6981055205,27,25,1,1
"912354455",39,2936.15458729532,2971.32528515657,2504.98447234734,22,17,1,1
"912354456",49,3155.53105449802,2992.72549260029,2624.62502504328,23,26,1,1
"912354457",36,2991.66708717874,3086.56684672174,2464.33502634194,17,19,1,1
"912354458",43,2980.59446012602,2933.89245125662,2555.47878346624,25,18,1,1
"912354459",42,2981.67026286002,2911.0833438163,2543.21752514954,20,22,1,1
"912354460",39,2965.96803781936,3152.14826403565,2504.98447234734,19,20,1,1
"912354461",43,2994.10110274536,3188.69000581592,2555.47878346624,17,26,1,1
"912354462",44,2905.66014374335,2786.0970028694,2567.51523707907,21,23,1,1
"912354463",48,2867.6899423809,2628.16170904437,2613.58673801098,18,30,1,1
"912354464",36,2745.88644841655,3014.93760515104,2464.33502634194,16,20,1,1
"912354466",34,3125.88447531332,3145.54530850888,2435.71163614839,16,18,1,1
"912354468",32,2816.43185859428,2841.69900912544,2405.71569249515,14,18,1,1
"912354469",48,3089.06275246455,3054.36312657938,2613.58673801098,22,26,1,1
"912354470",41,2993.67590773924,3174.46081731968,2530.72175773865,17,24,1,1
"912354471",54,3248.06304712353,3243.09688656136,2677.2712016452,27,27,1,1
"912354472",49,3292.72318186555,3880.79418712823,2624.62502504328,23,26,1,1
"912354473",40,2972.68394758629,3164.36750869193,2517.98110851286,17,23,1,1
"912354474",39,2801.46831032554,2956.52572476359,2504.98447234734,17,22,1,1
"912354475",34,2531.99111682989,2557.86082213482,2435.71163614839,16,18,1,1
"912354476",28,2446.00762006137,2570.85810453562,2340.94327947849,18,10,1,1
"912354477",20,2233.53593095581,2288.20936873779,2185.35845629437,10,10,1,1
"912354478",45,2596.90299170809,2972.91946720277,2579.33597919865,27,18,1,1
"912354479",32,2377.22968481295,2495.60647963839,2405.71569249515,21,11,1,1
"912354480",25,2212.48458402156,2462.71606051978,2287.34065519221,15,10,1,1
"912354481",38,2613.26376363972,2846.19202473837,2491.71993967651,23,15,1,1
"912354482",46,2769.58321349621,2748.66037713602,2590.94954296761,28,18,1,1
"912354483",38,2575.54997329899,2446.28644291175,2491.71993967651,21,17,1,1
"912354485",44,2640.08455765048,2684.72508680589,2567.51523707907,24,20,1,1
"912354488",27,2140.53188219306,1382.15978960265,2323.60649590586,14,13,1,1
"912354489",13,1947.30096357835,1711.60434902899,2001.16379457045,6,7,1,1
"912354490",12,1886.9902682953,1627.94613987972,1968.69006049611,6,6,1,1
"912354491",23,2350.23385951035,2349.27566735494,2248.68783741607,16,7,1,1
"912354492",24,2032.82941980251,1813.14260444972,2268.33468283819,13,11,1,1
"912354493",12,1894.41270178113,1616.71745071421,1968.69006049611,6,6,1,1
"912354494",15,2010.65203465671,1908.59088853847,2060.56118614118,9,6,1,1
"912354495",14,2104.1488468378,1993.79917197143,2031.70713799962,8,6,1,1
"912354496",13,2041.64309270433,1933.98843445171,2001.16379457045,7,6,1,1
"912354497",11,1861.79472563327,1624.59526548936,1933.98659929558,4,7,1,1
"912354498",11,1784.24902538101,1531.40817151619,1933.98659929558,6,5,1,1
"912354499",12,1915.58051052768,1817.1896580027,1968.69006049611,5,7,1,1
"912354500",12,1864.3080924338,1670.81897034364,1968.69006049611,7,5,1,1
"912354501",14,1946.3809149053,1655.38233791001,2031.70713799962,8,6,1,1
"912354502",13,1892.90982813748,1610.84766163684,2001.16379457045,6,7,1,1
"912354503",18,2058.46959829342,1758.97489864884,2138.79896507223,8,10,1,1
"912354504",13,1930.94514021278,1687.28694537725,2001.16379457045,8,5,1,1
"912354505",20,2277.39571486572,2209.76116866907,2185.35845629437,12,8,1,1
"912354506",8,1804.59587766168,1758.17587518423,1812.11073017574,4,4,1,1
"912354507",10,1862.73951427685,1835.55364989254,1896.67490607898,5,5,1,1
"912354508",15,1897.00469290245,1446.15629393101,2060.56118614118,9,6,1,1
"912354509",6,1690.83247962274,1679.51768160441,1708.62817714657,4,2,1,1
"912354510",7,1769.78423084357,1707.44873810932,1763.32076508842,5,2,1,1
"912354511",11,1866.11169948309,1581.67570599288,1933.98659929558,5,6,1,1
"912354512",15,1927.51753158336,1731.68621900771,2060.56118614118,8,7,1,1
"912354513",10,1948.07378217973,1883.87572373203,1896.67490607898,6,4,1,1
"912354514",18,2101.49512706037,1936.09084158069,2138.79896507223,7,11,1,1
"912354515",12,1839.23295304414,1646.10421664555,1968.69006049611,5,7,1,1
"912354516",15,1897.55251808811,1640.38086651555,2060.56118614118,10,5,1,1
"912354517",13,1886.88393562765,1552.08807059778,2001.16379457045,6,7,1,1
"912354518",18,2035.83856224157,1667.04180456821,2138.79896507223,9,9,1,1
"912354519",10,1810.75245273961,1524.96440419178,1896.67490607898,4,6,1,1
"912354593",26,2319.19683463532,2043.58747970196,2305.75108410937,14,12,1,1
"912354594",18,2145.54418592054,2294.74636829382,2138.79896507223,4,14,1,1
"912354595",25,2017.00378017245,1531.4617252663,2287.34065519221,10,15,1,1
"912354596",24,1963.71606852305,1997.29307556981,2268.33468283819,12,12,1,1
"912354597",31,2158.06397615977,1742.4349442156,2390.15469389133,12,19,1,1
"912354598",19,2330.2720825977,2047.69167536618,2162.56636020013,12,7,1,1
"912354599",26,2311.43252234839,2202.31428961648,2305.75108410937,15,11,1,1
"912354600",19,2051.55601412409,1901.67011254636,2162.56636020013,8,11,1,1
"912354601",21,2188.17281499618,2023.64013586249,2207.26116887512,9,12,1,1
"912354602",26,2443.3828728834,2349.60604829203,2305.75108410937,11,15,1,1
"912354603",12,2034.35520056598,1976.35863623383,1968.69006049611,5,7,1,1
"912354604",16,2078.41706828446,2148.14614111418,2087.92318348224,7,9,1,1
"912354605",19,2132.29030455532,2242.00433524553,2162.56636020013,8,11,1,1
"912354606",26,2361.27763011805,2382.52497361376,2305.75108410937,11,15,1,1
"912354607",19,2198.2545072592,1817.42395173725,2162.56636020013,9,10,1,1
"912354608",18,2146.06656184674,2274.12957470899,2138.79896507223,5,13,1,1
"912354609",21,1923.12366427714,1392.11461504733,2207.26116887512,4,17,1,1
"912354610",13,1920.0467918055,1926.10400093543,2001.16379457045,7,6,1,1
"912354611",9,1792.5009467324,1899.81706818131,1856.26587460569,5,4,1,1
"912354612",26,2314.30769836391,2064.17678865517,2305.75108410937,13,13,1,1
"912354613",25,2154.27774930787,1681.33390162238,2287.34065519221,12,13,1,1
"912354614",15,2139.01066738918,1999.21244155071,2060.56118614118,7,8,1,1
"912354615",21,2078.93515521489,1735.09394924234,2207.26116887512,13,8,1,1
"912354616",19,2300.69846776271,2420.92017944328,2162.56636020013,8,11,1,1
"912354617",11,1990.27860568139,1986.19430704342,1933.98659929558,5,6,1,1
"912354618",23,2327.23207071944,2563.92089995482,2248.68783741607,10,13,1,1
"912354619",25,2225.27569884165,2470.36181970783,2287.34065519221,12,13,1,1
"912354620",19,2141.8743268701,2164.51434025747,2162.56636020013,7,12,1,1
"912354693",29,2700.45738116931,2335.87621888904,2357.79423966008,16,13,1,1
"912354694",37,2649.1950401018,2707.56545836403,2478.17471526668,19,18,1,1
"912354695",54,2931.0689864444,3094.87806190573,2677.2712016452,26,28,1,1
"912354696",48,3568.70541318219,3322.88044166733,2613.58673801098,25,23,1,1
"912354697",50,3077.89287075898,2327.93106898107,2635.48551585152,26,24,1,1
"912354698",64,3316.31088466925,2939.86997698515,2771.87783482774,37,27,1,1
"912354699",58,3147.23375124725,3242.27256649774,2716.66249357165,30,28,1,1
"912354700",50,3056.80357438108,2709.90948391338,2635.48551585152,22,28,1,1
"912354701",61,3722.44415340593,3566.50723808166,2744.81051624266,31,30,1,1
"912354702",65,3134.10939628145,3377.00301371847,2780.67589681985,40,25,1,1
"912354704",29,2543.23344014446,2521.71100633447,2357.79423966008,17,12,1,1
"912354706",59,3266.67733464615,3110.75625413549,2726.17127719361,27,32,1,1
"912354719",31,2168.44569299635,2025.6691085514,2390.15469389133,12,19,1,1
"912354720",31,2253.78804785223,1956.75496238724,2390.15469389133,11,20,1,1
"912354721",30,2373.00982336692,2412.28191257428,2374.18906024059,10,20,1,1
"912354722",30,2467.5601345376,2492.55105261533,2374.18906024059,13,17,1,1
"912354723",29,2281.26068285795,1870.01774367631,2357.79423966008,14,15,1,1
"912354724",23,2114.64761782173,2125.41166813326,2248.68783741607,9,14,1,1
"912354725",20,2047.97209678525,2232.29977936649,2185.35845629437,6,14,1,1
"912354726",15,1981.51790354496,2034.69759105897,2060.56118614118,5,10,1,1
"912354727",27,2216.59329355656,1883.17301284742,2323.60649590586,13,14,1,1
"912354728",22,2192.20940796243,1941.1541650833,2228.3491786518,11,11,1,1
"912354729",13,1900.67246597187,1726.31665757492,2001.16379457045,5,8,1,1
"912354730",19,2078.54994271861,1969.20163609454,2162.56636020013,7,12,1,1
"912354731",36,2312.66873196735,2021.79292605106,2464.33502634194,17,19,1,1
"912354732",33,2406.0931276178,1826.31641115188,2420.89448855093,17,16,1,1
"912354733",31,2283.26418614757,2033.89150576977,2390.15469389133,16,15,1,1
"912354734",32,2314.50601116148,1902.23988857558,2405.71569249515,15,17,1,1
"912354735",10,1828.51941776689,1770.46365816393,1896.67490607898,2,8,1,1
"912354736",11,1745.15278819662,1726.27642113442,1933.98659929558,3,8,1,1
"912354737",9,1753.79328382676,1697.49582098252,1856.26587460569,3,6,1,1
"912354738",13,1837.29179185207,1667.06424792768,2001.16379457045,3,10,1,1
"912354739",37,2205.8007727069,1710.51160422047,2478.17471526668,23,14,1,1
"912354740",29,2260.2788934361,2099.63571900871,2357.79423966008,15,14,1,1
"912354741",36,2444.81020282175,2167.20431257303,2464.33502634194,20,16,1,1
"912354742",26,2221.37415110426,2378.77762056384,2305.75108410937,13,13,1,1
"912354743",40,2641.8178667722,2105.75837701796,2517.98110851286,21,19,1,1
"912354744",28,2373.80582964896,1923.22170402596,2340.94327947849,15,13,1,1
"912354745",26,2323.95344080507,2156.39123414815,2305.75108410937,13,13,1,1
"912354746",41,2391.5490518417,2137.97642869426,2530.72175773865,23,18,1,1
"912354747",19,1887.36877440555,1713.0769532694,2162.56636020013,6,13,1,1
"912354748",26,2096.71182894239,1896.22655911225,2305.75108410937,10,16,1,1
"912354749",36,2555.29519634654,2388.1357199695,2464.33502634194,17,19,1,1
"912354750",33,2250.59737734404,1835.06388206956,2420.89448855093,15,18,1,1
"912354751",26,2149.00303441222,2070.494948735,2305.75108410937,14,12,1,1
"912354752",19,2130.15781243484,1983.36904759001,2162.56636020013,8,11,1,1
"912354753",32,2382.18663324989,1906.76775971929,2405.71569249515,16,16,1,1
"912354754",38,2311.08444720412,1809.30173816055,2491.71993967651,19,19,1,1
"912354755",38,2308.16962392568,2077.78613228254,2491.71993967651,19,19,1,1
"912354756",24,2212.64165148418,1852.67085909046,2268.33468283819,12,12,1,1
"912354757",31,2218.37400036164,1930.841652774,2390.15469389133,14,17,1,1
"912354758",20,2013.83621657793,1840.02051833542,2185.35845629437,7,13,1,1
"912354761",55,2553.85838804477,2761.8737456509,2687.33120998132,27,28,1,1
"912354762",34,2510.88684407378,2362.68737245561,2435.71163614839,16,18,1,1
"912354763",58,2587.715138669,2628.80900939448,2716.66249357165,32,26,1,1
"912354764",53,2896.81972166731,2591.6011916252,2667.061866114,25,28,1,1
"912354765",50,2652.54500866202,2269.64498239417,2635.48551585152,26,24,1,1
"912354766",43,2445.08437710335,2160.21055510148,2555.47878346624,24,19,1,1
"912354767",35,2210.91153283514,1652.30042504566,2450.1860183293,20,15,1,1
"912354768",59,3068.77740644621,3602.21598886827,2726.17127719361,28,31,1,1
"912354769",81,3080.90274087015,3569.17387513089,2908.60658576875,39,42,1,1
"912354770",55,2462.03318283302,1860.98108064456,2687.33120998132,34,21,1,1
"912354771",37,2392.18525564539,2003.81177563899,2478.17471526668,17,20,1,1
"912354772",54,2935.21463058232,2116.80086731678,2677.2712016452,33,21,1,1
"912354773",57,2578.57983894545,2010.77998664992,2707.02236739438,35,22,1,1
"912354774",49,3151.06163853281,3754.51149967298,2624.62502504328,26,23,1,1
"912354775",43,2593.3294428846,2735.80884981916,2555.47878346624,29,14,1,1
"912354777",30,2277.12933699288,1802.71464133827,2374.18906024059,16,14,1,1
"923400159",25,2037.61464477638,1988.84381476803,2287.34065519221,11,14,1,1
"923400160",29,2052.30877466215,1934.29992860166,2357.79423966008,12,17,1,1
"923400168",52,3242.91770777896,3979.12164953274,2656.6981055205,31,21,1,1
"923400169",45,3167.19763424933,4813.03501489889,2579.33597919865,24,21,1,1
"923400170",47,3361.05507840559,4114.30532479305,2602.36394728806,26,21,1,1
"923400171",58,3136.94013745589,3863.20879076418,2716.66249357165,31,27,1,1
"923400172",49,2969.90773493075,3116.84553922489,2624.62502504328,28,21,1,1
"923400173",31,2744.43217132782,3366.2703195311,2390.15469389133,17,14,1,1
"923400174",34,2641.68223572549,3043.8842475373,2435.71163614839,20,14,1,1
"923400175",30,2846.23156877307,3605.26551084732,2374.18906024059,20,10,1,1
"923400176",49,3069.22613577219,4197.68509273481,2624.62502504328,29,20,1,1
"923400177",35,2888.815833045,3315.44578056994,2450.1860183293,19,16,1,1
"923400178",41,2759.97105116824,2590.46482863837,2530.72175773865,20,21,1,1
"923400179",38,2876.85841495251,3279.17902906599,2491.71993967651,25,13,1,1
"923400180",38,3302.40682351877,4738.81825310049,2491.71993967651,22,16,1,1
"923400181",30,2835.84058526885,3146.35928049484,2374.18906024059,16,14,1,1
"923400182",30,2577.92241642643,2601.04080488641,2374.18906024059,13,17,1,1
"923400183",52,3252.25684768779,4007.49359764715,2656.6981055205,28,24,1,1
"923400184",45,2687.77201455434,3214.83056547777,2579.33597919865,24,21,1,1
"923400185",39,2725.01121167392,3641.33136399475,2504.98447234734,19,20,1,1
"923400186",52,3060.86484413505,3388.03461025568,2656.6981055205,28,24,1,1
"923400187",32,2914.28474732369,3803.29719226542,2405.71569249515,16,16,1,1
"923400188",35,2880.92294623712,3700.88419601597,2450.1860183293,16,19,1,1
"923400189",36,2701.32872615445,4037.55721615031,2464.33502634194,18,18,1,1
"923400190",47,3162.69415153815,4327.22119648448,2602.36394728806,25,22,1,1
"923400191",61,3141.60616510744,3181.19477907402,2744.81051624266,35,26,1,1
"923400192",33,2666.78026253004,2967.05288344041,2420.89448855093,14,19,1,1
"923400193",41,2671.71784940891,3254.20026791111,2530.72175773865,21,20,1,1
"923400194",33,2472.93344469711,2897.38082208614,2420.89448855093,16,17,1,1
"923400195",34,2569.88571779256,2831.7547189012,2435.71163614839,19,15,1,1
"923400196",44,3182.2541147424,4196.76905329908,2567.51523707907,21,23,1,1
"923400197",35,2825.96397016315,3316.61306478586,2450.1860183293,21,14,1,1
"923400198",30,2771.72038733902,3212.8254187986,2374.18906024059,16,14,1,1
"923400199",40,3067.23824070667,3846.44786295018,2517.98110851286,19,21,1,1
"923400200",37,2929.89450543962,3461.19275520829,2478.17471526668,20,17,1,1
"923400201",37,2787.27077642206,3692.9924717077,2478.17471526668,20,17,1,1
"923400202",41,3160.6947028583,3627.44192452941,2530.72175773865,23,18,1,1
"923400203",45,3220.06996716543,3672.31165347603,2579.33597919865,23,22,1,1
"923400204",48,2932.96264141411,3174.7702603348,2613.58673801098,22,26,1,1
"923400205",47,3046.72818615793,3072.01394062397,2602.36394728806,26,21,1,1
"923400206",33,2579.97028944583,3039.23397133875,2420.89448855093,17,16,1,1
"923400207",49,2747.09842894232,3183.58433196371,2624.62502504328,27,22,1,1
"923400208",55,2942.88448673936,3525.80301074487,2687.33120998132,29,26,1,1
"923400209",43,2840.04913058873,3346.51887320128,2555.47878346624,25,18,1,1
"923400210",44,3249.95069453755,4686.89201312485,2567.51523707907,22,22,1,1
"923400211",46,3237.35190472497,3636.49092570447,2590.94954296761,25,21,1,1
"923400212",47,2849.72915142141,3055.4778509118,2602.36394728806,26,21,1,1
"923400213",33,2777.11883466232,3882.83056716611,2420.89448855093,17,16,1,1
"923400214",59,2998.27383038972,3381.98588656696,2726.17127719361,32,27,1,1
"923400215",39,2820.38148308877,3370.42275025238,2504.98447234734,19,20,1,1
"923400216",30,2418.26727198166,2706.27580240739,2374.18906024059,19,11,1,1
"923400217",35,2818.18859355844,2781.58631627276,2450.1860183293,18,17,1,1
"923400218",31,2367.7119184233,2513.80771694364,2390.15469389133,16,15,1,1
"923400219",42,2946.4715402099,3516.01934423912,2543.21752514954,23,19,1,1
"923400220",40,2434.2467767064,2529.41977474857,2517.98110851286,20,20,1,1
"923400221",35,2800.06795734423,3615.93664921841,2450.1860183293,16,19,1,1
"923400222",35,2815.17236652587,3050.66880086148,2450.1860183293,18,17,1,1
"923400223",37,2774.45375550388,3513.09515574347,2478.17471526668,20,17,1,1
"923400224",47,3058.16083069632,3949.14030574017,2602.36394728806,27,20,1,1
"923400225",47,2941.87967147161,4137.5139113256,2602.36394728806,25,22,1,1
"923400226",36,2719.56855767929,3715.83097784432,2464.33502634194,20,16,1,1
"923400227",21,2460.05286726441,3083.87132948878,2207.26116887512,8,13,1,1
"923400228",48,3224.49128929339,4500.36201065897,2613.58673801098,25,23,1,1
"923400229",41,2697.31932166826,3053.2434581867,2530.72175773865,18,23,1,1
"923400230",54,3579.04865592279,5072.39937484278,2677.2712016452,33,21,1,1
"923400232",62,3952.92814384083,5283.10403421063,2753.94837323248,36,26,1,1
"923400233",31,2701.67676609644,2564.35265187354,2390.15469389133,12,19,1,1
"923400234",34,2704.44287863183,2587.71933081387,2435.71163614839,16,18,1,1
"923400235",41,2875.83130586348,2947.50114169037,2530.72175773865,21,20,1,1
"923400421",17,1837.31228604277,1626.46391743719,2113.95669457394,12,5,1,1
"923400423",20,1825.58566974215,1456.69711975571,2185.35845629437,9,11,1,1
"923400424",19,1946.88972627613,1394.53990709968,2162.56636020013,12,7,1,1
"923400427",19,1962.75323077602,1773.61338096156,2162.56636020013,12,7,1,1
"923400428",13,1569.12987831357,1327.71530831712,2001.16379457045,7,6,1,1
"923400429",29,2421.85505204495,2751.36144947139,2357.79423966008,13,16,1,1
"923400430",37,2616.332637794,2160.81282796532,2478.17471526668,22,15,1,1
"923400431",20,2202.70665990713,2474.14702812193,2185.35845629437,9,11,1,1
"923400432",30,2425.0749801338,2966.25962583227,2374.18906024059,13,17,1,1
"923400433",28,2401.30869992883,2647.11508787066,2340.94327947849,12,16,1,1
"923400434",30,2795.10404542136,2967.976714966,2374.18906024059,12,18,1,1
"923400435",51,3091.64799894311,2545.80980895255,2646.17454577679,28,23,1,1
"923400436",13,1923.89357285235,1913.91968552364,2001.16379457045,5,8,1,1
"923400437",34,2235.89705103029,2156.5460403805,2435.71163614839,11,23,1,1
"923400438",53,3116.1557494783,3383.86746999068,2667.061866114,31,22,1,1
"923400439",40,2889.0179669361,2773.37336111071,2517.98110851286,20,20,1,1
"923400440",50,2857.48211211394,2837.80093246906,2635.48551585152,30,20,1,1
"923400441",42,2675.969964562,2646.01341086409,2543.21752514954,26,16,1,1
"923400442",36,2686.45532052966,3054.13121542865,2464.33502634194,13,23,1,1
"923400443",22,2381.08425264306,2329.48043932997,2228.3491786518,12,10,1,1
"923400444",27,2215.51381527076,2319.14030466618,2323.60649590586,10,17,1,1
"923400445",28,2570.66487923656,2599.39591143004,2340.94327947849,15,13,1,1
"923400446",25,2455.97240273551,2601.36730859326,2287.34065519221,13,12,1,1
"923400447",18,2125.89292948525,2018.8619645597,2138.79896507223,7,11,1,1
"923400448",42,2868.25015246539,3193.44911016966,2543.21752514954,23,19,1,1
"923400449",28,2339.07610151036,2678.41955305958,2340.94327947849,11,17,1,1
"923400450",33,2615.63694714092,2709.32787286715,2420.89448855093,15,18,1,1
"923400451",24,2328.47342161732,2327.22987760378,2268.33468283819,10,14,1,1
"923400452",39,2634.52509571832,2367.31151625522,2504.98447234734,23,16,1,1
"923400453",16,2112.59622891591,2543.91526245149,2087.92318348224,6,10,1,1
"923400454",36,2696.20463283765,2656.46642783655,2464.33502634194,14,22,1,1
"923400455",33,2517.6741090499,2740.724555774,2420.89448855093,16,17,1,1
"923400456",23,2273.84622164035,2120.33150844278,2248.68783741607,8,15,1,1
"923400457",21,2256.64132997775,2176.49543473748,2207.26116887512,7,14,1,1
"923400458",21,2113.20928480091,2007.55884372875,2207.26116887512,8,13,1,1
"923400459",27,2530.13630591754,2488.9207329681,2323.60649590586,15,12,1,1
"923400460",35,2483.11382909667,2382.51066281443,2450.1860183293,20,15,1,1
"923400461",6,1699.35819478516,1668.34382081516,1708.62817714657,2,4,1,1
"923400462",12,2036.60077827494,1959.84700638474,1968.69006049611,6,6,1,1
"923400463",9,1928.77874281477,1825.85205013275,1856.26587460569,3,6,1,1
"923400464",45,3119.2626059664,2895.51119668727,2579.33597919865,26,19,1,1
"923400465",57,3297.00909506429,3745.19221241098,2707.02236739438,29,28,1,1
"923400466",49,3187.16607375957,2870.24326868027,2624.62502504328,24,25,1,1
"923400467",34,2842.77280585124,2858.94843269657,2435.71163614839,15,19,1,1
"923400468",14,1865.59081967603,1784.51480709565,2031.70713799962,5,9,1,1
"923400469",39,2780.86084752833,2907.20143568066,2504.98447234734,15,24,1,1
"923400470",34,2530.87755239809,2405.82991729774,2435.71163614839,14,20,1,1
"923400471",31,2509.38386915434,2168.81931931468,2390.15469389133,16,15,1,1
"923400472",31,2559.1038211253,2453.19535084599,2390.15469389133,13,18,1,1
"923400473",45,3058.5676129082,3125.73471970141,2579.33597919865,30,15,1,1
"923400474",42,2904.64630850717,2108.2475333869,2543.21752514954,26,16,1,1
"923400475",31,2472.0806388929,2453.15473572686,2390.15469389133,17,14,1,1
"923400476",33,2781.21607746136,2885.17489265006,2420.89448855093,21,12,1,1
"923400477",51,3543.57484506213,4173.00030625656,2646.17454577679,25,26,1,1
"923400478",59,4020.05881805247,4173.02133612194,2726.17127719361,31,28,1,1
"923400479",38,2919.77498504509,3180.00614190136,2491.71993967651,21,17,1,1
"923400480",43,2910.57896690779,2437.01902923524,2555.47878346624,28,15,1,1
"923400481",31,2649.74726784857,3013.73369498472,2390.15469389133,16,15,1,1
"923400482",20,2355.51896919892,2367.47813836485,2185.35845629437,12,8,1,1
"923400483",31,2350.54075303707,2453.42072935522,2390.15469389133,13,18,1,1
"923400484",29,2509.93870936168,2351.75536514695,2357.79423966008,17,12,1,1
"923400485",46,2757.07821667384,2972.98496997271,2590.94954296761,26,20,1,1
"923400486",20,2177.94419798928,1993.15644645547,2185.35845629437,6,14,1,1
"923400487",38,2729.31983189692,2771.48600884019,2491.71993967651,25,13,1,1
"923400488",26,2427.1588401129,2477.40138481598,2305.75108410937,11,15,1,1
"923400489",42,2718.27037361405,3052.70271103752,2543.21752514954,25,17,1,1
"923400490",34,2498.8817647553,2618.13668442146,2435.71163614839,19,15,1,1
"923400491",48,2826.62695793302,2461.40414138922,2613.58673801098,25,23,1,1
"923400492",22,2284.59602407067,2320.3638918637,2228.3491786518,10,12,1,1
"923400493",47,3523.00843493257,3501.83291905834,2602.36394728806,19,28,1,1
"923400494",35,2817.40257790798,3327.27814533859,2450.1860183293,20,15,1,1
"923400495",15,2214.62855871185,2063.30529116071,2060.56118614118,7,8,1,1
"923400496",28,2346.96930746318,2281.59565828085,2340.94327947849,10,18,1,1
"923400497",46,2885.90389913588,2497.53221628768,2590.94954296761,19,27,1,1
"923400500",57,3509.63844710877,4344.40421404181,2707.02236739438,26,31,1,1
"923400501",58,3462.80268799075,3353.16070352379,2716.66249357165,25,33,1,1
"923400502",40,2828.99010158658,2753.69039573468,2517.98110851286,14,26,1,1
"923400503",14,2057.67931214464,1820.09036964485,2031.70713799962,5,9,1,1
"923400504",13,1901.6103305467,1713.83326912481,2001.16379457045,4,9,1,1
"923400505",17,2102.14466497151,1848.02378067456,2113.95669457394,5,12,1,1
"923400506",50,3091.42305649642,3113.1212945508,2635.48551585152,26,24,1,1
"923400507",49,2968.47726353471,3069.79406680608,2624.62502504328,21,28,1,1
"923400508",41,2420.68403463461,2407.35042628164,2530.72175773865,19,22,1,1
"923400509",54,2567.47624152475,2569.31896155587,2677.2712016452,28,26,1,1
"923400510",37,2871.61814699114,2707.38706004889,2478.17471526668,14,23,1,1
"923400511",28,2417.59375930789,2174.99496473717,2340.94327947849,13,15,1,1
"923400512",19,2252.42077581552,2370.64863714057,2162.56636020013,12,7,1,1
"923400513",18,2197.25336915013,2225.30413328892,2138.79896507223,8,10,1,1
"923400514",12,1955.70975607062,2034.75592777515,1968.69006049611,4,8,1,1
"923400515",43,3023.17905256076,3630.06897148616,2555.47878346624,20,23,1,1
"923400516",46,3009.44931538141,3120.30430835303,2590.94954296761,19,27,1,1
"923400517",37,2821.76354614525,2780.67566369253,2478.17471526668,18,19,1,1
"923400518",59,3090.46494284919,3404.41552988603,2726.17127719361,28,31,1,1
"923400519",20,2397.77312111005,2666.04696547927,2185.35845629437,12,8,1,1
"923400520",13,2011.1037270797,1894.19829648598,2001.16379457045,4,9,1,1
"923400521",61,3260.58572185808,3483.04346606903,2744.81051624266,30,31,1,1
"923400522",28,2361.84067624684,2364.38115319084,2340.94327947849,15,13,1,1
"923400523",12,2090.86514487215,2113.71000944234,1968.69006049611,4,8,1,1
"923400524",15,2143.00276692474,2315.80967206489,2060.56118614118,9,6,1,1
"923400525",56,3386.36236252918,3356.83212471059,2697.24673169728,23,33,1,1
"923400526",44,3129.46850439388,2840.20473349637,2567.51523707907,19,25,1,1
"923400527",55,3601.94818948005,2928.39983887553,2687.33120998132,25,30,1,1
"923400528",43,2875.17142704278,3086.02200028282,2555.47878346624,14,29,1,1
"923400529",34,2878.27106882697,2675.99183788756,2435.71163614839,13,21,1,1
"923400530",50,3120.76825970534,3493.70568569255,2635.48551585152,24,26,1,1
"923400531",69,4134.82046386765,5472.1288480409,2814.82611826518,34,35,1,1
"923400532",22,2146.94992878307,2118.04897484117,2228.3491786518,8,14,1,1
"923400533",42,2875.28174177977,2873.32578548113,2543.21752514954,20,22,1,1
"923400534",64,3207.36092856663,3187.75826899017,2771.87783482774,25,39,1,1
"923400536",26,2485.76151830612,2324.79294148942,2305.75108410937,14,12,1,1
"923400537",50,3042.45645595112,2928.07806431614,2635.48551585152,16,34,1,1
"923400538",38,2866.64461574055,2936.70526914,2491.71993967651,17,21,1,1
"923400539",44,2862.18361792379,2831.21434294409,2567.51523707907,18,26,1,1
"923400540",50,3483.63620289329,3849.95348774432,2635.48551585152,19,31,1,1
"923400541",67,3411.91874929249,3869.28433020172,2797.95380131742,28,39,1,1
"923400542",62,3118.91756592742,3385.97384407866,2753.94837323248,29,33,1,1
"923400543",61,2999.62488326042,2950.64646023684,2744.81051624266,28,33,1,1
"923400544",34,2750.47788170428,3013.90432600261,2435.71163614839,14,20,1,1
"923400545",19,2267.43166075735,2360.20252707153,2162.56636020013,9,10,1,1
"923400546",55,3172.21257115104,3845.21229630069,2687.33120998132,25,30,1,1
"923400547",67,3287.35125518836,2885.49607174815,2797.95380131742,32,35,1,1
"923400548",21,2167.31309777448,2147.67951522403,2207.26116887512,9,12,1,1
"923400549",50,3379.23735616324,4389.69615939394,2635.48551585152,28,22,1,1
"923400550",19,2035.45948600822,2010.98020993043,2162.56636020013,9,10,1,1
"923400551",27,2482.4812081124,2478.17061641264,2323.60649590586,11,16,1,1
"923400552",38,3049.43864805935,2657.25710674291,2491.71993967651,19,19,1,1
"923400553",13,1961.80021892603,2011.6141161936,2001.16379457045,7,6,1,1
"923400554",67,3644.82164506214,4711.19183131027,2797.95380131742,33,34,1,1
"923400555",58,3196.2288045002,3422.0352320954,2716.66249357165,30,28,1,1
"923400556",29,2532.65793347171,2276.96599157712,2357.79423966008,19,10,1,1
"923400557",61,4232.65802233163,5850.04972685633,2744.81051624266,29,32,1,1
"923400558",33,2517.49802303009,2485.85185038857,2420.89448855093,9,24,1,1
"923400559",16,2090.57857795991,2211.44537856865,2087.92318348224,7,9,1,1
"923400560",58,3359.82937670401,3867.14110627021,2716.66249357165,24,34,1,1
"923400561",12,1943.43459388167,1928.22734948616,1968.69006049611,4,8,1,1
"923400562",61,3329.50710299498,3457.68042364239,2744.81051624266,29,32,1,1
"923400563",69,3679.85961432883,3766.88204240423,2814.82611826518,33,36,1,1
"923400564",53,3077.59928077513,3012.00433699588,2667.061866114,22,31,1,1
"923400565",27,2604.01403474863,2608.89201944014,2323.60649590586,12,15,1,1
"923400566",74,3944.1854235542,3501.03059463688,2855.36548874306,38,36,1,1
"923400567",41,2976.14891062674,2916.11576700721,2530.72175773865,17,24,1,1
"923400568",42,3325.71401090479,3192.3633189347,2543.21752514954,21,21,1,1
"923400569",60,2886.67394889959,3117.2443873617,2735.5526890818,32,28,1,1
"923400572",35,2504.39877097946,2816.23090373643,2450.1860183293,17,18,1,1
"923400573",47,3156.93389103321,3890.05778788438,2602.36394728806,24,23,1,1
"923400574",61,3246.5281028367,3605.06153627675,2744.81051624266,34,27,1,1
"923400575",16,1933.8287189325,1750.82418425496,2087.92318348224,6,10,1,1
"923400576",52,3078.6746175436,3831.56025194399,2656.6981055205,24,28,1,1
"923400577",62,3049.67686030407,3280.33110937598,2753.94837323248,36,26,1,1
"923400578",43,2860.54373157293,3449.19148028716,2555.47878346624,16,27,1,1
"923400579",40,2998.52677494991,3822.71718748463,2517.98110851286,20,20,1,1
"923400580",60,3338.87532660372,4044.53007680273,2735.5526890818,29,31,1,1
"923400581",69,3082.3257494913,2925.87692896506,2814.82611826518,32,37,1,1
"923400582",78,4068.76528951468,4700.5405813006,2886.25582696583,37,41,1,1
"923400583",56,2935.55237006499,3194.3265547103,2697.24673169728,22,34,1,1
"923400584",30,2363.86056769595,2159.8481911825,2374.18906024059,13,17,1,1
"923400585",43,2847.51463246752,3390.81056600953,2555.47878346624,17,26,1,1
"923400586",46,2720.19259287406,3015.12200931631,2590.94954296761,19,27,1,1
"923400587",7,1751.72528312677,1763.97232428339,1763.32076508842,4,3,1,1
"923400588",38,2954.79355987589,3072.59262356403,2491.71993967651,16,22,1,1
"923400589",47,3093.49358632181,3045.3815496182,2602.36394728806,18,29,1,1
"923400590",50,3206.76692786461,3291.76231889904,2635.48551585152,20,30,1,1
"923400591",25,2245.05136380311,2103.00969372782,2287.34065519221,14,11,1,1
"923400592",43,2559.30494650845,2477.67888000474,2555.47878346624,18,25,1,1
"923400593",37,2572.33219261845,2581.32793340709,2478.17471526668,14,23,1,1
"923400594",48,3067.64028757709,2629.38446134995,2613.58673801098,24,24,1,1
"923400595",41,2592.85060832087,2282.54186530192,2530.72175773865,18,23,1,1
"923400596",54,2819.22307890927,2851.81801652932,2677.2712016452,24,30,1,1
"923400597",14,2098.24177909355,2085.64088186368,2031.70713799962,7,7,1,1
"923400598",59,3358.18177763924,3541.0167138831,2726.17127719361,23,36,1,1
"923400599",53,2838.3105386832,2710.36202896054,2667.061866114,22,31,1,1
"923400600",35,2887.10523322299,3160.61091690138,2450.1860183293,11,24,1,1
"923400601",18,2180.16763397902,1954.68071489285,2138.79896507223,5,13,1,1
"923400602",52,3128.21794744026,3527.35988594356,2656.6981055205,29,23,1,1
"923400603",65,3431.63409096957,3490.77122134011,2780.67589681985,41,24,1,1
"923400604",56,2967.96599970033,3073.72732309437,2697.24673169728,34,22,1,1
"923400605",22,2280.80204062076,2179.84623646747,2228.3491786518,10,12,1,1
"923400606",54,2822.04910801229,2532.17846571255,2677.2712016452,33,21,1,1
"923400607",55,3325.21583583462,3176.38401808251,2687.33120998132,25,30,1,1
"923400608",22,2404.26183607975,2459.07658531078,2228.3491786518,15,7,1,1
"923400609",62,3386.38686971677,3974.2430509272,2753.94837323248,36,26,1,1
"923400610",75,3310.51941718417,2895.95271094305,2863.21031780169,36,39,1,1
"923400611",35,2810.9072550196,3111.26928282576,2450.1860183293,20,15,1,1
"923400612",65,3046.53496246095,2977.02319650123,2780.67589681985,33,32,1,1
"923400613",27,2242.19190969195,2323.2992906,2323.60649590586,14,13,1,1
"923400614",65,3271.11122548668,3238.72705318153,2780.67589681985,33,32,1,1
"923400615",28,2376.82406165198,2177.43334512359,2340.94327947849,15,13,1,1
"923400616",68,2919.19831256847,2573.50457512988,2806.43931339586,32,36,1,1
"923400617",77,4003.55238617242,4110.05133599391,2878.65357631343,47,30,1,1
"923400618",34,2511.72851407486,2537.07237314086,2435.71163614839,21,13,1,1
"923400619",77,3888.00096067237,5112.50690971123,2878.65357631343,42,35,1,1
"923400620",36,2647.07267176879,2824.21416805176,2464.33502634194,22,14,1,1
"923400621",44,2950.82628369787,3364.93120606031,2567.51523707907,23,21,1,1
"923400622",57,3037.19619035486,2461.01740496646,2707.02236739438,31,26,1,1
"923400623",77,3764.46656397244,4441.14379705161,2878.65357631343,43,34,1,1
"923400624",51,2987.42273610652,2940.01784421292,2646.17454577679,29,22,1,1
"923400625",52,3092.09010782786,3236.46842288314,2656.6981055205,22,30,1,1
"923400626",51,3330.21330756043,3541.90809002116,2646.17454577679,27,24,1,1
"923400627",21,2175.71346868909,2201.11164761516,2207.26116887512,9,12,1,1
"923400628",30,2319.19461963385,2415.38742105491,2374.18906024059,16,14,1,1
"923400629",23,2217.39155221826,2128.72976762932,2248.68783741607,9,14,1,1
"923400630",69,3323.00116939714,3911.5773204458,2814.82611826518,38,31,1,1
"923400631",66,3580.22209729521,3895.41199228318,2789.3669207067,35,31,1,1
"923400632",57,3399.12434172585,3075.78551936783,2707.02236739438,32,25,1,1
"923400633",69,3720.20085626455,3136.84439269877,2814.82611826518,33,36,1,1
"923400634",58,2906.93024517146,2832.38853606868,2716.66249357165,24,34,1,1
"923400635",28,2386.90759317281,2467.15856320257,2340.94327947849,9,19,1,1
"923400636",34,2477.66087958635,2597.43548359539,2435.71163614839,15,19,1,1
"923400637",37,2763.4784431154,2713.78061118865,2478.17471526668,23,14,1,1
"923400638",35,2390.53536700915,2389.59642367946,2450.1860183293,18,17,1,1
"923400639",34,2667.74515785823,2637.89055325583,2435.71163614839,20,14,1,1
"923400640",43,2767.16713140373,2788.13932028174,2555.47878346624,20,23,1,1
"923400641",75,3360.76174732736,3360.91259442636,2863.21031780169,39,36,1,1
"923400642",53,3068.77885922139,3394.17667177207,2667.061866114,23,30,1,1
"923400643",68,3307.43399855348,3748.18494532041,2806.43931339586,41,27,1,1
"923400644",50,3305.35255803122,3304.81252215877,2635.48551585152,27,23,1,1
"923400645",49,3196.86309734174,3074.37607675103,2624.62502504328,28,21,1,1
"923400646",47,3194.51239933403,3459.14041118034,2602.36394728806,26,21,1,1
"923400647",15,2282.35753460296,2486.66130575052,2060.56118614118,9,6,1,1
"923400648",48,2968.2513082963,3045.56661472452,2613.58673801098,20,28,1,1
"923400649",39,2812.09856577994,3371.98932492419,2504.98447234734,16,23,1,1
"923400650",40,2769.93472531472,2937.52972417055,2517.98110851286,25,15,1,1
"923400651",50,3271.09736130563,3554.4462299107,2635.48551585152,26,24,1,1
"923400652",43,2761.85732614103,2676.025542912,2555.47878346624,21,22,1,1
"923400653",49,2859.56273680145,3389.24179626613,2624.62502504328,28,21,1,1
"923400654",40,2654.39356850491,2384.20480328995,2517.98110851286,18,22,1,1
"923400655",56,3521.27508965252,3200.76714682497,2697.24673169728,25,31,1,1
"923400656",46,2721.93635690611,2941.2565071861,2590.94954296761,26,20,1,1
"923400657",50,3335.08353438638,3327.1388540891,2635.48551585152,27,23,1,1
"923400658",56,3593.77894181494,4021.6549293892,2697.24673169728,28,28,1,1
"923400659",47,3030.94904464606,3035.60994783829,2602.36394728806,24,23,1,1
"923400660",52,2986.12957270475,2939.41883231359,2656.6981055205,24,28,1,1
"923400661",51,2979.0730447919,3319.21760499717,2646.17454577679,26,25,1,1
"923400662",49,3180.0875610038,3048.17310333641,2624.62502504328,25,24,1,1
"923400663",18,2191.28115645782,2017.70375878703,2138.79896507223,6,12,1,1
"923400664",38,2774.08473855249,2833.96514148005,2491.71993967651,22,16,1,1
"923400669",69,3323.25137374485,3053.03834500126,2814.82611826518,38,31,1,1
"923400670",38,2751.20539413421,2459.79433991667,2491.71993967651,18,20,1,1
"923400671",44,2940.26186409673,3088.42896010629,2567.51523707907,19,25,1,1
"923400672",44,3157.98794453181,3417.21503432782,2567.51523707907,24,20,1,1
"923400673",50,2957.46448198132,3251.16731160256,2635.48551585152,28,22,1,1
"923400674",50,3015.66394587954,3313.36702257162,2635.48551585152,27,23,1,1
"923400675",40,2702.03428950783,2992.92073243065,2517.98110851286,22,18,1,1
"923400676",44,3017.38631181835,2975.34878442709,2567.51523707907,27,17,1,1
"923400677",63,3182.59834296051,3019.07485305231,2762.96971264875,32,31,1,1
"923400678",54,2847.48828960706,3497.58650394571,2677.2712016452,28,26,1,1
"923400679",39,2975.74702214383,3921.21659852834,2504.98447234734,23,16,1,1
"923400680",23,2524.46390858671,2558.41643780625,2248.68783741607,14,9,1,1
"923400690",47,2334.94152866731,1669.74168130225,2602.36394728806,26,21,1,1
"923400709",27,2150.05941968951,2308.03612330581,2323.60649590586,16,11,1,1
"923400944",79,3133.87497851513,2460.90003816613,2893.78092561085,44,35,1,1
"923400960",29,2339.37758267245,2224.33928422962,2357.79423966008,15,14,1,1
"923400961",31,2445.92556118072,2267.20638801045,2390.15469389133,16,15,1,1
"923400962",32,2505.01619273333,2354.02256710249,2405.71569249515,15,17,1,1
"923400963",30,2412.61373198022,2233.8685317356,2374.18906024059,13,17,1,1
"923400964",31,2301.25719566475,1951.43962861962,2390.15469389133,15,16,1,1
"923400965",34,2297.10260258083,2427.98830910481,2435.71163614839,18,16,1,1
"923400966",39,2536.49075006613,2208.614328539,2504.98447234734,19,20,1,1
"923400967",37,2468.53769739435,2021.75830456695,2478.17471526668,20,17,1,1
"923400968",38,2497.81195196375,2575.08252614147,2491.71993967651,20,18,1,1
"923400969",30,2415.1014872918,2359.2157311289,2374.18906024059,15,15,1,1
"923400970",34,2511.69282667267,2279.27847182037,2435.71163614839,19,15,1,1
"923400971",22,2177.57161817814,1830.9684691227,2228.3491786518,15,7,1,1
"923400972",35,2534.6291267195,2283.58433101884,2450.1860183293,19,16,1,1
"923400973",30,2249.60363772699,2121.24514196491,2374.18906024059,17,13,1,1
"923400974",26,2219.90867894454,1899.02651100857,2305.75108410937,13,13,1,1
"923400975",38,2371.85132064375,2018.23574691002,2491.71993967651,21,17,1,1
"923400976",30,2499.76961813103,2342.31398548319,2374.18906024059,15,15,1,1
"923400977",29,2411.77853457485,2192.88611130594,2357.79423966008,14,15,1,1
"923400978",30,2503.17162739617,1985.44909324643,2374.18906024059,15,15,1,1
"923400979",30,2566.57942880304,2459.98616297303,2374.18906024059,16,14,1,1
"923400980",29,2397.46352034252,2149.40910550215,2357.79423966008,13,16,1,1
"923400981",37,2575.215274779,2294.81193316586,2478.17471526668,17,20,1,1
"923400982",36,2492.34255217963,2116.53058008215,2464.33502634194,18,18,1,1
"923400983",28,2278.9413825377,2081.76042462535,2340.94327947849,14,14,1,1
"923400984",28,2439.1754462122,2453.77323532917,2340.94327947849,15,13,1,1
"923400985",26,2222.07991473808,2004.92651733393,2305.75108410937,14,12,1,1
"923400986",37,2377.66891918381,2115.47266892399,2478.17471526668,18,19,1,1
"923400989",31,2554.12785405373,2520.92448594536,2390.15469389133,14,17,1,1
"923400990",27,2528.80293225803,2644.28001602295,2323.60649590586,11,16,1,1
"923400991",27,2570.56977696224,2451.97979542053,2323.60649590586,15,12,1,1
"923400992",39,2608.44518356786,2797.79846293905,2504.98447234734,19,20,1,1
"923400993",36,2418.35672123844,1923.4307729363,2464.33502634194,17,19,1,1
"923400994",20,2255.5169181458,2362.75869055189,2185.35845629437,11,9,1,1
"923400995",39,2581.53227711415,2778.02318434651,2504.98447234734,15,24,1,1
"923400996",21,2309.01225876122,2319.86685570219,2207.26116887512,11,10,1,1
"923400997",37,2606.86885816971,2331.76148716932,2478.17471526668,19,18,1,1
"923400998",30,2749.1250195018,2641.87530375453,2374.18906024059,14,16,1,1
"923400999",32,2477.28720824086,2557.25073437887,2405.71569249515,16,16,1,1
"923401000",28,2452.72804992577,2575.39302293098,2340.94327947849,14,14,1,1
"923401001",26,2460.65473554622,2534.95272921116,2305.75108410937,13,13,1,1
"923401002",30,2548.14809984662,2755.96338002655,2374.18906024059,14,16,1,1
"923401003",33,2673.38894681936,2538.7199142303,2420.89448855093,15,18,1,1
"923401004",27,2519.61465417412,2515.4681704042,2323.60649590586,13,14,1,1
"923401005",35,2553.48078073549,2521.04984135507,2450.1860183293,19,16,1,1
"923401006",19,2200.44426920679,2254.5751028218,2162.56636020013,9,10,1,1
"923401007",36,2743.8785784035,2619.29541723308,2464.33502634194,21,15,1,1
"923401008",34,2428.85958815501,2445.52171350961,2435.71163614839,15,19,1,1
"923401009",28,2690.26916281334,2806.53079102803,2340.94327947849,15,13,1,1
"923401010",36,2579.0660462528,2819.90357507158,2464.33502634194,14,22,1,1
"923401011",36,2571.79561263594,2524.30507805535,2464.33502634194,14,22,1,1
"923401012",26,2491.19684707676,2522.04741056077,2305.75108410937,12,14,1,1
"923401013",28,2402.90340242848,2499.61315887481,2340.94327947849,15,13,1,1
"923401014",12,1955.2708437838,1844.26145680388,1968.69006049611,7,5,1,1
"923401015",32,2429.64287114739,2181.10956655375,2405.71569249515,17,15,1,1
"923401016",40,2577.45913332352,2511.156281728,2517.98110851286,20,20,1,1
"923401033",17,2298.02960313195,2169.72808271681,2113.95669457394,10,7,1,1
"923401034",15,2234.44492866921,2108.65405239135,2060.56118614118,8,7,1,1
"923401035",19,2234.58236056748,2258.41728513521,2162.56636020013,14,5,1,1
"923401036",15,2166.37146941568,2167.80490235195,2060.56118614118,7,8,1,1
"923401245",36,2855.69699522859,3351.87180981468,2464.33502634194,19,17,1,1
"923401246",49,3045.90551810856,3640.32845751711,2624.62502504328,25,24,1,1
"923401247",23,2593.47415956299,2967.9331725554,2248.68783741607,13,10,1,1
"923401248",42,2615.76697641274,2721.25824482084,2543.21752514954,20,22,1,1
"923401249",39,2912.94423607934,3521.62974218308,2504.98447234734,24,15,1,1
"923401250",42,3144.46952249187,4158.76211544443,2543.21752514954,18,24,1,1
"923401251",31,2341.70292752036,2409.69911253544,2390.15469389133,17,14,1,1
"923401252",20,2128.0182617264,2538.61387001675,2185.35845629437,6,14,1,1
"923401253",39,2784.0934570331,3511.40535472817,2504.98447234734,22,17,1,1
"923401254",31,2356.71679137285,2865.16196098463,2390.15469389133,14,17,1,1
"923401256",26,2317.88471919594,1989.73809351565,2305.75108410937,14,12,1,1
"923401257",36,2440.03697253537,2949.23182295871,2464.33502634194,18,18,1,1
"923401258",46,3390.1126940358,4803.43613787105,2590.94954296761,26,20,1,1
"923401259",35,2641.67054521414,3329.5860512847,2450.1860183293,21,14,1,1
"923401260",34,2467.19065070659,3002.92871635737,2435.71163614839,17,17,1,1
"923401261",36,2724.91029103364,3263.21179117314,2464.33502634194,19,17,1,1
"923401262",41,2866.27721999946,3335.61093707438,2530.72175773865,22,19,1,1
"923401263",37,2653.45239200667,3290.05309859846,2478.17471526668,21,16,1,1
"923401264",31,2450.46399054476,2836.4253217335,2390.15469389133,15,16,1,1
"923401265",46,3061.76298039524,3971.5272884394,2590.94954296761,24,22,1,1
"923401266",44,2917.34795920237,3133.84767537818,2567.51523707907,25,19,1,1
"923401267",46,3085.04052455842,4316.06829921283,2590.94954296761,25,21,1,1
"923401268",43,3206.29456877645,4304.6886642134,2555.47878346624,26,17,1,1
"923401269",46,2598.51809074124,2575.62122754862,2590.94954296761,22,24,1,1
"923401270",23,2410.76426476392,3166.84300413006,2248.68783741607,14,9,1,1
"923401271",35,2451.96615738797,2242.6316497122,2450.1860183293,14,21,1,1
"923401272",42,3007.54559362539,4103.12710681104,2543.21752514954,25,17,1,1
"923401273",34,2744.59123352096,3624.48166134818,2435.71163614839,20,14,1,1
"923401274",39,2673.5871759787,2917.62083662843,2504.98447234734,22,17,1,1
"923401275",47,3516.26619015568,4087.01633569898,2602.36394728806,29,18,1,1
"923401276",38,2338.10944432582,2798.19656525546,2491.71993967651,22,16,1,1
"923401277",35,2797.44560983911,3342.53159554874,2450.1860183293,24,11,1,1
"923401278",68,3277.99762824381,3819.46539177208,2806.43931339586,38,30,1,1
"923401279",45,2868.29281143931,2767.60523825452,2579.33597919865,26,19,1,1
"923401280",53,3141.26157477961,4501.89882628852,2667.061866114,27,26,1,1
"923401281",43,3071.50841358125,3332.55718439181,2555.47878346624,24,19,1,1
"923401282",48,3001.68682009658,3774.18402541187,2613.58673801098,27,21,1,1
"923401283",47,3276.1668032502,4155.2128206025,2602.36394728806,26,21,1,1
"923401284",50,3221.31939646761,3524.5233673505,2635.48551585152,27,23,1,1
"923401285",29,2712.77318612109,3472.11772672832,2357.79423966008,19,10,1,1
"923401286",41,3218.67606866988,2564.69144949721,2530.72175773865,21,20,1,1
"923401287",47,3110.68122132288,3861.92275502953,2602.36394728806,25,22,1,1
"923401288",49,3233.83711027166,3466.7048425932,2624.62502504328,26,23,1,1
"923401289",35,2710.68319395741,3121.62965330197,2450.1860183293,20,15,1,1
"923401290",32,2976.36864325821,3345.8604929498,2405.71569249515,21,11,1,1
"923401291",38,2819.11372836257,3066.12722721568,2491.71993967651,21,17,1,1
"923401292",48,2540.75849769368,2566.25823461241,2613.58673801098,22,26,1,1
"923401293",28,2300.88236516649,1845.76076779711,2340.94327947849,18,10,1,1
"923401294",32,2573.18892086225,3250.92429093075,2405.71569249515,21,11,1,1
"923401295",41,3123.33227290951,3829.18625469827,2530.72175773865,24,17,1,1
"923401296",48,3089.80291872769,4006.22163749197,2613.58673801098,25,23,1,1
"923401297",48,3117.39778805284,4390.96164489957,2613.58673801098,27,21,1,1
"923401298",36,2631.50722280469,2868.75839445178,2464.33502634194,20,16,1,1
"923401299",34,2905.84859407981,3510.45740996528,2435.71163614839,20,14,1,1
"923401300",41,2961.20187541997,3999.31170247653,2530.72175773865,21,20,1,1
"923401301",59,3427.17506761815,3725.27040556326,2726.17127719361,29,30,1,1
"923401302",48,2930.66684713757,4003.64188273257,2613.58673801098,24,24,1,1
"923401303",52,3197.06630169691,4593.08244569343,2656.6981055205,28,24,1,1
"923401305",55,3236.7813731649,3960.19611897963,2687.33120998132,29,26,1,1
"923401306",33,2734.3600952493,3751.40042010165,2420.89448855093,19,14,1,1
"923401307",42,2518.29488297948,2321.5171423589,2543.21752514954,23,19,1,1
"923401308",33,2880.29850274162,3456.04381858329,2420.89448855093,19,14,1,1
"923401309",35,3280.69954399704,3789.46001962201,2450.1860183293,15,20,1,1
"923401310",50,2945.78320950093,3486.27707522905,2635.48551585152,30,20,1,1
"923401312",89,3170.1650264131,2854.39240844707,2965.14449011489,41,48,1,1
"923401313",74,3872.22322061939,3640.68706866051,2855.36548874306,42,32,1,1
"923401314",51,2770.14524820592,2385.27306158425,2646.17454577679,29,22,1,1
"923401315",69,3447.4652824135,2973.57896285308,2814.82611826518,36,33,1,1
"923401316",37,2698.87315998958,2696.25465104661,2478.17471526668,20,17,1,1
"923401317",68,3155.35550780593,3355.06040868005,2806.43931339586,37,31,1,1
"923401318",41,3302.53371247814,3818.90211689026,2530.72175773865,20,21,1,1
"923401319",59,3573.31542983275,3734.82396476036,2726.17127719361,30,29,1,1
"923401320",50,2903.91843882083,3803.45568903633,2635.48551585152,24,26,1,1
"923401426",45,3356.70689134256,3542.12138861692,2579.33597919865,17,28,1,1
"923401427",36,2521.82660467792,2456.15675474683,2464.33502634194,23,13,1,1
"923401428",39,2743.72889841813,2558.73653115839,2504.98447234734,18,21,1,1
"923401429",30,2731.24224516855,3000.57651583501,2374.18906024059,16,14,1,1
"923401430",34,2695.73009235133,2902.37186581038,2435.71163614839,18,16,1,1
"923401431",64,2834.31496837418,2234.04684636951,2771.87783482774,35,29,1,1
"923401432",21,2288.87818054576,2195.36190830451,2207.26116887512,11,10,1,1
"923401433",40,2934.2649018121,2797.0622134826,2517.98110851286,21,19,1,1
"923401434",40,2831.20313472216,2883.39510251417,2517.98110851286,22,18,1,1
"923401435",25,2380.55115351672,2258.32321108091,2287.34065519221,15,10,1,1
"923401436",38,2732.44448985703,2484.80697569524,2491.71993967651,18,20,1,1
"923401437",23,2427.58054431766,2483.34786017634,2248.68783741607,12,11,1,1
"923401439",31,2585.57044992993,2644.44905087871,2390.15469389133,16,15,1,1
"923401440",57,3374.43665676284,3754.32192498792,2707.02236739438,29,28,1,1
"923401441",31,2889.38258689073,3202.66979473581,2390.15469389133,17,14,1,1
"923401442",39,2854.50596533411,2823.71972765668,2504.98447234734,23,16,1,1
"923401443",31,2848.65650497467,2903.31506490454,2390.15469389133,12,19,1,1
"923401444",38,3059.28170750067,2978.87573433528,2491.71993967651,20,18,1,1
"923401445",24,2313.53437327078,2169.98944384265,2268.33468283819,14,10,1,1
"923401446",43,2704.92659505272,3328.51783211837,2555.47878346624,16,27,1,1
"923401447",27,2555.39125957239,2820.50501948033,2323.60649590586,11,16,1,1
"923401449",34,2794.32112037656,3184.31431210408,2435.71163614839,21,13,1,1
"923401450",42,2964.68512551664,2974.67024537484,2543.21752514954,22,20,1,1
"923401451",47,2874.96768633877,2685.88541017153,2602.36394728806,21,26,1,1
"923401452",39,2813.68309784688,3454.66856744992,2504.98447234734,18,21,1,1
"923401453",54,3209.89047379432,2829.56724262524,2677.2712016452,25,29,1,1
"923401454",51,3081.40483168618,2954.4704027271,2646.17454577679,24,27,1,1
"923401455",47,2963.50274460567,2654.52260148814,2602.36394728806,24,23,1,1
"923401456",41,2759.19808659846,2897.17406377247,2530.72175773865,19,22,1,1
"923401457",29,2921.76309432578,3037.55637538875,2357.79423966008,14,15,1,1
"923401458",48,3276.25967973408,3389.50894540083,2613.58673801098,24,24,1,1
"923401459",34,2745.73590190113,2443.15228273415,2435.71163614839,17,17,1,1
"923401460",35,2823.12466316497,2573.26308554879,2450.1860183293,17,18,1,1
"923401461",37,3060.13344570565,2826.97007527048,2478.17471526668,23,14,1,1
"923401462",37,2749.92003263723,2560.56056050868,2478.17471526668,18,19,1,1
"923401463",41,2806.01551559032,2899.44214048612,2530.72175773865,26,15,1,1
"923401464",37,2862.63876308332,3337.52095725801,2478.17471526668,19,18,1,1
"923401465",59,3273.36734750751,3648.00526164745,2726.17127719361,31,28,1,1
"923401466",43,2740.27330130879,2805.92212777653,2555.47878346624,25,18,1,1
"923401467",21,2476.48445829507,2904.46818792333,2207.26116887512,13,8,1,1
"923401468",32,2742.40698412307,2835.23537026786,2405.71569249515,16,16,1,1
"923401469",40,2728.24695025279,3077.25436206445,2517.98110851286,20,20,1,1
"923401470",56,3211.08163383179,3835.06339752693,2697.24673169728,28,28,1,1
"923401471",36,2627.87408821691,2645.84733496588,2464.33502634194,22,14,1,1
"923401472",49,3091.88829077389,3341.2040542252,2624.62502504328,24,25,1,1
"923401473",46,2864.64409407072,3053.04548088095,2590.94954296761,28,18,1,1
"923401474",31,2868.78097080576,2915.12922568545,2390.15469389133,17,14,1,1
"923401475",51,3605.34615851477,3554.10530717993,2646.17454577679,26,25,1,1
"923401476",36,2796.92395737869,2785.18256824674,2464.33502634194,17,19,1,1
"923401477",37,2491.72067285511,2622.2920074949,2478.17471526668,18,19,1,1
"923401478",24,2399.56274951028,2392.10609378509,2268.33468283819,12,12,1,1
"923401479",32,2586.64947181513,2042.59212029705,2405.71569249515,16,16,1,1
"923401480",44,3174.81325065142,2882.25588671284,2567.51523707907,21,23,1,1
"923401481",44,2923.88385654237,2851.79265325649,2567.51523707907,27,17,1,1
"923401482",43,3065.97031917865,2799.50673574745,2555.47878346624,18,25,1,1
"923401483",44,2784.9874506066,2692.61040578835,2567.51523707907,19,25,1,1
"923401484",29,2716.32694305401,2757.26668446164,2357.79423966008,15,14,1,1
"923401485",38,2647.40759608276,2913.64863915754,2491.71993967651,18,20,1,1
"923401486",35,2710.76595282114,2870.02504951315,2450.1860183293,15,20,1,1
"923401487",28,2533.65660385707,2339.02052109069,2340.94327947849,14,14,1,1
"923401488",24,2479.76540307074,2440.59638065697,2268.33468283819,14,10,1,1
"923401489",35,2547.05362223149,2374.05301601235,2450.1860183293,22,13,1,1
"923401490",43,2674.35485378308,3062.7565093139,2555.47878346624,26,17,1,1
"923401491",47,3542.9853456597,3265.34774135821,2602.36394728806,23,24,1,1
"923401492",24,2463.16799020081,2979.56773950265,2268.33468283819,10,14,1,1
"923401493",54,3076.06870492199,2200.49840455428,2677.2712016452,23,31,1,1
"923401494",41,2956.78481943599,3073.55523652185,2530.72175773865,15,26,1,1
"923401495",34,2786.76559034557,2478.91757545471,2435.71163614839,17,17,1,1
"923401496",55,3045.90331901975,3023.73151996404,2687.33120998132,27,28,1,1
"923401497",49,2948.81755868199,2643.95475872481,2624.62502504328,24,25,1,1
"923401498",40,2728.62882875846,2566.85716141856,2517.98110851286,20,20,1,1
"923401499",33,2749.43287345032,2515.57460121806,2420.89448855093,15,18,1,1
"923401500",56,2878.85856277682,3033.05334936615,2697.24673169728,29,27,1,1
"923401501",37,2565.0918836421,2555.29205206513,2478.17471526668,16,21,1,1
"923401502",23,2302.18955975888,2402.1375756972,2248.68783741607,8,15,1,1
"923401503",27,2409.83165269301,2435.51599653313,2323.60649590586,17,10,1,1
"923401504",34,2740.13213687245,2676.94474100329,2435.71163614839,14,20,1,1
"923401505",40,3079.45518847697,3088.94526317302,2517.98110851286,22,18,1,1
"923401506",31,2482.01534457177,2467.00308134529,2390.15469389133,17,14,1,1
"923401507",48,3144.67378519708,3431.64079480525,2613.58673801098,20,28,1,1
"923401508",29,2439.92203092644,2496.73342360896,2357.79423966008,14,15,1,1
"923401509",42,2989.4221118805,3098.29034185203,2543.21752514954,15,27,1,1
"923401510",32,2740.24478748707,3278.72961850642,2405.71569249515,12,20,1,1
"923401511",51,2979.53328936786,2475.1769856753,2646.17454577679,26,25,1,1
"923401512",38,2551.28152861153,2666.63773317862,2491.71993967651,15,23,1,1
"923401513",26,2547.96022574809,2740.75069358627,2305.75108410937,11,15,1,1
"923401514",34,2770.67141440714,2372.33892731909,2435.71163614839,18,16,1,1
"923401515",30,2509.93386793391,2830.23088788765,2374.18906024059,13,17,1,1
"923401516",48,2965.53050494073,2919.84573318338,2613.58673801098,31,17,1,1
"923401517",35,2697.92097351215,2689.78863513939,2450.1860183293,21,14,1,1
"923401518",45,2943.66079175357,3412.95800045439,2579.33597919865,23,22,1,1
"923401519",42,3103.81503262645,3214.23988926024,2543.21752514954,23,19,1,1
"923401520",51,3139.58938190579,3433.73413000761,2646.17454577679,29,22,1,1
"923401521",64,3717.75229708832,3889.81522625873,2771.87783482774,42,22,1,1
"923401522",40,2862.96837865628,2896.11161712836,2517.98110851286,18,22,1,1
"923401523",38,2921.348481062,2865.24879697248,2491.71993967651,22,16,1,1
"923401524",36,2668.32250458836,2679.63636989958,2464.33502634194,17,19,1,1
"923401525",42,2751.83427474056,2569.05056084244,2543.21752514954,22,20,1,1
"923401526",49,3075.52180638202,3325.20734592028,2624.62502504328,24,25,1,1
"923401527",37,2701.31999159461,2612.96689485529,2478.17471526668,17,20,1,1
"923401528",26,2552.9629338638,2695.48953101004,2305.75108410937,12,14,1,1
"923401529",26,2283.74060923539,2395.49414567911,2305.75108410937,15,11,1,1
"923401530",51,3159.76890912181,3118.38483430271,2646.17454577679,23,28,1,1
"923401531",31,2901.13658367489,3103.75662193087,2390.15469389133,13,18,1,1
"923401532",26,2563.63411130971,2849.86210492063,2305.75108410937,11,15,1,1
"923401533",46,3106.24991536208,3552.98497756919,2590.94954296761,21,25,1,1
"923401534",44,2943.33314989793,2788.27421973944,2567.51523707907,26,18,1,1
"923401535",34,2978.82835295017,3488.73690648476,2435.71163614839,14,20,1,1
"923401537",47,2916.58710053381,3147.15445673954,2602.36394728806,23,24,1,1
"923401538",36,2389.43017163594,2329.39569657423,2464.33502634194,20,16,1,1
"923401539",36,2622.99477933894,3020.23139789236,2464.33502634194,23,13,1,1
"923401540",34,2638.31194478768,2412.5436963007,2435.71163614839,16,18,1,1
"923401541",44,3193.61017059006,3406.84648996711,2567.51523707907,22,22,1,1
"923401542",68,2994.20044441222,2244.70029443944,2806.43931339586,42,26,1,1
"923401543",25,2778.03355130862,2907.55683123141,2287.34065519221,16,9,1,1
"923401544",42,2756.2138966353,2733.01400210401,2543.21752514954,22,20,1,1
"923401545",42,2970.54778532957,3376.12743415211,2543.21752514954,22,20,1,1
"923401546",34,2812.96802494042,2817.51926523552,2435.71163614839,20,14,1,1
"923401547",37,2435.84874947605,2227.64817138372,2478.17471526668,23,14,1,1
"923401548",32,2670.36326194695,2596.82305869588,2405.71569249515,13,19,1,1
"923401549",43,2782.10156934756,2512.42100869101,2555.47878346624,19,24,1,1
"923401550",46,3044.76160445461,2845.74851013992,2590.94954296761,25,21,1,1
"923401551",41,2557.68749317106,2159.41049648472,2530.72175773865,21,20,1,1
"923401552",49,3036.3928099913,2817.82894702594,2624.62502504328,30,19,1,1
"923401553",41,2816.04169999212,2760.61735267272,2530.72175773865,29,12,1,1
"923401554",30,2646.61378602509,2687.48392972252,2374.18906024059,20,10,1,1
"923401555",35,2593.31397371565,2488.41600506267,2450.1860183293,16,19,1,1
"923401556",33,2884.63012864249,3121.36800531581,2420.89448855093,17,16,1,1
"923401557",48,3096.88260614098,3443.65050518419,2613.58673801098,22,26,1,1
"923401558",52,3220.41248319312,3272.01168449117,2656.6981055205,20,32,1,1
"923401559",41,2693.39469610752,2709.33023522056,2530.72175773865,23,18,1,1
"923401560",33,2863.15012283515,3064.28411032759,2420.89448855093,17,16,1,1
"923401561",45,2915.55691534427,2927.51554495767,2579.33597919865,21,24,1,1
"923401562",38,2921.40321241005,2626.30655160102,2491.71993967651,14,24,1,1
"923401563",58,3193.25768113607,3353.93654395551,2716.66249357165,26,32,1,1
"923401564",31,2787.26981553789,3142.60997881701,2390.15469389133,18,13,1,1
"923401565",40,2654.57821128307,2470.93510519677,2517.98110851286,12,28,1,1
"923401566",41,2791.12501069106,2829.27950496934,2530.72175773865,17,24,1,1
"923401567",47,3185.07131302777,3205.10182415845,2602.36394728806,23,24,1,1
"923401569",44,3126.06114945948,3163.30733216567,2567.51523707907,20,24,1,1
"923401570",42,2535.63721700097,2487.79355958313,2543.21752514954,24,18,1,1
"923401571",42,2599.18984835122,2356.1582552302,2543.21752514954,20,22,1,1
"923401572",50,3766.19281552195,3972.70536210027,2635.48551585152,26,24,1,1
"923401573",31,2748.08790324174,2912.77841328908,2390.15469389133,11,20,1,1
"923401574",56,3438.12375853424,3637.08081132596,2697.24673169728,32,24,1,1
"923401575",29,2365.20965486521,2578.01587697683,2357.79423966008,13,16,1,1
"923401576",39,2922.50199956689,2675.6750602986,2504.98447234734,18,21,1,1
"923401577",36,2844.74434426657,3111.97449451806,2464.33502634194,14,22,1,1
"923401578",47,3021.95103273887,2615.84411970455,2602.36394728806,23,24,1,1
"923401579",59,3292.11626413949,3280.341042418,2726.17127719361,34,25,1,1
"923401580",31,2686.87577930661,3076.934994458,2390.15469389133,19,12,1,1
"923401581",29,2674.74874720178,2577.48854841697,2357.79423966008,13,16,1,1
"923401582",44,3295.24379798207,3229.72038355245,2567.51523707907,25,19,1,1
"923401583",41,3280.03132714232,3387.2852610445,2530.72175773865,24,17,1,1
"923401584",40,3339.38935325841,3634.94488369488,2517.98110851286,18,22,1,1
"923401585",30,2451.77796211871,2913.33597318214,2374.18906024059,13,17,1,1
"923401586",42,2796.58816528725,3016.14823385963,2543.21752514954,19,23,1,1
"923401587",35,2566.48350686371,2493.49714493672,2450.1860183293,22,13,1,1
"923401588",14,1941.99848429266,1948.37761304806,2031.70713799962,7,7,1,1
"923401589",34,2982.8174325562,3056.60183018707,2435.71163614839,17,17,1,1
"923401590",44,2825.47447474265,2916.08164839549,2567.51523707907,22,22,1,1
"923401591",42,2958.42413210816,2874.56448067727,2543.21752514954,17,25,1,1
"923401592",32,2755.42098039849,3087.50987110795,2405.71569249515,15,17,1,1
"923401593",38,2833.90924770581,2863.71839408264,2491.71993967651,25,13,1,1
"923401594",41,2888.23967281364,3302.8425184885,2530.72175773865,17,24,1,1
"923401595",54,3329.66920359115,3258.10563536876,2677.2712016452,26,28,1,1
"923401596",35,2917.97460437728,2949.92471822814,2450.1860183293,20,15,1,1
"923401597",42,3282.63543522545,3537.87962354462,2543.21752514954,21,21,1,1
"923401598",41,2706.77120867005,2811.9014698625,2530.72175773865,22,19,1,1
"923401599",32,2915.26083807647,2463.12098825467,2405.71569249515,17,15,1,1
"923401600",54,3026.67792899319,3218.27253056111,2677.2712016452,29,25,1,1
"923401601",29,2356.25908396199,2275.13379614073,2357.79423966008,14,15,1,1
"923401602",57,2659.06746673117,2157.04269143969,2707.02236739438,26,31,1,1
"923401603",25,2510.88578553191,2511.82652299196,2287.34065519221,13,12,1,1
"923401604",37,2550.21098220597,2746.7299047689,2478.17471526668,24,13,1,1
"923401606",35,2920.17141691621,2865.74438450726,2450.1860183293,17,18,1,1
"923401607",41,2897.13281331912,2926.4040021266,2530.72175773865,19,22,1,1
"923401608",31,2823.27805216753,2668.50787826853,2390.15469389133,14,17,1,1
"923401609",34,2976.83860145067,3209.95726783038,2435.71163614839,15,19,1,1
"923401610",31,2769.09278718051,2868.83126741636,2390.15469389133,15,16,1,1
"923401611",25,2570.1791713303,2455.14204363623,2287.34065519221,12,13,1,1
"923401612",49,2793.81406025303,2922.18705034308,2624.62502504328,22,27,1,1
"923401613",42,2829.69942652834,2817.23503178219,2543.21752514954,24,18,1,1
"923401614",28,2555.5209599021,2688.74269842939,2340.94327947849,14,14,1,1
"923401615",19,2151.66672682417,2221.39178922265,2162.56636020013,10,9,1,1
"923401616",31,2573.00454303727,2560.662108605,2390.15469389133,19,12,1,1
"923401617",34,2792.22623483544,3100.05413928813,2435.71163614839,14,20,1,1
"923401618",40,2840.13596408379,2659.91892588521,2517.98110851286,24,16,1,1
"923401619",36,2664.83269511627,2576.02874355185,2464.33502634194,19,17,1,1
"923401620",37,2770.15906113109,2359.975127191,2478.17471526668,19,18,1,1
"923401621",41,3072.37748347578,3090.1444815739,2530.72175773865,19,22,1,1
"923401622",48,2857.83459464805,3144.61453677163,2613.58673801098,30,18,1,1
"923401623",27,2661.78432899638,2406.15477085405,2323.60649590586,13,14,1,1
"923401624",38,2751.47404101064,2796.90283933109,2491.71993967651,18,20,1,1
"923401625",42,3116.64391307132,2919.88477793449,2543.21752514954,21,21,1,1
"923401626",36,2913.6277678185,3066.04832290376,2464.33502634194,18,18,1,1
"923401627",42,2642.74168870975,2474.42517046381,2543.21752514954,22,20,1,1
"923401628",36,2497.85970090284,2872.22167234888,2464.33502634194,18,18,1,1
"923401629",48,3285.53778984998,3894.75374242565,2613.58673801098,19,29,1,1
"923401730",57,2921.63623644101,3032.8029370546,2707.02236739438,34,23,1,1
"923401731",42,3003.71959796834,3461.6541709369,2543.21752514954,26,16,1,1
"923401732",45,3177.85956966438,3709.69770271454,2579.33597919865,33,12,1,1
"923401733",40,2902.25548252736,3302.82280586032,2517.98110851286,27,13,1,1
"923401734",37,2814.44950318063,2901.9541204038,2478.17471526668,24,13,1,1
"923401735",52,2960.78485051046,3264.04362573678,2656.6981055205,31,21,1,1
"923401736",47,3144.66021208537,3876.05068130259,2602.36394728806,31,16,1,1
"923401737",46,2640.75026527273,3342.43249313129,2590.94954296761,32,14,1,1
"923401738",41,2751.09789800665,3033.84643298407,2530.72175773865,28,13,1,1
"923401739",73,3800.08300909379,3616.44675175666,2847.4358582506,43,30,1,1
"923401740",44,2804.88915449706,3080.02355691238,2567.51523707907,29,15,1,1
"923401759",43,2436.16901370111,2162.5495711758,2555.47878346624,23,20,1,1
"923401760",53,3315.20249589812,3437.48384479562,2667.061866114,30,23,1,1
"923401761",68,3298.3890938199,3120.50147450058,2806.43931339586,33,35,1,1
"923401762",65,2985.69152289075,2397.07359313831,2780.67589681985,33,32,1,1
"923401763",84,3451.60813470752,3539.78345131608,2930.30814451558,40,44,1,1
"923401764",58,3136.53459362181,2408.28564535491,2716.66249357165,33,25,1,1
"923401765",81,3656.99266995038,3463.52078931047,2908.60658576875,40,41,1,1
"923401766",78,3968.57182734882,4144.44036871833,2886.25582696583,36,42,1,1
"923401767",63,3333.66898590019,2745.4918405145,2762.96971264875,37,26,1,1
"923401768",65,2943.50270234541,2812.52763863101,2780.67589681985,29,36,1,1
"923401769",59,3475.666158222,3212.18419999728,2726.17127719361,39,20,1,1
"923401770",69,3965.37895732984,3554.94529423972,2814.82611826518,38,31,1,1
"923401771",47,3157.54400113235,2661.48148397957,2602.36394728806,24,23,1,1
"923401772",65,3123.18418840313,2812.37110724548,2780.67589681985,32,33,1,1
"923401773",56,3166.29008226574,2614.76802799389,2697.24673169728,29,27,1,1
"923401774",71,3170.31734458316,3375.02716869626,2831.31372136695,43,28,1,1
"923401776",40,2632.7899236029,3504.66813547713,2517.98110851286,17,23,1,1
"923401795",26,2735.80119882114,2953.26928638129,2305.75108410937,12,14,1,1
"923401796",40,3026.90840825312,3392.4271326964,2517.98110851286,14,26,1,1
"923401797",32,2622.00912207492,2629.50048781277,2405.71569249515,10,22,1,1
"923401798",47,3346.11746886531,3549.80442746119,2602.36394728806,13,34,1,1
"923401799",43,3206.6075559526,3116.57523237183,2555.47878346624,13,30,1,1
"923401800",45,3016.57807133018,3476.53635605005,2579.33597919865,13,32,1,1
"923401801",47,2831.28729778601,3284.02163582058,2602.36394728806,17,30,1,1
"923401802",44,3059.31746777673,3387.85377847583,2567.51523707907,13,31,1,1
"923401803",37,2831.18336383157,3099.02901567739,2478.17471526668,16,21,1,1
"923401804",51,3170.3513299169,3074.68850680755,2646.17454577679,19,32,1,1
"923401805",26,2573.2158850939,2726.07598389732,2305.75108410937,9,17,1,1
"923401806",28,2570.1948752768,2417.87671260964,2340.94327947849,10,18,1,1
"923401807",46,2615.78817901009,2195.98915643763,2590.94954296761,16,30,1,1
"923401808",45,3335.13005602785,3461.48207184965,2579.33597919865,22,23,1,1
"923401924",46,3007.14384259977,3586.6328216017,2590.94954296761,24,22,1,1
"923401926",28,2155.19621257289,1936.46656521428,2340.94327947849,18,10,1,1
"923401927",20,1792.80469646233,1703.59534164184,2185.35845629437,9,11,1,1
"923402020",33,2562.74886672865,2506.91905867395,2420.89448855093,19,14,1,1
"923402021",30,2423.75585252429,2280.17454608707,2374.18906024059,17,13,1,1
"923402022",30,2436.38343519056,2574.19860217635,2374.18906024059,16,14,1,1
"923402023",35,2382.10722801162,2861.13077018794,2450.1860183293,20,15,1,1
"923402024",28,2352.47946617086,2325.76755673379,2340.94327947849,17,11,1,1
"923402025",26,2422.46006563681,2488.63328726458,2305.75108410937,14,12,1,1
"923402026",31,2226.06230357528,2459.61457959662,2390.15469389133,19,12,1,1
"923402027",12,1857.28193662807,1902.92493463831,1968.69006049611,8,4,1,1
"923402028",17,2188.85243262716,2196.21397121249,2113.95669457394,9,8,1,1
"923402029",27,2699.39942677982,3148.9368395588,2323.60649590586,15,12,1,1
"923402030",5,1581.7340083554,1631.06116539129,1646.12614877363,2,3,1,1
"923402031",31,2438.56678391686,2654.99199128724,2390.15469389133,17,14,1,1
"923402032",24,2330.06730865839,2536.6869436709,2268.33468283819,13,11,1,1
"923402033",14,1892.67500507505,1888.45117351377,2031.70713799962,11,3,1,1
"923402034",38,2660.35871626406,2356.00669670305,2491.71993967651,20,18,1,1
"923402035",6,1700.82493022798,1680.08608429343,1708.62817714657,3,3,1,1
"923402036",12,1723.749246488,1505.23714791107,1968.69006049611,6,6,1,1
"923402037",33,2582.40877715696,2759.8990616301,2420.89448855093,16,17,1,1
"923402038",24,2531.21639576324,2567.10362692882,2268.33468283819,12,12,1,1
"923402039",30,2678.34123231033,2665.25893704607,2374.18906024059,16,14,1,1
"923402040",28,2614.44322373342,2657.20049461549,2340.94327947849,13,15,1,1
"923402041",17,1773.40034906617,1701.34373975604,2113.95669457394,9,8,1,1
"923402042",9,1801.45648227142,1840.60998945897,1856.26587460569,7,2,1,1
"923402043",32,2633.16353354882,2717.31210843459,2405.71569249515,19,13,1,1
"923402044",10,1761.97495314586,1806.15040918942,1896.67490607898,7,3,1,1
"923402045",8,1741.74006332377,1715.49961389174,1812.11073017574,4,4,1,1
"923402046",13,1757.80564658252,1695.2471767086,2001.16379457045,8,5,1,1
"923402047",7,1694.66909728615,1629.70478509328,1763.32076508842,5,2,1,1
"923402048",31,2695.09959712393,2744.20456719377,2390.15469389133,16,15,1,1
"923402049",9,1827.89422706563,1803.49854724748,1856.26587460569,3,6,1,1
"923402050",15,2014.13031219387,1884.6645294516,2060.56118614118,8,7,1,1
"923402051",28,2394.00598541599,2670.68885373852,2340.94327947849,16,12,1,1
"923402052",31,2567.75405784997,2571.03723688846,2390.15469389133,16,15,1,1
"923402053",28,2412.19904499573,2538.04857849123,2340.94327947849,16,12,1,1
"923402054",36,2600.38447589779,2912.11313162899,2464.33502634194,21,15,1,1
"923402055",2,1346.37516003337,1364.97646362037,1364.97646362037,1,1,1,1
"923402056",29,2682.84189384915,2599.45717077782,2357.79423966008,16,13,1,1
"923402057",32,2637.45677863601,2664.62636992563,2405.71569249515,17,15,1,1
"923402058",27,2542.59669978355,2650.69203798836,2323.60649590586,14,13,1,1
"923402059",36,2718.25005779043,3466.89026927853,2464.33502634194,21,15,1,1
"923402060",17,2207.92884137004,2168.38267341219,2113.95669457394,10,7,1,1
"923402061",39,2600.9273677623,2404.51598902343,2504.98447234734,20,19,1,1
"923402062",5,1639.25703112479,1621.14256056501,1646.12614877363,2,3,1,1
"923402063",6,1714.11951175923,1680.66342532071,1708.62817714657,3,3,1,1
"923402064",17,2089.13944780838,2074.52302142412,2113.95669457394,8,9,1,1
"923402065",26,2603.80681422536,2726.96951653079,2305.75108410937,15,11,1,1
"923402066",4,1535.84795864897,1557.36446869144,1572.73281143487,1,3,1,1
"923402067",14,1886.36990353279,1925.74466285344,2031.70713799962,9,5,1,1
"923402068",19,2119.47251813338,2021.29000516289,2162.56636020013,12,7,1,1
"923402069",28,2469.11562183354,2524.0448033573,2340.94327947849,16,12,1,1
"923402070",31,2426.3972125649,2514.56117335361,2390.15469389133,15,16,1,1
"923402071",19,2106.29488041584,2023.44020537107,2162.56636020013,10,9,1,1
"923402072",18,2067.61796578404,2217.93921185039,2138.79896507223,10,8,1,1
"923402073",15,2159.75810192268,2262.94800983973,2060.56118614118,8,7,1,1
"923402074",21,2376.78188766522,2520.12532784869,2207.26116887512,10,11,1,1
"923402075",10,1960.44011635045,2102.66154325927,1896.67490607898,6,4,1,1
"923402076",12,2024.14791708859,2055.4152076918,1968.69006049611,6,6,1,1
"923402077",25,2344.97932063079,2273.16367235296,2287.34065519221,12,13,1,1
"923402118",21,2132.77431407827,1851.09355870473,2207.26116887512,13,8,1,1
"923402119",19,2491.37060177708,2404.57967100721,2162.56636020013,11,8,1,1
"923402120",39,2821.90991285313,3003.56766441591,2504.98447234734,23,16,1,1
"923402121",39,2946.97114120862,3149.37219976161,2504.98447234734,18,21,1,1
"923402122",12,1857.40080893938,1516.41475750745,1968.69006049611,4,8,1,1
"923402123",23,2419.55385983439,2606.71373919916,2248.68783741607,10,13,1,1
"923402124",23,2408.11093070756,2589.60477664694,2248.68783741607,12,11,1,1
"923402125",32,2620.26111024835,2581.24920019795,2405.71569249515,14,18,1,1
"923402126",22,2167.83772557465,1681.0382113914,2228.3491786518,14,8,1,1
"923402127",29,2472.22079380435,2722.94447209328,2357.79423966008,16,13,1,1
"923402128",23,2482.23286929419,2854.99596547249,2248.68783741607,15,8,1,1
"923402129",22,2367.96497797779,2601.24416139103,2228.3491786518,14,8,1,1
"923402130",35,2771.09025453139,2960.81006858151,2450.1860183293,18,17,1,1
"923402131",19,2166.44087343447,1866.10458887104,2162.56636020013,12,7,1,1
"923402132",17,2304.32818119072,2561.44639726994,2113.95669457394,9,8,1,1
"923402133",27,2068.56461823869,1898.28629528493,2323.60649590586,9,18,1,1
"923402135",24,2168.2732529689,1920.86550178454,2268.33468283819,12,12,1,1
"923402136",33,2013.2022632608,2019.5390534,2420.89448855093,11,22,1,1
"923402137",47,2510.88622170181,2378.44060362953,2602.36394728806,26,21,1,1
"923402138",39,2565.05352213383,2281.58919276706,2504.98447234734,23,16,1,1
"923402139",12,2075.97171618492,2137.23644477092,1968.69006049611,7,5,1,1
"923402140",21,2112.6947379942,1697.55186721133,2207.26116887512,13,8,1,1
"923402141",19,2339.29663546698,2411.44333037932,2162.56636020013,12,7,1,1
"923402142",41,2803.88393565498,2398.64861493886,2530.72175773865,22,19,1,1
"923402143",34,2899.39488556932,2741.77016474434,2435.71163614839,19,15,1,1
"923402144",16,2015.35403120362,1641.07851302716,2087.92318348224,8,8,1,1
"923402145",26,2423.62501399951,1844.5454288459,2305.75108410937,15,11,1,1
"923402146",20,2398.38929325932,2460.59275857839,2185.35845629437,11,9,1,1
"923402147",21,2188.49057895802,1746.94165891905,2207.26116887512,12,9,1,1
"923402148",32,2821.87336838549,3264.4398030171,2405.71569249515,20,12,1,1
"923402149",13,1967.85420807391,1601.99217681,2001.16379457045,6,7,1,1
"923402150",21,2382.07096813388,2387.45668422381,2207.26116887512,10,11,1,1
"923402151",41,2591.02583362526,2944.2538640616,2530.72175773865,20,21,1,1
"923402152",17,2271.21162755949,2382.42402815895,2113.95669457394,11,6,1,1
"923402153",34,2669.00900192518,2924.75650203206,2435.71163614839,18,16,1,1
"923402155",24,2195.03563979172,1693.50100230852,2268.33468283819,14,10,1,1
"923402156",24,2332.24520945009,2566.41663418871,2268.33468283819,12,12,1,1
"923402157",17,2160.81629258408,2002.17912933159,2113.95669457394,9,8,1,1
"923402158",31,2496.24952970478,2116.07143036565,2390.15469389133,17,14,1,1
"923402159",24,2609.76602622318,2814.71268695504,2268.33468283819,12,12,1,1
"923402162",45,2674.8978760466,2139.62985871026,2579.33597919865,22,23,1,1
"923402163",59,2678.75071091466,2228.66114467342,2726.17127719361,39,20,1,1
"923402164",41,2547.22337707297,1961.38942277165,2530.72175773865,27,14,1,1
"923402165",49,2637.82732241184,2241.07710118227,2624.62502504328,24,25,1,1
"923402166",44,3044.68892767616,3401.59643239636,2567.51523707907,25,19,1,1
"923402167",58,2513.50249964064,2232.4621883339,2716.66249357165,36,22,1,1
"923402168",59,3293.8437324871,3648.47771044285,2726.17127719361,33,26,1,1
"923402169",62,3349.30592744969,5271.59892895399,2753.94837323248,32,30,1,1
"923402170",51,2651.85782972995,2888.12361947704,2646.17454577679,28,23,1,1
"923402171",63,2766.43080728565,2695.04133963695,2762.96971264875,36,27,1,1
"923402173",78,3338.63802664629,3619.59993604913,2886.25582696583,40,38,1,1
"923402174",38,2253.17972984009,1843.32677273282,2491.71993967651,21,17,1,1
"923402175",58,3161.96275067207,3336.04709695086,2716.66249357165,30,28,1,1
"923402919",53,2979.9497224913,3394.3055409706,2667.061866114,30,23,1,1
"923402920",46,2955.02329063773,3010.52826829309,2590.94954296761,22,24,1,1
"923402921",50,2602.90887445559,2357.1190953829,2635.48551585152,29,21,1,1
"923402922",43,2564.9469994517,2137.27443009479,2555.47878346624,23,20,1,1
"923402923",53,2401.01005545803,1721.31577696566,2667.061866114,27,26,1,1
"923402924",62,2655.21217349123,2852.87827865227,2753.94837323248,36,26,1,1
"923402925",38,2488.28185780128,2483.14890258831,2491.71993967651,20,18,1,1
"923402926",19,2171.56501625864,2312.35771447099,2162.56636020013,14,5,1,1
"923402927",66,3398.29146460745,3310.27211597898,2789.3669207067,33,33,1,1
"923402928",51,2805.39002942481,2592.15806975967,2646.17454577679,31,20,1,1
"923402929",42,2577.88882844506,2129.48292528742,2543.21752514954,26,16,1,1
"923402930",64,2639.47310941179,2199.88420272654,2771.87783482774,39,25,1,1
"923402931",45,2567.13482696164,1736.78198758834,2579.33597919865,27,18,1,1
"923402932",67,2888.58370719751,2766.61635207287,2797.95380131742,35,32,1,1
"923402933",54,2816.3651814707,3146.50877992681,2677.2712016452,29,25,1,1
"923402934",72,3250.96291999618,3073.43976606645,2839.4193288992,36,36,1,1
"923402937",66,3439.53634682391,3176.22479502679,2789.3669207067,33,33,1,1
"923402938",54,3053.95217738895,2666.53758274758,2677.2712016452,24,30,1,1
"923403188",39,2713.22722596504,2795.24774202332,2504.98447234734,23,16,1,1
"923403189",37,2332.20586447415,2137.40805854872,2478.17471526668,20,17,1,1
"923403190",33,2166.31895119312,1947.73373467085,2420.89448855093,17,16,1,1
"923403191",30,2545.68217293856,2638.23149231879,2374.18906024059,16,14,1,1
"923403192",33,2402.19454800958,2785.29337651745,2420.89448855093,16,17,1,1
"923403193",35,2435.47101164691,2606.60996836817,2450.1860183293,20,15,1,1
"923403194",33,2601.93284565523,2662.0993359203,2420.89448855093,18,15,1,1
"923403195",31,2430.68209605414,2626.44284951719,2390.15469389133,18,13,1,1
"923403196",33,2439.65880794462,2532.85710505106,2420.89448855093,19,14,1,1
"923403197",24,2216.33602915771,2328.73811586008,2268.33468283819,13,11,1,1
"923403198",36,2579.3025727641,2573.1854928817,2464.33502634194,21,15,1,1
"923403199",40,2447.82673450157,2529.00501210932,2517.98110851286,22,18,1,1
"923403205",29,2506.38812956964,2526.49230696138,2357.79423966008,19,10,1,1
"923403206",34,2389.91864079258,2701.03208237058,2435.71163614839,22,12,1,1
"923403207",28,2267.22795850067,2395.57551091934,2340.94327947849,17,11,1,1
"923403208",35,2549.53144183483,2705.52842947258,2450.1860183293,18,17,1,1
"923403209",33,2561.3368378494,2917.45033528092,2420.89448855093,20,13,1,1
"923403210",22,2265.27308475816,2508.16947905122,2228.3491786518,12,10,1,1
"923403211",35,2466.93018922279,2583.01544586619,2450.1860183293,19,16,1,1
"923403212",31,2595.5330741692,2832.70364589716,2390.15469389133,19,12,1,1
"923403213",30,2492.09609273608,2703.27703160108,2374.18906024059,16,14,1,1
"923403214",28,2532.20224622562,2757.19368045604,2340.94327947849,13,15,1,1
"923403215",34,2386.58971629672,2366.43244072788,2435.71163614839,20,14,1,1
"923403216",38,2537.94593001002,2192.89554154643,2491.71993967651,19,19,1,1
"923403217",32,2306.37903326669,2176.88788966735,2405.71569249515,21,11,1,1
"923403218",36,2527.50468947786,2414.00467211429,2464.33502634194,23,13,1,1
"923403219",34,2487.68702483628,2476.50307499795,2435.71163614839,18,16,1,1
"923403220",24,2316.91974327102,2526.68410265071,2268.33468283819,17,7,1,1
"923403221",23,2341.37259478519,2315.05203149371,2248.68783741607,13,10,1,1
"923403222",33,2537.79157738035,2715.46291753165,2420.89448855093,17,16,1,1
"923403223",29,2443.87100170872,2262.05080158307,2357.79423966008,17,12,1,1
"923403224",29,2407.74767544826,2668.51372652035,2357.79423966008,16,13,1,1
"923403225",66,3386.37564141004,2942.88791543516,2789.3669207067,39,27,1,1
"923403226",47,3022.13629593771,3071.26698692611,2602.36394728806,26,21,1,1
"923403227",30,2457.61910467678,2408.16739623802,2374.18906024059,17,13,1,1
"923403228",38,2844.07039652076,2603.72486218029,2491.71993967651,19,19,1,1
"923403229",23,2246.77956975106,2073.8433874566,2248.68783741607,16,7,1,1
"923403230",45,2915.59779071132,2822.15312097477,2579.33597919865,29,16,1,1
"923403231",76,3446.72193160944,4020.46863166045,2870.97236507783,35,41,1,1
"923403232",44,2916.05672489808,2743.06725840465,2567.51523707907,19,25,1,1
"923403233",23,2249.53772414701,2435.36949009543,2248.68783741607,7,16,1,1
"923403234",53,3121.8309858053,2960.13132724736,2667.061866114,24,29,1,1
"923403235",41,2505.59485211027,2374.37050625252,2530.72175773865,21,20,1,1
"923403236",52,3125.98698781509,3013.97769931749,2656.6981055205,32,20,1,1
"923403237",45,2890.29167983725,2613.24110498321,2579.33597919865,24,21,1,1
"923403238",18,2231.67931529941,2447.2908965582,2138.79896507223,8,10,1,1
"923403239",40,2914.76575255628,3124.1287325058,2517.98110851286,22,18,1,1
"923403240",56,3103.71962039098,2770.92513287433,2697.24673169728,30,26,1,1
"923403241",52,2974.32862564591,2820.42074283053,2656.6981055205,29,23,1,1
"923403242",45,3286.3402397464,3532.18087833961,2579.33597919865,27,18,1,1
"923403243",36,2871.48352556481,2966.7056782507,2464.33502634194,20,16,1,1
"923403244",34,2700.65010825691,2818.83523782406,2435.71163614839,17,17,1,1
"923403245",44,2802.15487924189,2773.1541386465,2567.51523707907,19,25,1,1
"923403246",50,3218.47887246559,3607.53847202913,2635.48551585152,26,24,1,1
"923403247",39,3016.14853224855,2787.45642368213,2504.98447234734,23,16,1,1
"923403248",20,2209.74015698274,2265.52329673256,2185.35845629437,9,11,1,1
"923403249",56,3232.89958088061,3296.86652834719,2697.24673169728,32,24,1,1
"923403250",64,3663.73617644051,4365.95684180918,2771.87783482774,29,35,1,1
"923403251",42,2566.83662275698,2647.75310897715,2543.21752514954,26,16,1,1
"923403252",35,2671.75105065741,2777.54120043999,2450.1860183293,20,15,1,1
"923403253",61,2996.38155432309,3590.47861232272,2744.81051624266,34,27,1,1
"923403254",33,2379.42047621279,2172.27100426257,2420.89448855093,19,14,1,1
"923403255",45,2946.38126346138,2726.55787511421,2579.33597919865,18,27,1,1
"923403256",42,2537.93840988947,2587.88662483955,2543.21752514954,26,16,1,1
"923403257",63,3204.38341262362,2914.44463571035,2762.96971264875,30,33,1,1
"923403258",36,2757.18424063159,2643.55607118062,2464.33502634194,18,18,1,1
"923403259",37,2537.23354132868,2554.82563588889,2478.17471526668,22,15,1,1
"923403260",64,3161.42867651931,3431.90337854459,2771.87783482774,28,36,1,1
"923403261",43,2422.06153467724,2477.21032349084,2555.47878346624,21,22,1,1
"923403262",50,3004.54136323143,2773.50315855914,2635.48551585152,20,30,1,1
"923403263",43,2698.64898967584,2495.44253549558,2555.47878346624,30,13,1,1
"923403264",43,3054.06959303553,3413.87325070585,2555.47878346624,23,20,1,1
"923403265",49,3136.9514452691,3158.61899607332,2624.62502504328,19,30,1,1
"923403266",46,2930.31705706093,2841.26614861594,2590.94954296761,26,20,1,1
"923403284",34,2557.35914105722,2829.18415417705,2435.71163614839,23,11,1,1
"923403285",46,3369.95038076751,3720.93768113659,2590.94954296761,31,15,1,1
"923403286",32,2784.2176409076,2910.05502474021,2405.71569249515,20,12,1,1
"923403287",47,3115.46789392389,3461.87010995885,2602.36394728806,30,17,1,1
"923403288",48,3182.2074762643,3417.66563007428,2613.58673801098,27,21,1,1
"923403289",36,3001.98272610756,3253.87332759058,2464.33502634194,23,13,1,1
"923403290",38,3030.52356058846,3055.99063268332,2491.71993967651,24,14,1,1
"923403291",37,2970.54313876115,3247.13054738738,2478.17471526668,26,11,1,1
"923403292",59,3548.61188339062,3887.46824752771,2726.17127719361,31,28,1,1
"923403293",52,3472.03532612186,3499.87326903552,2656.6981055205,30,22,1,1
"923403294",65,3468.88079080485,4176.94954055106,2780.67589681985,36,29,1,1
"923403295",46,2937.65483098631,3259.8311825103,2590.94954296761,31,15,1,1
"923403296",35,2727.39350653882,2823.41679378634,2450.1860183293,23,12,1,1
"923403297",35,2787.64532208488,3152.08357120797,2450.1860183293,23,12,1,1
"923403298",53,3181.93546669149,3657.09561251341,2667.061866114,30,23,1,1
"923403299",17,2264.31183646346,2499.48355052983,2113.95669457394,5,12,1,1
"923403300",35,2887.3261142104,2935.3588686778,2450.1860183293,18,17,1,1
"923403301",41,2864.94580779442,3314.09434163818,2530.72175773865,20,21,1,1
"923403303",19,2219.26410039973,2463.81093693059,2162.56636020013,9,10,1,1
"923403304",20,2195.37766659753,2147.95079004482,2185.35845629437,7,13,1,1
"923403305",38,2299.43381212556,2250.70095185691,2491.71993967651,18,20,1,1
"923403306",31,2250.47879892468,2207.52508837098,2390.15469389133,14,17,1,1
"923403307",32,2104.2786087617,1737.73378696019,2405.71569249515,16,16,1,1
"923403308",53,2437.89436784399,1944.80659192141,2667.061866114,21,32,1,1
"923403309",28,2160.54467200122,1726.58391864184,2340.94327947849,16,12,1,1
"923403310",23,2317.60020355666,2135.79831496136,2248.68783741607,9,14,1,1
"923403311",43,2988.2655240386,3871.66855782947,2555.47878346624,19,24,1,1
"923403312",41,3313.19576947266,3675.83614711834,2530.72175773865,22,19,1,1
"923403313",16,2060.29470813372,2116.85448836188,2087.92318348224,6,10,1,1
"923403314",30,2286.39292400329,2295.90786310175,2374.18906024059,16,14,1,1
"923403315",37,2813.16278979871,3355.51553475044,2478.17471526668,23,14,1,1
"923403316",46,3123.19322594088,3770.76440498133,2590.94954296761,24,22,1,1
"923403318",15,2090.12515764274,1953.0277668875,2060.56118614118,7,8,1,1
"923403319",19,1966.42554208274,1946.02935303794,2162.56636020013,7,12,1,1
"923403320",33,2100.1051983949,2312.33469072833,2420.89448855093,16,17,1,1
"923403321",18,1941.54428258427,2008.40542649508,2138.79896507223,6,12,1,1
"923403322",35,2959.07414056798,3513.49671123772,2450.1860183293,17,18,1,1
"923403323",37,2377.04122351645,2565.83816567086,2478.17471526668,17,20,1,1
"923403325",29,2279.07581617038,2199.20935237227,2357.79423966008,14,15,1,1
"923403326",18,2213.11521147026,2094.25005999544,2138.79896507223,7,11,1,1
"923403327",46,3219.40697173191,3843.795809814,2590.94954296761,26,20,1,1
"923403328",65,2703.22142509173,2089.20283071748,2780.67589681985,25,40,1,1
"923403329",14,1999.0317721459,1996.95521826407,2031.70713799962,3,11,1,1
"923403330",42,3084.87425622371,3612.33847531273,2543.21752514954,23,19,1,1
"923403331",36,3024.15012004579,3375.0741718281,2464.33502634194,21,15,1,1
"923403332",39,2626.88176452202,3108.54229244804,2504.98447234734,21,18,1,1
"923403333",15,1977.77612617381,1853.88829417094,2060.56118614118,8,7,1,1
"923403334",23,2004.98397099138,1829.90986164699,2248.68783741607,9,14,1,1
"923403335",34,2178.99087539687,1966.48793222333,2435.71163614839,18,16,1,1
"923403336",33,2912.17534290316,3566.08857145443,2420.89448855093,18,15,1,1
"923403337",44,2963.0788920149,3739.8817169536,2567.51523707907,24,20,1,1
"923403338",20,2182.66702946326,2083.19756020768,2185.35845629437,12,8,1,1
"923403339",19,1960.26301008009,1957.46738897845,2162.56636020013,6,13,1,1
"923403341",46,3121.6741718909,3480.77918638031,2590.94954296761,29,17,1,1
"923403342",32,2242.12901161428,2058.17967686972,2405.71569249515,15,17,1,1
"923403343",42,3003.39906968341,3364.64788404151,2543.21752514954,21,21,1,1
"923403344",48,3078.84541101979,3953.29365644949,2613.58673801098,25,23,1,1
"923403345",71,3398.66916861732,4123.56832097151,2831.31372136695,40,31,1,1
"923403346",50,2992.81119714681,2521.21608137213,2635.48551585152,29,21,1,1
"923403347",55,2783.11139465916,2603.87879893149,2687.33120998132,29,26,1,1
"923403348",55,3312.29310984356,3002.11107016524,2687.33120998132,31,24,1,1
"923403349",65,3479.0410316715,3601.65790306237,2780.67589681985,33,32,1,1
"923403350",41,2606.90604679172,2508.44598886279,2530.72175773865,21,20,1,1
"923403351",68,3315.8350008866,2905.90722685577,2806.43931339586,35,33,1,1
"923403352",49,2985.66065707755,2699.40107549278,2624.62502504328,27,22,1,1
"923403353",59,3126.72886928333,2707.10949143873,2726.17127719361,30,29,1,1
"923403354",61,2936.61664752625,3278.59979401533,2744.81051624266,30,31,1,1
"923403355",50,2748.34566978475,3061.86377011832,2635.48551585152,32,18,1,1
"923403356",45,3078.10994615541,2732.44901195429,2579.33597919865,23,22,1,1
"923403357",56,3383.67842098488,3965.62374559708,2697.24673169728,30,26,1,1
"923403358",59,3451.46737960968,3541.01669634509,2726.17127719361,32,27,1,1
"923403359",51,2510.68865523525,2177.53677554655,2646.17454577679,26,25,1,1
"923403360",48,2506.14694535363,2391.31381989899,2613.58673801098,28,20,1,1
"923403361",50,2919.79540420319,2688.45167494496,2635.48551585152,26,24,1,1
"923403362",74,4374.32931245581,5273.80082268968,2855.36548874306,36,38,1,1
"923403363",78,3615.28177922222,3267.1396656235,2886.25582696583,40,38,1,1
"923403364",81,3119.80978488737,2531.11538805334,2908.60658576875,44,37,1,1
"923403365",32,2650.04281406182,2475.32633850956,2405.71569249515,19,13,1,1
"923403366",47,2789.42557590326,3157.98012300996,2602.36394728806,26,21,1,1
"923403367",57,3162.59073211909,2823.51665389012,2707.02236739438,29,28,1,1
"923403368",45,3268.62608943029,2848.38504255117,2579.33597919865,22,23,1,1
"923403369",73,3698.87010506041,4289.00137930598,2847.4358582506,40,33,1,1
"923403370",52,3460.88121634951,3195.73246132418,2656.6981055205,30,22,1,1
"923403371",44,2750.26945751244,2864.77484585164,2567.51523707907,20,24,1,1
"923403372",65,3303.46665226639,2937.2909410482,2780.67589681985,36,29,1,1
"923403373",79,3331.75634058135,2702.4833862054,2893.78092561085,43,36,1,1
"923403374",48,2907.73694377838,2677.69267055625,2613.58673801098,28,20,1,1
"923403375",48,2908.68400872493,2950.09992598974,2613.58673801098,24,24,1,1
"923403376",37,2749.6045506267,2891.44638827604,2478.17471526668,24,13,1,1
"923403377",39,2745.34244859843,2551.48076982698,2504.98447234734,21,18,1,1
"923403378",42,2501.85950332019,2228.74146526108,2543.21752514954,23,19,1,1
"923403379",59,3173.1747213889,3370.72543136704,2726.17127719361,28,31,1,1
"923403380",44,2848.31058450294,2462.58290815441,2567.51523707907,29,15,1,1
"923403381",35,2950.80126007125,2891.36208139103,2450.1860183293,21,14,1,1
"923403382",30,2626.85214108818,2676.67162368134,2374.18906024059,20,10,1,1
"923403383",76,4051.40517552567,2990.83856705756,2870.97236507783,40,36,1,1
"923403384",61,2773.2545332224,2707.96579871326,2744.81051624266,32,29,1,1
"923403385",66,3213.14063565791,3608.95458499509,2789.3669207067,36,30,1,1
"923403386",70,3231.69641709692,3216.68602422343,2823.11677003184,44,26,1,1
"923403387",81,2672.73720210963,1569.54182678007,2908.60658576875,42,39,1,1
"923403388",62,3447.66266575643,2419.03004006114,2753.94837323248,34,28,1,1
"923403389",68,3104.37484007811,2917.40984932122,2806.43931339586,36,32,1,1
"923403391",63,3102.07383072172,2907.63689338599,2762.96971264875,33,30,1,1
"923403392",72,3480.14636064089,2914.63084761456,2839.4193288992,34,38,1,1
"923403393",58,3007.68952838831,2920.01313312501,2716.66249357165,33,25,1,1
"923403394",36,2527.26908681369,2257.91013947226,2464.33502634194,21,15,1,1
"923403395",79,2905.19049207326,3001.84015823672,2893.78092561085,45,34,1,1
"923403396",59,3567.69081550908,3657.24144187595,2726.17127719361,27,32,1,1
"923403397",34,2702.82453588538,2624.53222245887,2435.71163614839,19,15,1,1
"923403398",64,3394.95146422599,2735.00274593013,2771.87783482774,35,29,1,1
"923403399",54,3377.01333883518,3421.35032647733,2677.2712016452,28,26,1,1
"923403400",38,2607.83086885386,2624.6815269896,2491.71993967651,20,18,1,1
"923403402",46,3294.18441569994,3372.36724068862,2590.94954296761,31,15,1,1
"923403403",48,2574.5276400268,2349.24261423945,2613.58673801098,28,20,1,1
"923403404",61,3029.84436667359,2751.20337436065,2744.81051624266,30,31,1,1
"923403405",62,3254.32724434649,2637.94798456536,2753.94837323248,35,27,1,1
"923403406",60,3212.5940792956,4061.17546432636,2735.5526890818,37,23,1,1
"923403407",53,2646.49210768779,2828.635027638,2667.061866114,27,26,1,1
"923403408",71,3928.3560400842,3283.00619219574,2831.31372136695,39,32,1,1
"923403409",53,3273.53549754142,3476.92205484281,2667.061866114,29,24,1,1
"923403410",63,3206.08402358765,3716.09840558033,2762.96971264875,38,25,1,1
"923403411",74,3848.00161507384,4273.84854486623,2855.36548874306,36,38,1,1
"923403412",42,2803.08112388325,2552.36656121569,2543.21752514954,23,19,1,1
"923403413",49,2858.00154709076,2836.06499891057,2624.62502504328,28,21,1,1
"923403414",71,3803.79926135046,3626.62143276806,2831.31372136695,40,31,1,1
"923403415",88,4128.53140969349,4695.07953333528,2958.30409156145,48,40,1,1
"923403416",73,2902.38388526377,2701.81643614046,2847.4358582506,41,32,1,1
"923403417",41,2885.53373937914,2362.38701987873,2530.72175773865,25,16,1,1
"923403418",79,3157.734205535,2935.93351035211,2893.78092561085,42,37,1,1
"923403419",72,2772.58409784199,2503.95970164539,2839.4193288992,43,29,1,1
"923403420",41,2493.41968783346,2287.81861693495,2530.72175773865,29,12,1,1
"923403421",75,2834.4284479779,1742.32303519005,2863.21031780169,42,33,1,1
"923403422",70,3171.58355166519,3256.33863304369,2823.11677003184,42,28,1,1
"923403423",57,2566.38869865586,2170.63175057652,2707.02236739438,36,21,1,1
"923403424",38,2655.4644455318,2662.14766561059,2491.71993967651,18,20,1,1
"923403425",67,3113.0901831906,2585.99194332812,2797.95380131742,42,25,1,1
"923403426",73,3129.88730221165,2803.96001856649,2847.4358582506,41,32,1,1
"923403427",66,3494.60020881274,3050.57850328227,2789.3669207067,35,31,1,1
"923403428",43,2858.65446170545,2705.78424487973,2555.47878346624,26,17,1,1
"923403429",66,3124.35383388312,3627.01379292749,2789.3669207067,36,30,1,1
"923403430",60,3673.3074645413,2926.36252324518,2735.5526890818,31,29,1,1
"923403431",51,3090.57801347996,3082.31860987172,2646.17454577679,25,26,1,1
"923403432",68,3395.67142044265,3980.91823519067,2806.43931339586,34,34,1,1
"923403433",34,2641.63676828322,2630.98243271904,2435.71163614839,22,12,1,1
"923403434",67,3515.90831791779,2998.87345479368,2797.95380131742,39,28,1,1
"923403435",75,2914.35643394382,2690.75292935073,2863.21031780169,40,35,1,1
"923403436",39,2477.66121282648,2327.76575042454,2504.98447234734,24,15,1,1
"923403437",87,3445.71132894154,3702.42992149889,2951.40156710974,45,42,1,1
"923403438",72,3861.21504635409,4235.4031835898,2839.4193288992,36,36,1,1
"923403439",61,3229.36094034266,2657.63814530958,2744.81051624266,36,25,1,1
"923403440",76,2931.26818332506,1713.09863713479,2870.97236507783,39,37,1,1
"923403441",47,3129.34398504214,3344.87446589782,2602.36394728806,29,18,1,1
"923403442",37,2701.83805099274,3115.38573720795,2478.17471526668,21,16,1,1
"923403443",76,3863.32256348099,3936.95435607413,2870.97236507783,36,40,1,1
"923403444",67,3651.77891872032,3328.21193382741,2797.95380131742,32,35,1,1
"923403445",46,2966.08117270852,2498.95525422988,2590.94954296761,25,21,1,1
"923403446",62,3820.38507067704,4288.13933731549,2753.94837323248,35,27,1,1
"923403447",55,3425.09368548924,3604.27896563776,2687.33120998132,35,20,1,1
"923403448",56,3712.9820729769,3941.62795665707,2697.24673169728,32,24,1,1
"923403449",75,3425.83520286685,3344.20739762356,2863.21031780169,41,34,1,1
"923403450",50,3211.27964308773,3003.75012111636,2635.48551585152,30,20,1,1
"923403451",43,2590.79784083894,2354.00704280845,2555.47878346624,20,23,1,1
"923403452",42,2681.18446022153,2981.27257243663,2543.21752514954,21,21,1,1
"923403453",48,3348.66286479402,3108.93683573621,2613.58673801098,30,18,1,1
"923403454",67,3176.74485097414,2924.25796230639,2797.95380131742,29,38,1,1
"923403455",47,2792.06992973565,2427.77393471867,2602.36394728806,28,19,1,1
"923403456",56,3257.95218251756,2975.35369907233,2697.24673169728,29,27,1,1
"923403457",36,2722.86926626303,3188.00020677083,2464.33502634194,22,14,1,1
"923403458",45,2655.42951277116,2774.16078639284,2579.33597919865,26,19,1,1
"923403459",59,2685.29213472345,2612.57135393318,2726.17127719361,32,27,1,1
"923403460",54,3104.1520071433,3183.05318507361,2677.2712016452,31,23,1,1
"923403461",41,2600.55397962411,2332.12407085672,2530.72175773865,22,19,1,1
"923403462",40,2702.84356009604,2274.99450377384,2517.98110851286,24,16,1,1
"923403463",53,3209.09173708587,2926.21559752187,2667.061866114,29,24,1,1
"923403464",46,2670.13027143989,2438.12195958059,2590.94954296761,26,20,1,1
"923403670",19,2164.44660042119,2178.00502881191,2162.56636020013,10,9,1,1
"923403671",25,2315.03375571891,2219.23285361222,2287.34065519221,10,15,1,1
"923403672",14,2127.99084422574,2251.10416113786,2031.70713799962,8,6,1,1
"923403673",21,2354.31726233076,2315.7886600031,2207.26116887512,12,9,1,1
"923403674",17,2182.93965268045,2320.10151485917,2113.95669457394,10,7,1,1
"923403675",18,2211.43117623566,2548.4284255087,2138.79896507223,11,7,1,1
"923403676",24,2089.69746108624,2525.73756417718,2268.33468283819,12,12,1,1
"923403677",24,2320.62157886192,2339.40566891967,2268.33468283819,15,9,1,1
"923403679",23,2422.71481080924,2399.16078572097,2248.68783741607,12,11,1,1
"923403680",30,2732.11009909089,2662.4935951625,2374.18906024059,16,14,1,1
"923403681",31,2589.68452468011,2941.2697567076,2390.15469389133,14,17,1,1
"923403682",32,2617.4550503054,2661.39531693472,2405.71569249515,14,18,1,1
"923403683",21,2440.68140705201,2493.8377326861,2207.26116887512,11,10,1,1
"923403684",38,2548.73070658235,3005.42948014645,2491.71993967651,23,15,1,1
"923403685",37,2841.13963653263,2874.82914851837,2478.17471526668,21,16,1,1
"923403686",26,2504.83238626935,2467.31529806892,2305.75108410937,15,11,1,1
"923403687",31,2834.83887461815,2608.31250822847,2390.15469389133,13,18,1,1
"923403688",27,2599.11828103493,2675.26070642262,2323.60649590586,16,11,1,1
"923403701",48,2990.93640826353,3031.8381235545,2613.58673801098,19,29,1,1
"923403702",47,2902.53013593209,3525.46402500256,2602.36394728806,20,27,1,1
"923403703",38,2986.83866722843,2961.63363791087,2491.71993967651,16,22,1,1
"923403704",27,2537.98103083004,2832.69626149601,2323.60649590586,18,9,1,1
"923403705",42,2716.06266042545,2725.03280388733,2543.21752514954,24,18,1,1
"923403706",52,3478.52155815192,3073.51319743169,2656.6981055205,24,28,1,1
"923403707",55,3369.56622204247,3391.91845771277,2687.33120998132,26,29,1,1
"923403708",13,2029.58946759973,2061.74322174241,2001.16379457045,4,9,1,1
"923403709",26,2237.42919440628,2344.11598547967,2305.75108410937,9,17,1,1
"923403710",34,2707.7984633285,2685.24395912814,2435.71163614839,13,21,1,1
"923403711",30,2223.51357190666,2159.76050504951,2374.18906024059,12,18,1,1
"923403712",43,3288.15524224404,3999.3860609057,2555.47878346624,15,28,1,1
"923403713",56,2933.93857200309,2801.06387609372,2697.24673169728,30,26,1,1
"923403714",69,3485.2551019543,3606.04365338857,2814.82611826518,28,41,1,1
"923403715",48,3137.65546841875,3445.35753961332,2613.58673801098,20,28,1,1
"923403716",42,2957.96286927873,3391.89859424526,2543.21752514954,16,26,1,1
"923403717",55,3505.26146155506,2924.39415166429,2687.33120998132,24,31,1,1
"923403718",30,2278.24361464947,2203.99391185401,2374.18906024059,14,16,1,1
"923403720",48,3026.63930126731,3474.42614908428,2613.58673801098,23,25,1,1
"923403721",52,2959.73506436255,3134.97338419129,2656.6981055205,24,28,1,1
"923403722",11,1981.46186676024,2003.85461765216,1933.98659929558,5,6,1,1
"923403723",59,3423.62841824277,3635.11246899025,2726.17127719361,25,34,1,1
"923403724",14,1884.73065042758,1773.62701216186,2031.70713799962,7,7,1,1
"923403725",37,2348.32497045102,2309.29615318978,2478.17471526668,18,19,1,1
"923403726",41,2487.95675842755,2500.32804631426,2530.72175773865,20,21,1,1
"923403727",64,3080.63658252372,2885.07999680178,2771.87783482774,32,32,1,1
"923403728",21,2220.15328340815,2360.21662426663,2207.26116887512,11,10,1,1
"923403729",39,2916.87592793641,3636.78995313541,2504.98447234734,18,21,1,1
"923403730",46,3390.84440647724,3084.36164882396,2590.94954296761,18,28,1,1
"923403731",49,3339.77866937913,3151.78374061482,2624.62502504328,18,31,1,1
"923403732",36,2556.82416964755,1990.44648827364,2464.33502634194,24,12,1,1
"923403733",47,2855.85235859837,2783.32788798001,2602.36394728806,25,22,1,1
"923403734",34,2106.63430754,1884.04620014376,2435.71163614839,22,12,1,1
"923403735",37,2917.53232707243,3208.91693981073,2478.17471526668,16,21,1,1
"923403736",25,2229.21447143355,2043.41468879038,2287.34065519221,13,12,1,1
"923403737",39,2962.94676718494,3267.73914816207,2504.98447234734,15,24,1,1
"923403738",49,2377.37849471438,2059.67162648339,2624.62502504328,22,27,1,1
"923403739",18,2160.16189848281,2359.89956130873,2138.79896507223,10,8,1,1
"923403740",39,2962.6427707794,2514.08187523451,2504.98447234734,15,24,1,1
"923403741",20,2102.25059929356,2155.92646670498,2185.35845629437,8,12,1,1
"923403743",60,3076.09006907992,3328.19741838398,2735.5526890818,26,34,1,1
"923403744",50,2949.586534721,3004.50722874785,2635.48551585152,19,31,1,1
"923403745",28,2337.06975352979,2411.47479026499,2340.94327947849,18,10,1,1
"923403746",52,3514.6911780161,3213.58453059768,2656.6981055205,23,29,1,1
"923403747",31,2259.62509376178,1933.40506404315,2390.15469389133,15,16,1,1
"923403748",20,2124.73472018795,2140.37175648225,2185.35845629437,14,6,1,1
"923403749",37,2581.61879748543,2804.3469259011,2478.17471526668,17,20,1,1
"923403750",52,3231.22692012819,3807.49066248802,2656.6981055205,21,31,1,1
"923403751",31,2262.66758745245,1920.37011565317,2390.15469389133,18,13,1,1
"923403752",44,2708.03885281545,3042.56423490595,2567.51523707907,19,25,1,1
"923403753",62,2685.41846266656,2555.58008914204,2753.94837323248,33,29,1,1
"923403754",65,3126.29002777261,2702.73050508757,2780.67589681985,33,32,1,1
"923403755",57,3264.49608142384,3054.94126682243,2707.02236739438,31,26,1,1
"923403756",25,2378.15115183041,2250.06789211667,2287.34065519221,11,14,1,1
"923403757",18,2278.54386936307,2589.03824095918,2138.79896507223,9,9,1,1
"923403758",22,2141.07955875317,2164.1266064796,2228.3491786518,13,9,1,1
"923403759",48,3272.66884882489,3456.42412954837,2613.58673801098,16,32,1,1
"923403760",21,1949.12855334712,1713.43444103142,2207.26116887512,7,14,1,1
"923403761",55,3376.99002859996,3663.14999760133,2687.33120998132,26,29,1,1
"923403762",24,2298.752767476,2371.76892420336,2268.33468283819,15,9,1,1
"923403763",60,2798.18687790908,3136.425768355,2735.5526890818,27,33,1,1
"923403764",20,2121.03625070901,2054.72243088805,2185.35845629437,10,10,1,1
"923403765",42,2937.24610769886,2844.25913000171,2543.21752514954,16,26,1,1
"923403766",35,2506.37943288261,2598.01015533104,2450.1860183293,20,15,1,1
"923403767",47,3252.44999874389,3860.16279040457,2602.36394728806,17,30,1,1
"923403768",60,3781.45985302547,3827.50168009101,2735.5526890818,25,35,1,1
"923403769",51,3215.04642375121,3895.01996067786,2646.17454577679,23,28,1,1
"923403770",54,3444.43313483036,3345.8896799131,2677.2712016452,28,26,1,1
"923403771",24,2337.43956419175,2259.13928395328,2268.33468283819,13,11,1,1
"923403772",49,2900.56465889461,2630.62499554672,2624.62502504328,21,28,1,1
"923403773",55,3604.96360355888,3950.35490695043,2687.33120998132,23,32,1,1
"923403774",51,3047.24200553929,3167.91353294685,2646.17454577679,23,28,1,1
"923403775",24,2293.1773331003,2370.19606622047,2268.33468283819,14,10,1,1
"923403776",52,2356.07252957876,1954.89660931733,2656.6981055205,18,34,1,1
"923403777",44,2966.48709349316,3388.38305587579,2567.51523707907,21,23,1,1
"923403778",43,3261.46357579222,3184.92724389787,2555.47878346624,20,23,1,1
"923403779",30,2287.0485667319,2333.06223814083,2374.18906024059,15,15,1,1
"923403780",53,3311.97058165486,3279.61965776591,2667.061866114,25,28,1,1
"923403781",39,2695.15443498951,2750.13967972504,2504.98447234734,16,23,1,1
"923403782",59,2712.81195475916,2765.10312443049,2726.17127719361,25,34,1,1
"923403783",51,3103.45139876514,3167.42312524346,2646.17454577679,20,31,1,1
"923403784",38,2621.10353892361,2578.82514577471,2491.71993967651,18,20,1,1
"923403785",57,3156.7448153424,3108.17972862076,2707.02236739438,28,29,1,1
"923403786",34,2461.23674927349,2792.20941298953,2435.71163614839,14,20,1,1
"923403787",69,3320.76306601902,2497.19852794744,2814.82611826518,29,40,1,1
"923403788",22,2252.43692717919,2502.36657008327,2228.3491786518,11,11,1,1
"923403789",37,2476.15335263557,2205.3052114205,2478.17471526668,19,18,1,1
"923403790",58,2514.70646142311,2244.97466913053,2716.66249357165,30,28,1,1
"923403791",69,3063.40914889857,3397.67321662795,2814.82611826518,35,34,1,1
"923403792",12,1885.31883749026,1800.91974205244,1968.69006049611,5,7,1,1
"923403793",55,3292.5243425313,3314.83296589046,2687.33120998132,24,31,1,1
"923403795",67,2828.09684398313,2304.13616506803,2797.95380131742,37,30,1,1
"923403796",46,3033.25067973893,2812.27738924281,2590.94954296761,23,23,1,1
"923403797",32,2926.71749884206,2973.90328510709,2405.71569249515,16,16,1,1
"923403798",56,3295.74997866965,3578.08842934572,2697.24673169728,27,29,1,1
"923403799",56,3168.63206853575,2999.21718063033,2697.24673169728,23,33,1,1
"923403800",9,1874.90677641148,1751.509609044,1856.26587460569,3,6,1,1
"923403801",64,3288.798643665,3584.98164765609,2771.87783482774,32,32,1,1
"923403802",40,2284.07363947862,1887.53622732338,2517.98110851286,21,19,1,1
"923403803",60,2982.38479742992,2977.90032974996,2735.5526890818,22,38,1,1
"923403804",15,1930.03871164009,1776.5797220826,2060.56118614118,4,11,1,1
"923403805",17,2202.29893023328,2201.97441905182,2113.95669457394,9,8,1,1
"923403806",23,2238.70953134161,2288.00032027376,2248.68783741607,12,11,1,1
"923403807",43,2892.44540601398,2561.11861065194,2555.47878346624,19,24,1,1
"923403808",40,2978.47816965546,3099.76440440679,2517.98110851286,17,23,1,1
"923403809",27,2148.21604041925,2352.69560751946,2323.60649590586,14,13,1,1
"923403810",30,2417.11872870702,2396.21716587324,2374.18906024059,18,12,1,1
"923403811",17,1943.7729728694,1799.98874811381,2113.95669457394,5,12,1,1
"923403812",72,3325.38580074394,3177.22116512113,2839.4193288992,33,39,1,1
"923403813",43,2669.48708976532,3324.11788102959,2555.47878346624,20,23,1,1
"923403814",44,3130.39503093952,3732.10517795151,2567.51523707907,18,26,1,1
"923403815",38,3029.51330873662,3045.07159894242,2491.71993967651,16,22,1,1
"923403816",28,2043.6979969854,1732.32752056358,2340.94327947849,13,15,1,1
"923403817",58,2615.02204209234,2301.71391944585,2716.66249357165,33,25,1,1
"923403818",31,2666.82042849145,2804.97220720385,2390.15469389133,17,14,1,1
"923403819",21,2225.67106085539,2503.08995221253,2207.26116887512,13,8,1,1
"923403820",41,3133.04947687552,3013.59440609168,2530.72175773865,20,21,1,1
"923403821",15,2046.52747393938,2085.07598662493,2060.56118614118,7,8,1,1
"923403822",46,2999.70537952383,3325.18155659843,2590.94954296761,25,21,1,1
"923403823",38,2130.19777780153,1786.40899801442,2491.71993967651,19,19,1,1
"923403824",51,2451.26624064838,2128.9069312924,2646.17454577679,28,23,1,1
"923403825",31,2395.28048771436,2322.04554234,2390.15469389133,16,15,1,1
"923403826",47,3143.17243024394,3087.30293564728,2602.36394728806,21,26,1,1
"923403827",41,2696.5078645651,3064.33089534347,2530.72175773865,26,15,1,1
"923403828",41,2522.4030605734,2119.27389111734,2530.72175773865,19,22,1,1
"923403829",42,2957.31034829289,2773.99473186419,2543.21752514954,23,19,1,1
"923403830",43,2961.28518734205,2933.41307009112,2555.47878346624,20,23,1,1
"923403831",10,1821.48520519819,1802.15757996795,1896.67490607898,2,8,1,1
"923403832",62,3402.02256311845,3292.55200778751,2753.94837323248,27,35,1,1
"923403833",53,3128.5281058188,3214.08704637072,2667.061866114,25,28,1,1
"923403834",40,2472.92747155201,2380.70088215487,2517.98110851286,19,21,1,1
"923403835",34,2478.36066687389,2689.42688667932,2435.71163614839,15,19,1,1
"923403836",54,2719.68866311562,2556.83676145669,2677.2712016452,30,24,1,1
"923403837",47,3310.27382243698,3722.83370618318,2602.36394728806,23,24,1,1
"923403838",41,2586.40980772744,2509.56476044057,2530.72175773865,19,22,1,1
"923403839",31,2426.94532064294,2414.40512923593,2390.15469389133,12,19,1,1
"923403840",58,2713.41575561337,2761.80016059334,2716.66249357165,26,32,1,1
"923403841",73,3483.92372462751,4138.59680343482,2847.4358582506,31,42,1,1
"923403842",32,2332.43426085462,2208.43511707195,2405.71569249515,19,13,1,1
"923403843",46,3426.72827634983,3761.44643606751,2590.94954296761,17,29,1,1
"923403844",60,3460.82819425995,3544.76837097232,2735.5526890818,28,32,1,1
"923403845",15,2225.02274559565,2142.98098774116,2060.56118614118,4,11,1,1
"923403846",15,2232.85934530534,2214.81465944979,2060.56118614118,8,7,1,1
"923403847",36,2743.39494357665,2981.58071002512,2464.33502634194,16,20,1,1
"923403848",30,2415.20106827825,2423.56966352591,2374.18906024059,15,15,1,1
"923403849",56,3107.17006708546,3732.27297881208,2697.24673169728,19,37,1,1
"923403850",43,2763.84782551556,2763.88022457064,2555.47878346624,18,25,1,1
"923403851",58,2941.38705483899,2829.09075494993,2716.66249357165,26,32,1,1
"923403852",60,2573.44728916538,2405.19944700085,2735.5526890818,30,30,1,1
"923403853",12,1802.36698347703,1680.75903207812,1968.69006049611,5,7,1,1
"923403854",57,3607.99026752846,3528.62963544697,2707.02236739438,24,33,1,1
"923403855",13,1937.13160016453,2048.49511145919,2001.16379457045,6,7,1,1
"923403856",43,2734.67198750704,2815.43742544612,2555.47878346624,20,23,1,1
"923403857",47,2792.85703264143,3247.94462047327,2602.36394728806,20,27,1,1
"923403858",31,2517.4336530217,2643.7569020285,2390.15469389133,15,16,1,1
"923403859",46,3079.40735220721,3843.31790962074,2590.94954296761,20,26,1,1
"923403860",49,2920.70225554471,3000.80207860735,2624.62502504328,23,26,1,1
"923403861",34,2957.13468355391,2980.06711303291,2435.71163614839,13,21,1,1
"923403862",85,3384.85823621672,3229.51552851383,2937.40494579778,31,54,1,1
"923403863",39,3077.73505380284,2999.10084247187,2504.98447234734,16,23,1,1
"923403864",48,3192.14262289787,3046.35355933457,2613.58673801098,25,23,1,1
"923403865",48,2694.259110788,2681.12040674891,2613.58673801098,22,26,1,1
"923403866",38,2861.69051155269,3416.17785079318,2491.71993967651,20,18,1,1
"923403867",59,2812.36157139361,2917.02595034547,2726.17127719361,30,29,1,1
"923403868",36,2696.04063815133,2918.12911325985,2464.33502634194,16,20,1,1
"923403869",33,2132.44764270112,2279.31535936234,2420.89448855093,18,15,1,1
"923403870",47,3404.40865365016,3571.61459201702,2602.36394728806,19,28,1,1
"923403871",22,2216.54627070578,2280.2329270252,2228.3491786518,12,10,1,1
"923403872",47,3382.83966880783,3763.44447438887,2602.36394728806,15,32,1,1
"923403873",44,3151.57673319119,3212.32246405814,2567.51523707907,22,22,1,1
"923403874",38,2763.86302648593,2743.82245160693,2491.71993967651,18,20,1,1
"923403875",13,1819.18917428619,1646.74925105676,2001.16379457045,7,6,1,1
"923403876",47,2854.50483879191,3074.41172058196,2602.36394728806,23,24,1,1
"923403877",40,2784.26387029448,2637.37202201917,2517.98110851286,20,20,1,1
"923403878",30,2460.42001291911,2585.1502005542,2374.18906024059,12,18,1,1
"923403879",47,3226.68807513042,3144.6792292881,2602.36394728806,20,27,1,1
"923403880",65,3832.11808901022,3705.54477855164,2780.67589681985,27,38,1,1
"923403881",48,3311.21580926052,3859.16611383894,2613.58673801098,23,25,1,1
"923403882",31,2410.1311911814,2389.05294215053,2390.15469389133,17,14,1,1
"923403883",31,2294.83909112764,2173.78327542675,2390.15469389133,17,14,1,1
"923403884",23,2240.80339741708,2197.30238692958,2248.68783741607,12,11,1,1
"923403885",62,3256.22421108103,3152.40249140815,2753.94837323248,30,32,1,1
"923403886",24,2266.4400428273,2305.43418315785,2268.33468283819,13,11,1,1
"923403887",11,1839.22530680128,1756.44826170176,1933.98659929558,6,5,1,1
"923403888",55,3318.94697172184,3175.99490091765,2687.33120998132,20,35,1,1
"923403889",36,2600.36580407448,2768.10681772932,2464.33502634194,15,21,1,1
"923403890",39,2631.01610725259,2407.24704884453,2504.98447234734,19,20,1,1
"923403891",44,2570.35634524994,2316.25249285637,2567.51523707907,20,24,1,1
"923403892",29,2224.15541143698,2546.89483298631,2357.79423966008,14,15,1,1
"923403893",45,3301.67747975574,3403.76604939769,2579.33597919865,18,27,1,1
"923403894",33,2865.87976855712,3022.83684336313,2420.89448855093,11,22,1,1
"923403895",54,3296.66701190973,3502.01484877984,2677.2712016452,25,29,1,1
"923403896",55,3264.89674933669,3211.55111655995,2687.33120998132,23,32,1,1
"923403897",68,3247.54754669415,3364.68757301429,2806.43931339586,26,42,1,1
"923403898",27,2379.22377799986,2380.82956352079,2323.60649590586,13,14,1,1
"923403899",43,2798.67419412809,2922.94407136861,2555.47878346624,21,22,1,1
"923403900",45,2693.87619336858,3094.20378618654,2579.33597919865,19,26,1,1
"923403901",53,3141.98203895807,3538.5749151772,2667.061866114,22,31,1,1
"923403902",15,1870.27500801944,1622.62429087801,2060.56118614118,7,8,1,1
"923403903",65,3205.55924290336,2847.860075436,2780.67589681985,31,34,1,1
"923403904",35,2645.86554737418,2508.74654121125,2450.1860183293,15,20,1,1
"923403905",53,2981.89603936715,3029.37947226779,2667.061866114,23,30,1,1
"923403906",41,3282.73495259631,3851.28524960641,2530.72175773865,20,21,1,1
"923403907",23,2229.49462048388,2235.90523751076,2248.68783741607,13,10,1,1
"923403908",31,2807.45795382198,3124.05855085451,2390.15469389133,13,18,1,1
"923403909",33,2703.18895660703,2827.38663600021,2420.89448855093,14,19,1,1
"923403910",39,2793.11626517867,3039.16079287181,2504.98447234734,17,22,1,1
"923403911",28,2186.63885080999,2200.73709633888,2340.94327947849,15,13,1,1
"923403912",58,3330.31009495297,4094.80892092353,2716.66249357165,27,31,1,1
"923403913",45,3105.18673396453,3796.08086272034,2579.33597919865,19,26,1,1
"923403914",38,2675.90291477162,2668.0646060049,2491.71993967651,13,25,1,1
"923403915",47,2891.45756766937,3226.26103703307,2602.36394728806,18,29,1,1
"923403916",55,3752.66779768225,3810.41063247807,2687.33120998132,25,30,1,1
"923403917",52,3049.39451726991,2766.97111400361,2656.6981055205,21,31,1,1
"923403918",34,2731.29963214518,2496.08286925056,2435.71163614839,16,18,1,1
"923403919",69,2808.86579826829,2673.11832836385,2814.82611826518,33,36,1,1
"923403920",32,2107.89822098367,1947.29772993973,2405.71569249515,15,17,1,1
"923403921",70,2876.34568720128,2814.29469776802,2823.11677003184,29,41,1,1
"923403922",15,1888.33518544263,1763.26460989039,2060.56118614118,5,10,1,1
"923403952",37,3167.72166303769,3572.84800503229,2478.17471526668,21,16,1,1
"923403953",48,2857.68983162543,2702.51297231954,2613.58673801098,19,29,1,1
"923403954",61,2721.80167919089,2778.04709225761,2744.81051624266,27,34,1,1
"923403955",29,2338.19258273299,2563.3126373476,2357.79423966008,14,15,1,1
"923403956",36,3003.37943787274,3524.67692562277,2464.33502634194,12,24,1,1
"923403957",40,2681.60195934217,2942.9948206222,2517.98110851286,19,21,1,1
"923403958",57,3111.13037450912,3599.48479850299,2707.02236739438,25,32,1,1
"923403959",24,2450.77341583573,2348.44798461445,2268.33468283819,10,14,1,1
"923403960",52,3649.50600279713,3469.48069297557,2656.6981055205,25,27,1,1
"923403961",51,3478.1771982682,4094.37544849114,2646.17454577679,21,30,1,1
"923403962",30,2750.95968591164,3291.02081477798,2374.18906024059,13,17,1,1
"923403963",56,2813.38901163443,2933.78373704713,2697.24673169728,23,33,1,1
"923403964",59,3608.86970510968,3447.00594875378,2726.17127719361,31,28,1,1
"923403965",45,3259.64825463696,3608.85303250558,2579.33597919865,24,21,1,1
"923403966",59,3439.1685043843,3532.67576025988,2726.17127719361,28,31,1,1
"923403967",66,3049.17934531875,3312.80065154624,2789.3669207067,29,37,1,1
"923403968",31,2779.92290117875,3178.12545182642,2390.15469389133,17,14,1,1
"923403969",27,2492.2431614353,2705.43744068575,2323.60649590586,16,11,1,1
"923403970",68,3849.58971782366,4266.10774301889,2806.43931339586,27,41,1,1
"923403971",39,3114.58485871992,3476.42583184889,2504.98447234734,17,22,1,1
"923403972",42,3394.37071785666,3803.52817625308,2543.21752514954,21,21,1,1
"923403974",48,3572.18986768533,4060.75718687771,2613.58673801098,20,28,1,1
"923403975",37,2837.41492288592,3738.89211722774,2478.17471526668,13,24,1,1
"923403976",52,2970.17777591549,3121.63962201656,2656.6981055205,22,30,1,1
"923403977",27,2636.65042409828,2858.49652342176,2323.60649590586,12,15,1,1
"923403978",43,3056.61334116829,3291.1244472096,2555.47878346624,19,24,1,1
"923403979",41,3310.66574033475,4321.25464241352,2530.72175773865,17,24,1,1
"923403980",40,2760.11423837468,2984.59103602991,2517.98110851286,16,24,1,1
"923403981",48,3424.40737852042,4238.4790545752,2613.58673801098,24,24,1,1
"923403982",26,2543.74766819428,2606.44428158917,2305.75108410937,16,10,1,1
"923403983",22,2402.2871368594,2523.07234430768,2228.3491786518,10,12,1,1
"923403984",55,3522.00865250511,3112.79651199821,2687.33120998132,19,36,1,1
"923403985",33,2509.31149326645,2854.48346194647,2420.89448855093,18,15,1,1
"923403986",33,2835.15962231468,3102.19270935365,2420.89448855093,16,17,1,1
"923403987",74,3552.25919050135,2998.22378994453,2855.36548874306,32,42,1,1
"923403988",50,3635.8862975144,3908.03824058563,2635.48551585152,25,25,1,1
"923403989",55,3215.78773624618,3402.52082103098,2687.33120998132,25,30,1,1
"923403990",41,2759.88711615689,2705.87275206373,2530.72175773865,13,28,1,1
"923403991",62,3143.93203544959,2826.20587228158,2753.94837323248,26,36,1,1
"923403992",44,3203.29758945476,4050.31858436919,2567.51523707907,18,26,1,1
"923403993",64,3420.88254591456,2796.70366101934,2771.87783482774,36,28,1,1
"923403994",34,2754.57571062282,3339.31117791004,2435.71163614839,14,20,1,1
"923403995",35,2530.48927169637,2780.47620997621,2450.1860183293,16,19,1,1
"923403996",48,3102.84329063733,3488.36863923665,2613.58673801098,24,24,1,1
"923403997",49,3145.89638227051,3056.74778921505,2624.62502504328,25,24,1,1
"923403998",48,3279.94716658908,3969.81686585985,2613.58673801098,24,24,1,1
"923403999",66,3361.87860523257,3678.99683592567,2789.3669207067,32,34,1,1
"923404000",55,3452.5524323296,4036.22011767922,2687.33120998132,19,36,1,1
"923404001",42,3115.16178541955,3339.68848273111,2543.21752514954,17,25,1,1
"923404002",48,3254.95226913388,3799.0027238215,2613.58673801098,16,32,1,1
"923404003",28,2783.96778369143,2646.96681154354,2340.94327947849,10,18,1,1
"923404004",63,3582.24091070932,3322.65053336268,2762.96971264875,32,31,1,1
"923404005",44,3003.31701546452,2836.5868856252,2567.51523707907,18,26,1,1
"923404006",53,3344.93424796512,3077.18423493646,2667.061866114,29,24,1,1
"923404007",32,2665.36957475035,2927.92400225002,2405.71569249515,12,20,1,1
"923404008",56,3657.60696044985,3207.93439343676,2697.24673169728,24,32,1,1
"923404009",47,3056.32731759042,3066.03182736239,2602.36394728806,21,26,1,1
"923404010",76,3585.244408787,3540.06092677821,2870.97236507783,32,44,1,1
"923404011",41,3247.42776615644,3961.35636958746,2530.72175773865,16,25,1,1
"923404012",45,2933.67804596834,3207.29209227734,2579.33597919865,22,23,1,1
"923404013",54,3758.16612095483,3855.25032920033,2677.2712016452,22,32,1,1
"923404014",40,2674.22461363835,3195.56520116948,2517.98110851286,16,24,1,1
"923404015",49,3049.85507433214,2891.46487679647,2624.62502504328,17,32,1,1
"923404016",42,3034.06428235275,3281.70610292998,2543.21752514954,15,27,1,1
"923404017",51,2786.1868717687,2843.36671414577,2646.17454577679,20,31,1,1
"923404018",49,2655.86189901465,2787.86101350913,2624.62502504328,22,27,1,1
"923404019",44,2988.11803070327,3192.00038335223,2567.51523707907,24,20,1,1
"923404020",48,2991.26292247314,2901.04186289784,2613.58673801098,28,20,1,1
"923404021",38,2879.79802825275,3350.47681485903,2491.71993967651,17,21,1,1
"923404022",38,2835.43241890847,3083.10696990032,2491.71993967651,15,23,1,1
"923404023",43,2713.12968510493,2717.59940401883,2555.47878346624,16,27,1,1
"923404024",38,3000.91875184494,3141.41245270399,2491.71993967651,13,25,1,1
"923404025",37,2878.2398748252,2752.25913172536,2478.17471526668,14,23,1,1
"923404026",40,2874.16892860583,2838.23460287777,2517.98110851286,19,21,1,1
"923404027",40,2950.07380895987,2752.36616136288,2517.98110851286,17,23,1,1
"923404028",40,2899.5006995003,3077.12797505123,2517.98110851286,17,23,1,1
"923404029",53,2867.53998217115,2541.07963489188,2667.061866114,25,28,1,1
"923404030",58,2997.65044164417,3802.82256636253,2716.66249357165,26,32,1,1
"923404031",48,2975.56146283156,2490.23238212985,2613.58673801098,27,21,1,1
"923404032",52,2781.44603258651,3067.17549952943,2656.6981055205,24,28,1,1
"923404033",38,2963.84557923625,2642.24209454488,2491.71993967651,16,22,1,1
"923404034",37,3049.87297131068,3307.90745854003,2478.17471526668,16,21,1,1
"923404035",71,3492.30247352273,3612.88605640423,2831.31372136695,34,37,1,1
"923404036",53,3201.40687099269,3418.62983584179,2667.061866114,19,34,1,1
"923404037",60,3726.02267850377,3796.47406400621,2735.5526890818,26,34,1,1
"923404057",38,2793.2107378681,3225.7904331854,2491.71993967651,15,23,1,1
"923404058",42,2841.50966126411,3025.42747197007,2543.21752514954,18,24,1,1
"923404059",26,2753.80342911138,2708.99423958899,2305.75108410937,13,13,1,1
"923404060",46,3382.25331221228,3463.34521548458,2590.94954296761,22,24,1,1
"923404061",47,3135.93933121046,3292.48571914633,2602.36394728806,26,21,1,1
"923404062",32,2470.694000821,2312.26175929731,2405.71569249515,18,14,1,1
"923404063",33,2581.3008370327,2843.86201435087,2420.89448855093,12,21,1,1
"923404064",48,3515.07310835968,3932.8937753075,2613.58673801098,20,28,1,1
"923404065",47,2557.09712663152,2911.32931253507,2602.36394728806,17,30,1,1
"923404066",31,2346.94050106676,2394.75170068484,2390.15469389133,14,17,1,1
"923404067",44,2968.24215382778,2624.31129451152,2567.51523707907,23,21,1,1
"923404068",20,2300.29700822217,2471.4304147106,2185.35845629437,10,10,1,1
"923404069",36,3111.68373719586,3335.90545187132,2464.33502634194,18,18,1,1
"923404070",38,2668.02844333354,2656.88321085139,2491.71993967651,16,22,1,1
"923404071",30,2326.60312428912,2363.21281028426,2374.18906024059,12,18,1,1
"923404072",15,2050.88950019363,2019.95452783627,2060.56118614118,9,6,1,1
"923404077",16,1978.10773789307,1851.64416329281,2087.92318348224,9,7,1,1
"923404078",12,1865.33574407755,1724.10647044241,1968.69006049611,7,5,1,1
"923404079",19,2016.2081473682,1821.45132203007,2162.56636020013,12,7,1,1
"923404081",18,2168.2932258849,2064.49219755416,2138.79896507223,11,7,1,1
"923404082",21,2098.15574539683,1960.33571202024,2207.26116887512,10,11,1,1
"923404085",18,2012.88363638903,1808.18884593462,2138.79896507223,8,10,1,1
"923404088",25,2123.51880232027,2045.0998771791,2287.34065519221,13,12,1,1
"923404089",13,1884.06295487152,1706.53449613963,2001.16379457045,9,4,1,1
"923404090",18,2085.54097021424,2006.55951534834,2138.79896507223,11,7,1,1
"923404092",18,2026.96911044904,1770.56449512962,2138.79896507223,9,9,1,1
"923404094",14,1917.1215738816,1746.35292774887,2031.70713799962,5,9,1,1
"923404131",30,2502.29923286659,2676.21107948799,2374.18906024059,13,17,1,1
"923404132",32,2501.81036637891,2162.79267474276,2405.71569249515,15,17,1,1
"923404133",28,2673.42324506514,2797.00074699763,2340.94327947849,13,15,1,1
"923404134",39,2728.5610677971,2603.35589768792,2504.98447234734,19,20,1,1
"923404135",27,2534.02094608777,2388.3292443369,2323.60649590586,17,10,1,1
"923404136",36,2629.62174616776,2873.9093713387,2464.33502634194,15,21,1,1
"923404137",39,3053.55766213292,3728.99335379915,2504.98447234734,22,17,1,1
"923404138",27,2678.27584669205,2966.23475270691,2323.60649590586,19,8,1,1
"923404139",42,2514.58542792035,2467.5848384894,2543.21752514954,24,18,1,1
"923404140",43,2807.19443670231,2921.89216955467,2555.47878346624,22,21,1,1
"923404141",35,2721.29336674419,2758.12704967812,2450.1860183293,20,15,1,1
"923404142",39,2666.43093760469,2402.04195950024,2504.98447234734,22,17,1,1
"923404143",41,3017.95163785814,2611.7851031342,2530.72175773865,23,18,1,1
"923404144",34,2716.44992678796,2358.03831014106,2435.71163614839,15,19,1,1
"923404145",30,2593.32814854447,2049.10501214212,2374.18906024059,14,16,1,1
"923404146",27,2475.37859378197,2317.78302634878,2323.60649590586,13,14,1,1
"923404147",36,3224.58988631132,3670.8481734633,2464.33502634194,17,19,1,1
"923404148",49,3438.56418219025,3593.63318238439,2624.62502504328,22,27,1,1
"923404149",37,3044.34394117098,3115.54626240463,2478.17471526668,15,22,1,1
"923404150",32,2981.59545481529,3101.00395604925,2405.71569249515,10,22,1,1
"923404151",38,3017.64505006584,3318.85426462769,2491.71993967651,15,23,1,1
"923404152",45,3146.04757095544,3288.30788397588,2579.33597919865,20,25,1,1
"923404153",53,3468.56864291682,4585.85030749296,2667.061866114,28,25,1,1
"923404154",61,3206.69344855568,3696.42155077526,2744.81051624266,26,35,1,1
"923404155",45,3004.0748984373,3524.81188539839,2579.33597919865,18,27,1,1
"923404156",52,3312.38187501142,3761.44267393376,2656.6981055205,17,35,1,1
"923404157",52,3174.27175022725,3195.02898503023,2656.6981055205,19,33,1,1
"923404158",48,3265.525486076,3961.90528864908,2613.58673801098,20,28,1,1
"923404159",60,3467.26039047971,4038.07986073562,2735.5526890818,25,35,1,1
"923404160",56,3263.35804042129,2743.96718245287,2697.24673169728,20,36,1,1
"923404161",53,2958.13606248251,3188.09879596302,2667.061866114,18,35,1,1
"923404162",33,2789.13742205003,3422.2446210611,2420.89448855093,13,20,1,1
"923404163",52,3249.81175416587,3683.18178066024,2656.6981055205,21,31,1,1
"923404164",36,3014.07855803855,3267.86803435458,2464.33502634194,14,22,1,1
"923404165",55,3436.23190194887,4322.77316768496,2687.33120998132,22,33,1,1
"923404166",38,2795.70897173597,3405.53635366255,2491.71993967651,13,25,1,1
"923404167",63,3825.90995185137,3669.94753999787,2762.96971264875,28,35,1,1
"923404168",39,2811.19269206595,3121.7189185702,2504.98447234734,16,23,1,1
"923404169",27,2973.04335385696,3859.28316261654,2323.60649590586,7,20,1,1
"923404170",55,3142.44046021909,4039.8673655349,2687.33120998132,21,34,1,1
"923404171",24,2461.06723980669,2590.20621314853,2268.33468283819,10,14,1,1
"923404172",52,3802.35249053812,4145.4081590021,2656.6981055205,23,29,1,1
"923404173",49,3526.52950196467,4345.28393691422,2624.62502504328,21,28,1,1
"923404174",40,3059.65846738712,4276.0011848048,2517.98110851286,14,26,1,1
"923404175",50,3101.76828035673,3116.26005523498,2635.48551585152,20,30,1,1
"923404176",39,3222.74008070545,3439.74884772205,2504.98447234734,18,21,1,1
"923404177",34,2925.60644475381,3584.67693857201,2435.71163614839,11,23,1,1
"923404178",41,3049.69244993741,3712.64856566794,2530.72175773865,17,24,1,1
"923404179",56,3212.80327783495,3145.71745139576,2697.24673169728,20,36,1,1
"923404180",53,3235.37197177142,3520.62525618066,2667.061866114,23,30,1,1
"923404181",42,3352.40171049663,4373.00461776289,2543.21752514954,15,27,1,1
"923404182",60,4042.42007802805,3417.68504505554,2735.5526890818,19,41,1,1
"923404183",23,2796.5449090929,3255.16973808204,2248.68783741607,8,15,1,1
"923404184",53,3154.04689565476,3320.4291152878,2667.061866114,23,30,1,1
"923404185",44,2974.60334397732,3375.97748278703,2567.51523707907,17,27,1,1
"923404186",47,3144.77699489643,3356.06345820315,2602.36394728806,19,28,1,1
"923404187",35,3226.23876187045,3919.65083700581,2450.1860183293,15,20,1,1
"923404188",47,3094.4379472204,3836.95683754835,2602.36394728806,15,32,1,1
"923404189",49,3486.86393569691,4430.30421491119,2624.62502504328,22,27,1,1
"923404190",38,2894.63072646774,3157.44688983367,2491.71993967651,14,24,1,1
"923404191",55,3628.16910580714,4393.37959537064,2687.33120998132,23,32,1,1
"923404192",64,3856.13203752924,3577.05784977797,2771.87783482774,28,36,1,1
"923404193",39,2973.36525967389,3694.96271673514,2504.98447234734,13,26,1,1
"923404194",35,3095.29202149634,3012.40399932644,2450.1860183293,15,20,1,1
"923404195",56,3763.36175979246,5683.65084985695,2697.24673169728,27,29,1,1
"923404196",52,3560.15959320515,4623.54186576084,2656.6981055205,27,25,1,1
"923404197",33,3075.90100683523,3969.92198111342,2420.89448855093,11,22,1,1
"923404198",38,2965.15075374153,3135.35056034049,2491.71993967651,14,24,1,1
"923404199",34,2986.32677692377,3779.83454984819,2435.71163614839,11,23,1,1
"923404200",54,3151.30504827304,3920.43471319892,2677.2712016452,23,31,1,1
"923404201",49,3323.49074334749,3981.83248452232,2624.62502504328,20,29,1,1
"923404202",37,2668.36724011455,3204.16501715962,2478.17471526668,14,23,1,1
"923404203",58,3553.2255826496,4120.88045090418,2716.66249357165,22,36,1,1
"923404204",48,3257.42969532374,3760.39962948366,2613.58673801098,19,29,1,1
"923404205",60,3714.01196216924,4005.08674125161,2735.5526890818,27,33,1,1
"923404206",44,3164.64092775711,4183.02019577563,2567.51523707907,20,24,1,1
"923404207",39,3268.87003630889,3909.92215769817,2504.98447234734,15,24,1,1
"923404208",51,3276.8932305691,3983.85628405853,2646.17454577679,16,35,1,1
"923404209",52,3327.86447799645,3675.68492975518,2656.6981055205,16,36,1,1
"923404210",46,2837.78596811615,2860.85266788778,2590.94954296761,17,29,1,1
"923404211",40,2894.62242700063,3211.27033708038,2517.98110851286,14,26,1,1
"923404212",50,3648.97814353336,3821.58229023348,2635.48551585152,20,30,1,1
"923404213",44,3140.32107147042,3833.05380795246,2567.51523707907,17,27,1,1
"923404214",41,3313.48138977977,4292.97553917548,2530.72175773865,15,26,1,1
"923404215",42,3225.1523369617,4092.39706463303,2543.21752514954,15,27,1,1
"923404216",47,3256.07201045958,3549.6200499377,2602.36394728806,20,27,1,1
"923404217",52,2960.92746850451,2460.81279974599,2656.6981055205,23,29,1,1
"923404218",35,2690.98813201734,2944.32246798205,2450.1860183293,13,22,1,1
"923404219",40,3047.40831695338,3538.57966606458,2517.98110851286,17,23,1,1
"923404220",34,2692.67540184252,2857.03103654869,2435.71163614839,18,16,1,1
"923404221",37,2815.72765158194,3592.4205970226,2478.17471526668,16,21,1,1
"923404222",42,3099.58893607276,4013.1664532397,2543.21752514954,16,26,1,1
"923404223",57,3237.64303661088,3240.77154349381,2707.02236739438,20,37,1,1
"923404224",47,3087.5874829439,3362.1709494264,2602.36394728806,18,29,1,1
"923404225",44,3272.20951625692,4043.79077206382,2567.51523707907,21,23,1,1
"923404226",55,3388.11020113028,3675.94313642606,2687.33120998132,18,37,1,1
"923404227",64,4238.66645617666,6110.12854682019,2771.87783482774,34,30,1,1
"923404228",33,3029.63025460507,3883.05233735876,2420.89448855093,13,20,1,1
"923404229",41,3085.24461979712,3329.20089284318,2530.72175773865,20,21,1,1
"923404230",49,3080.90734283001,3265.90710798384,2624.62502504328,18,31,1,1
"923404232",54,2952.02746917499,3052.40616185395,2677.2712016452,18,36,1,1
"923404233",55,3401.75868598132,3623.6239806456,2687.33120998132,16,39,1,1
"923404234",25,2548.1982227531,2823.19245485697,2287.34065519221,9,16,1,1
"923404235",47,3257.47102662554,3489.12337237533,2602.36394728806,16,31,1,1
"923404236",45,2864.54903523208,2845.33888003922,2579.33597919865,12,33,1,1
"923404237",40,2910.57267112743,3151.8770985792,2517.98110851286,12,28,1,1
"923404238",42,3154.09871601138,3448.21885416186,2543.21752514954,15,27,1,1
"923404239",42,2490.66632546464,2458.30609216061,2543.21752514954,15,27,1,1
"923404240",64,3337.40196688773,4023.78273627835,2771.87783482774,18,46,1,1
"923404241",57,3198.38740230614,3822.17782891684,2707.02236739438,22,35,1,1
"923404242",50,2895.75250305782,3216.808413017,2635.48551585152,16,34,1,1
"923404243",49,3182.10100270943,3096.63491435917,2624.62502504328,18,31,1,1
"923404244",44,3119.59971127182,3575.85950424562,2567.51523707907,14,30,1,1
"923404245",32,2866.45919596169,3240.45777276222,2405.71569249515,15,17,1,1
"923404246",45,2972.51132800183,3113.43738533146,2579.33597919865,15,30,1,1
"923404247",18,2304.20456946721,2577.29735719931,2138.79896507223,5,13,1,1
"923404248",70,3264.54203678283,3261.03812225372,2823.11677003184,27,43,1,1
"923404249",32,2699.41777769197,2846.45111975619,2405.71569249515,9,23,1,1
"923404250",31,2745.54751004624,2835.4350824554,2390.15469389133,9,22,1,1
"923404251",57,2994.03572420711,3045.54866530077,2707.02236739438,21,36,1,1
"923404252",44,2920.29150399202,3427.72308503244,2567.51523707907,15,29,1,1
"923404253",44,3193.48526103891,3727.91956195473,2567.51523707907,16,28,1,1
"923404254",41,3044.21557907951,3231.92090500976,2530.72175773865,14,27,1,1
"923404255",42,3249.98380652138,3576.40617415409,2543.21752514954,15,27,1,1
"923404256",53,3377.30306619872,4038.25054048858,2667.061866114,20,33,1,1
"923404257",47,3108.13865999522,3512.95543957474,2602.36394728806,13,34,1,1
"923404258",34,2898.82530538361,3213.27575287157,2435.71163614839,12,22,1,1
"923404259",70,3327.43575244307,3402.04905998651,2823.11677003184,23,47,1,1
"923404260",30,2807.05539764999,3104.97108307316,2374.18906024059,11,19,1,1
"923404261",40,2840.25154670931,3170.28827056111,2517.98110851286,13,27,1,1
"923404262",57,3286.76954145191,3745.741496515,2707.02236739438,21,36,1,1
"923404263",58,3003.75199828798,3215.02786315582,2716.66249357165,18,40,1,1
"923404264",59,3157.9539707633,3223.91141044944,2726.17127719361,20,39,1,1
"923404265",77,3433.01469280645,3074.30904238264,2878.65357631343,26,51,1,1
"923404266",54,3127.71876679965,3619.7264562397,2677.2712016452,16,38,1,1
"923404267",52,3080.29063090614,3097.95398908527,2656.6981055205,18,34,1,1
"923404268",51,3563.17767930706,3582.5750390621,2646.17454577679,14,37,1,1
"923404269",24,2631.35975768065,2873.00447397034,2268.33468283819,8,16,1,1
"923404270",44,2944.6564914612,2742.82766194626,2567.51523707907,11,33,1,1
"923404271",52,2923.4641966934,3157.4152952415,2656.6981055205,17,35,1,1
"923404272",48,3098.62647370885,3148.39888452542,2613.58673801098,12,36,1,1
"923404273",43,2845.01574927944,2924.66093194089,2555.47878346624,15,28,1,1
"923404274",40,3032.85749542248,3474.10948711099,2517.98110851286,11,29,1,1
"923404275",49,3229.82359626332,3677.22081995139,2624.62502504328,17,32,1,1
"923404276",38,2618.77626041286,2926.37561997352,2491.71993967651,11,27,1,1
"923404277",45,2994.93551133122,3141.36809278839,2579.33597919865,15,30,1,1
"923404278",58,3600.2015860359,3866.49588918705,2716.66249357165,24,34,1,1
"923404279",72,3654.13049586607,4185.62063521765,2839.4193288992,36,36,1,1
"923404280",88,3802.85749646737,3631.93837509266,2958.30409156145,41,47,1,1
"923404281",83,3492.25042089869,3908.45805464548,2923.1438046077,41,42,1,1
"923404282",62,2931.75697487547,2826.39580890415,2753.94837323248,28,34,1,1
"923404283",48,3072.00426801183,3488.73300945693,2613.58673801098,24,24,1,1
"923404284",68,3977.45706897399,3607.93966355848,2806.43931339586,32,36,1,1
"923404285",40,2920.72577748776,2637.27962685016,2517.98110851286,20,20,1,1
"923404286",67,3774.09077582241,3662.9073766837,2797.95380131742,35,32,1,1
"923404287",66,3489.39039692271,3627.35882782812,2789.3669207067,33,33,1,1
"923404288",84,3847.38568414147,4097.46117377998,2930.30814451558,42,42,1,1
"923404289",78,4626.28280355699,4451.23340636283,2886.25582696583,37,41,1,1
"923404290",63,3185.11932172878,3423.08940456213,2762.96971264875,39,24,1,1
"923404291",66,3576.31734546154,3800.66634214053,2789.3669207067,28,38,1,1
"923404292",75,3706.17854551887,4387.85609669153,2863.21031780169,31,44,1,1
"923404293",82,4544.65809817605,5140.03120590863,2915.91045786314,37,45,1,1
"923404294",65,3609.2779547608,3866.78813793316,2780.67589681985,28,37,1,1
"923404295",45,3180.23830592207,3438.00742445435,2579.33597919865,20,25,1,1
"923404296",47,3077.34887386574,3752.14837622799,2602.36394728806,23,24,1,1
"923404297",93,3977.0734547553,2928.75597875645,2991.90921350397,40,53,1,1
"923404298",69,3803.95320719712,4327.74289341184,2814.82611826518,34,35,1,1
"923404299",89,3817.96431630934,5362.78142048608,2965.14449011489,44,45,1,1
"923404300",60,3841.09241794911,3948.30788720483,2735.5526890818,25,35,1,1
"923404301",54,3493.96238993663,3496.80075735952,2677.2712016452,24,30,1,1
"923404302",74,3399.56317563391,3859.36119472102,2855.36548874306,30,44,1,1
"923404303",65,3583.15484506452,3495.19687653344,2780.67589681985,30,35,1,1
"923404304",54,3197.55424417219,3212.99327361636,2677.2712016452,23,31,1,1
"923404305",56,3465.89368961935,3543.42046797559,2697.24673169728,27,29,1,1
"923404306",77,3944.69406862324,4309.46853858673,2878.65357631343,40,37,1,1
"923404307",88,3559.79427278778,3258.70397085616,2958.30409156145,45,43,1,1
"923404308",42,2973.7215604661,3236.45103144533,2543.21752514954,22,20,1,1
"923404309",84,4060.51433387627,4418.99125678536,2930.30814451558,44,40,1,1
"923404310",34,2617.10980380759,2921.66903814657,2435.71163614839,17,17,1,1
"923404311",64,3861.19299308853,4733.28444109521,2771.87783482774,31,33,1,1
"923404312",57,3473.80519026694,3375.81456453709,2707.02236739438,28,29,1,1
"923404313",79,3775.41389914693,4003.99524160203,2893.78092561085,35,44,1,1
"923404314",69,3689.6729262185,4298.11395444146,2814.82611826518,31,38,1,1
"923404315",61,3104.23146797293,3056.93519109375,2744.81051624266,28,33,1,1
