"survey_id","nb_species","aesthe_survey","aesthe_SR_survey","nb_sp_pos_survey","nb_sp_neg_survey","prop_biom_aesth","prop_abund_aesth"
"1003278",38,2834.62498779447,2491.71993967651,16,22,1,1
"1003281",26,2348.3955330821,2305.75108410937,16,10,1,1
"1003282",26,2582.84382574892,2305.75108410937,16,10,1,1
"1003283",32,2460.43063861493,2405.71569249515,19,13,1,1
"1003284",34,2718.18188826785,2435.71163614839,20,14,1,1
"1003285",35,2743.3359848579,2450.1860183293,17,18,1,1
"1003286",41,2744.97789181164,2530.72175773865,20,21,1,1
"1003287",34,2567.22400641361,2435.71163614839,18,16,1,1
"1003288",46,3040.40736146516,2590.94954296761,25,21,1,1
"1003289",32,2547.41485879721,2405.71569249515,17,15,1,1
"1003291",30,2677.64758321902,2374.18906024059,20,10,1,1
"1003292",31,2639.41341153123,2390.15469389133,16,15,1,1
"1003629",28,2675.94667683624,2340.94327947849,17,11,1,1
"1003630",19,2280.70103687933,2162.56636020013,12,7,1,1
"1003631",24,2462.410105185,2268.33468283819,16,8,1,1
"1003632",15,2183.26897049085,2060.56118614118,11,4,1,1
"1003633",31,2411.3331940583,2390.15469389133,19,12,1,1
"1003635",26,2481.96394900766,2305.75108410937,16,10,1,1
"1003636",36,2432.49383145624,2464.33502634194,20,16,1,1
"1003637",30,2541.68509720342,2374.18906024059,18,12,1,1
"1003638",28,2452.26260165818,2340.94327947849,16,12,1,1
"1003639",30,2501.42868359301,2374.18906024059,15,15,1,1
"1003640",30,2582.6435756512,2374.18906024059,15,15,1,1
"1003641",28,2445.9438538225,2340.94327947849,18,10,1,1
"1003642",38,2701.04012002581,2491.71993967651,23,15,1,1
"1003643",34,2514.65199497595,2435.71163614839,20,14,1,1
"1003644",25,2355.35119102894,2287.34065519221,14,11,1,1
"1003645",25,2480.40059982553,2287.34065519221,11,14,1,1
"1003646",38,2583.44275929517,2491.71993967651,16,22,1,1
"1003647",34,2359.26935431048,2435.71163614839,18,16,1,1
"1003648",32,2461.70219496895,2405.71569249515,16,16,1,1
"1003649",36,2533.32020116572,2464.33502634194,17,19,1,1
"1003650",33,2598.28841553419,2420.89448855093,18,15,1,1
"1003651",36,2287.12217380148,2464.33502634194,18,18,1,1
"1003652",30,2564.81528603248,2374.18906024059,15,15,1,1
"1003653",29,2456.29951076635,2357.79423966008,18,11,1,1
"1003654",26,2619.06051317686,2305.75108410937,15,11,1,1
"1003655",21,2312.81312920448,2207.26116887512,12,9,1,1
"1003656",19,2219.95727478835,2162.56636020013,12,7,1,1
"1003657",17,2225.89681257859,2113.95669457394,9,8,1,1
"1003658",36,2661.18799603537,2464.33502634194,20,16,1,1
"1003659",21,2601.4612787235,2207.26116887512,11,10,1,1
"1003660",24,2604.08930968113,2268.33468283819,13,11,1,1
"1003661",29,2667.47897551775,2357.79423966008,19,10,1,1
"1003662",29,2732.79012799436,2357.79423966008,17,12,1,1
"1003663",26,2670.03554075029,2305.75108410937,13,13,1,1
"1003664",27,2595.3425584543,2323.60649590586,15,12,1,1
"1003665",29,2537.95551978844,2357.79423966008,15,14,1,1
"1003666",34,2592.88070751434,2435.71163614839,18,16,1,1
"1003667",35,2809.69410757413,2450.1860183293,18,17,1,1
"1003668",30,2641.57232972808,2374.18906024059,18,12,1,1
"1003669",34,2855.92895277798,2435.71163614839,21,13,1,1
"1003670",35,2548.30479362694,2450.1860183293,16,19,1,1
"1003671",28,2636.39402594309,2340.94327947849,13,15,1,1
"1003672",31,2588.87312930491,2390.15469389133,16,15,1,1
"1003673",33,2687.8487434851,2420.89448855093,22,11,1,1
"1003674",30,2492.02543977643,2374.18906024059,19,11,1,1
"1003675",43,2776.19279041084,2555.47878346624,21,22,1,1
"1003676",30,2634.91753364299,2374.18906024059,20,10,1,1
"1003677",36,2586.64954443629,2464.33502634194,19,17,1,1
"1003678",34,2484.69075512989,2435.71163614839,19,15,1,1
"1003679",42,2780.82741913713,2543.21752514954,22,20,1,1
"1003680",39,2604.11114199515,2504.98447234734,19,20,1,1
"1003681",22,2438.28347379958,2228.3491786518,14,8,1,1
"1003682",31,2797.47383699023,2390.15469389133,15,16,1,1
"1003683",34,2633.45083639672,2435.71163614839,18,16,1,1
"1003684",42,2736.76117114097,2543.21752514954,21,21,1,1
"1003685",34,2817.05288094377,2435.71163614839,18,16,1,1
"1003686",33,2777.05759604396,2420.89448855093,14,19,1,1
"1003687",28,2548.93297717956,2340.94327947849,18,10,1,1
"1003688",39,2846.24637602979,2504.98447234734,24,15,1,1
"1003689",30,2527.42524841231,2374.18906024059,17,13,1,1
"1003690",33,2730.40402086587,2420.89448855093,18,15,1,1
"1003691",22,2421.32715584385,2228.3491786518,14,8,1,1
"1003692",22,2299.381811228,2228.3491786518,11,11,1,1
"1003693",25,2193.53471855977,2287.34065519221,14,11,1,1
"1003694",28,2481.07868958504,2340.94327947849,14,14,1,1
"1003695",28,2658.35733098227,2340.94327947849,14,14,1,1
"1003696",29,2606.43727260059,2357.79423966008,14,15,1,1
"1003697",31,2337.08270283158,2390.15469389133,16,15,1,1
"1003698",33,2679.08070832042,2420.89448855093,17,16,1,1
"1003699",27,2413.60555809978,2323.60649590586,15,12,1,1
"1003777",49,2831.15167862134,2624.62502504328,24,25,1,1
"1003778",51,2630.45235189563,2646.17454577679,25,26,1,1
"1003779",31,2735.23511969869,2390.15469389133,16,15,1,1
"1003780",21,2366.81256531015,2207.26116887512,12,9,1,1
"1003781",24,2423.9309805067,2268.33468283819,13,11,1,1
"1003782",36,2875.97397009262,2464.33502634194,22,14,1,1
"1003783",29,2730.63173973315,2357.79423966008,17,12,1,1
"1003784",44,2664.74611657279,2567.51523707907,21,23,1,1
"1003785",41,2629.61449942577,2530.72175773865,21,20,1,1
"1003786",43,2763.73899615362,2555.47878346624,23,20,1,1
"1003787",31,2658.45220989632,2390.15469389133,19,12,1,1
"1003793",44,2826.34643286085,2567.51523707907,19,25,1,1
"20003005",40,3324.0995538429,2517.98110851286,16,24,1,1
"20003006",47,3332.27209125963,2602.36394728806,18,29,1,1
"20003008",46,3298.22359630829,2590.94954296761,13,33,1,1
"20003009",48,3664.88636577173,2613.58673801098,17,31,1,1
"20003010",49,3251.52629745817,2624.62502504328,19,30,1,1
"20003011",42,3065.10445921299,2543.21752514954,14,28,1,1
"20003012",53,3646.71144962608,2667.061866114,21,32,1,1
"20003013",48,3427.61052281821,2613.58673801098,21,27,1,1
"20003014",60,3413.00366780833,2735.5526890818,21,39,1,1
"20003015",45,3456.28799862037,2579.33597919865,19,26,1,1
"20003016",50,3623.63217364735,2635.48551585152,17,33,1,1
"20003017",38,3005.31784256612,2491.71993967651,12,26,1,1
"2000937",21,2028.85815665794,2207.26116887512,1,20,1,1
"2000938",23,2359.26253393524,2248.68783741607,4,19,1,1
"2000939",18,2139.86997126847,2138.79896507223,3,15,1,1
"2000947",38,2346.66364428562,2491.71993967651,14,24,1,1
"2000948",25,2081.1584255493,2287.34065519221,11,14,1,1
"2000949",39,2616.27965689284,2504.98447234734,22,17,1,1
"2001049",24,2331.37903661541,2268.33468283819,9,15,1,1
"2001050",24,2202.71254275316,2268.33468283819,12,12,1,1
"2001051",36,2559.21651367958,2464.33502634194,14,22,1,1
"2001052",28,2444.37262272357,2340.94327947849,10,18,1,1
"2001053",38,2614.29584986469,2491.71993967651,17,21,1,1
"2001054",25,2453.05550431888,2287.34065519221,10,15,1,1
"2001055",36,2599.82982212037,2464.33502634194,17,19,1,1
"2001056",31,2611.85504796245,2390.15469389133,11,20,1,1
"2001057",26,2428.99583344858,2305.75108410937,15,11,1,1
"2001133",27,2390.13354035093,2323.60649590586,13,14,1,1
"2001134",36,2688.17874671735,2464.33502634194,23,13,1,1
"2001135",23,2409.02248030612,2248.68783741607,13,10,1,1
"2001136",35,2599.27790147041,2450.1860183293,17,18,1,1
"2001137",17,2197.46342312394,2113.95669457394,6,11,1,1
"2001138",35,2311.6749691139,2450.1860183293,18,17,1,1
"2001139",27,2328.88817684734,2323.60649590586,11,16,1,1
"2001140",24,2323.14859847725,2268.33468283819,12,12,1,1
"2001398",55,2635.80152890205,2687.33120998132,33,22,1,1
"2001400",43,2208.48351473994,2555.47878346624,20,23,1,1
"2001401",41,2406.18855778121,2530.72175773865,29,12,1,1
"2001402",10,1705.13139868383,1896.67490607898,4,6,1,1
"2001589",14,2241.28487582665,2031.70713799962,9,5,1,1
"2001803",18,2054.02051203019,2138.79896507223,8,10,1,1
"2001804",10,1729.82938505451,1896.67490607898,4,6,1,1
"2001805",15,2134.10778471234,2060.56118614118,11,4,1,1
"2001806",12,2015.7212409227,1968.69006049611,8,4,1,1
"2001807",25,2393.69734404422,2287.34065519221,17,8,1,1
"2001808",13,2034.35904618216,2001.16379457045,9,4,1,1
"2001809",15,2039.46466562871,2060.56118614118,9,6,1,1
"2001810",19,2218.90189762662,2162.56636020013,10,9,1,1
"2001811",11,1896.38159601978,1933.98659929558,7,4,1,1
"2001812",16,2094.17749714537,2087.92318348224,10,6,1,1
"2001813",8,1787.96454794621,1812.11073017574,2,6,1,1
"2001814",9,1847.69845723534,1856.26587460569,4,5,1,1
"2001815",12,1838.98151221517,1968.69006049611,5,7,1,1
"2001816",12,1853.40283955381,1968.69006049611,5,7,1,1
"2001817",15,1990.99419165286,2060.56118614118,7,8,1,1
"2001818",11,1858.54986384923,1933.98659929558,3,8,1,1
"2001819",10,1816.68342012049,1896.67490607898,5,5,1,1
"2001820",11,1843.78135922556,1933.98659929558,6,5,1,1
"2001821",12,1912.26469969288,1968.69006049611,5,7,1,1
"2001822",15,1915.82292245126,2060.56118614118,7,8,1,1
"2001823",13,1909.4165277014,2001.16379457045,5,8,1,1
"2001824",14,1940.18354564436,2031.70713799962,6,8,1,1
"2001825",19,2017.63936522416,2162.56636020013,9,10,1,1
"2001826",15,1968.79233198726,2060.56118614118,6,9,1,1
"2001827",20,2104.20147240521,2185.35845629437,8,12,1,1
"2001828",17,1946.18848453394,2113.95669457394,6,11,1,1
"2001829",14,1859.41213534795,2031.70713799962,8,6,1,1
"2001830",15,2022.5916786886,2060.56118614118,7,8,1,1
"2001831",21,2064.15160091279,2207.26116887512,11,10,1,1
"2001832",16,2165.53046936271,2087.92318348224,9,7,1,1
"2001833",14,2035.71991909811,2031.70713799962,8,6,1,1
"2001836",11,1795.22979572148,1933.98659929558,4,7,1,1
"2001837",8,1733.26800831205,1812.11073017574,3,5,1,1
"2002627",35,2620.19677918659,2450.1860183293,15,20,1,1
"2002628",43,2725.88532273135,2555.47878346624,21,22,1,1
"2002629",17,1993.63522492389,2113.95669457394,6,11,1,1
"2002630",19,2039.97214568395,2162.56636020013,7,12,1,1
"34003023",9,1808.10099530742,1856.26587460569,1,8,1,1
"34003024",9,1867.44897213749,1856.26587460569,1,8,1,1
"34003025",12,1804.92486865922,1968.69006049611,3,9,1,1
"34003026",13,2063.94331799144,2001.16379457045,3,10,1,1
"34003027",14,1931.05106186539,2031.70713799962,4,10,1,1
"34003028",18,1970.08049232677,2138.79896507223,5,13,1,1
"34003029",12,1828.32834696806,1968.69006049611,1,11,1,1
"34003030",9,1743.62050284292,1856.26587460569,0,9,1,1
"34003031",11,1819.430887132,1933.98659929558,1,10,1,1
"34003032",17,1821.95268447975,2113.95669457394,3,14,1,1
"34003949",8,1751.9808982029,1812.11073017574,2,6,1,1
"34003950",12,1872.32467972822,1968.69006049611,2,10,1,1
"34003951",12,1886.38907072356,1968.69006049611,1,11,1,1
"34003952",10,1835.44778156629,1896.67490607898,3,7,1,1
"34003953",12,1840.00696416031,1968.69006049611,3,9,1,1
"34003954",19,2025.70626655349,2162.56636020013,6,13,1,1
"34003955",9,1910.92994005712,1856.26587460569,3,6,1,1
"34003956",11,1833.77076226637,1933.98659929558,4,7,1,1
"34003957",12,1889.87498053508,1968.69006049611,3,9,1,1
"34003958",11,1909.28979376428,1933.98659929558,2,9,1,1
"34003959",17,1970.23822134552,2113.95669457394,6,11,1,1
"34003960",14,1812.33655071369,2031.70713799962,1,13,1,1
"34003961",12,1814.70667154732,1968.69006049611,1,11,1,1
"34003962",8,1719.00145946379,1812.11073017574,1,7,1,1
"34003963",15,1774.00910849377,2060.56118614118,4,11,1,1
"4000676",51,2838.97373446788,2646.17454577679,35,16,1,1
"4000677",43,2957.45454910646,2555.47878346624,31,12,1,1
"4000678",58,3803.02696441624,2716.66249357165,35,23,1,1
"4000679",53,3398.95200993357,2667.061866114,34,19,1,1
"4000680",62,3270.55072754752,2753.94837323248,41,21,1,1
"4000681",50,2863.64165943155,2635.48551585152,35,15,1,1
"4000682",40,2965.10288052632,2517.98110851286,23,17,1,1
"4000683",56,3333.24205809306,2697.24673169728,37,19,1,1
"4000684",61,3409.59200818289,2744.81051624266,43,18,1,1
"4000685",63,3313.79563162932,2762.96971264875,36,27,1,1
"4000686",59,3383.95374675793,2726.17127719361,38,21,1,1
"4000687",65,3841.87092131542,2780.67589681985,39,26,1,1
"4000688",51,3295.47194670539,2646.17454577679,30,21,1,1
"4000689",53,3271.37747703959,2667.061866114,28,25,1,1
"4000690",33,2552.14638085486,2420.89448855093,18,15,1,1
"4000691",51,2920.82945346857,2646.17454577679,32,19,1,1
"4000692",65,3617.63971569543,2780.67589681985,34,31,1,1
"4000693",57,2956.13413358554,2707.02236739438,37,20,1,1
"4000694",61,3307.95302647243,2744.81051624266,28,33,1,1
"4000695",44,3159.76676744579,2567.51523707907,29,15,1,1
"4000696",52,3215.53666931168,2656.6981055205,33,19,1,1
"4000697",65,3589.64052602984,2780.67589681985,34,31,1,1
"4000698",61,3188.32779197544,2744.81051624266,26,35,1,1
"4000699",67,3381.26663660316,2797.95380131742,37,30,1,1
"4000700",68,3448.16086004132,2806.43931339586,42,26,1,1
"4000701",81,3803.23352482605,2908.60658576875,48,33,1,1
"4000702",77,4020.79472241304,2878.65357631343,40,37,1,1
"4000703",78,3682.83600265447,2886.25582696583,39,39,1,1
"4000704",79,3703.94447271522,2893.78092561085,40,39,1,1
"4000705",78,3348.6113974196,2886.25582696583,38,40,1,1
"4000706",75,3728.50856247415,2863.21031780169,35,40,1,1
"4000707",29,2447.76515609753,2357.79423966008,18,11,1,1
"4000708",30,2313.09712725386,2374.18906024059,18,12,1,1
"4000709",38,2946.98478878107,2491.71993967651,21,17,1,1
"4000710",40,2878.19409315176,2517.98110851286,24,16,1,1
"4000711",30,2574.66126808553,2374.18906024059,20,10,1,1
"4000712",33,2785.12398916148,2420.89448855093,22,11,1,1
"4000713",45,2818.372492883,2579.33597919865,25,20,1,1
"4000714",28,2432.88608918238,2340.94327947849,16,12,1,1
"4000715",59,3565.59695426965,2726.17127719361,33,26,1,1
"4000717",82,3678.74386852482,2915.91045786314,45,37,1,1
"4000718",5,1655.31085269617,1646.12614877363,4,1,1,1
"4000719",5,1678.44084857242,1646.12614877363,3,2,1,1
"4000720",74,3423.75406685944,2855.36548874306,42,32,1,1
"4000721",68,3503.18543375585,2806.43931339586,45,23,1,1
"4000722",60,3338.74205569643,2735.5526890818,38,22,1,1
"4000723",70,3000.93346340142,2823.11677003184,41,29,1,1
"4000724",40,2486.65214505205,2517.98110851286,23,17,1,1
"4000725",58,2844.96396903092,2716.66249357165,36,22,1,1
"4000726",49,2808.88553814535,2624.62502504328,27,22,1,1
"4000728",76,3891.75195479251,2870.97236507783,45,31,1,1
"4000729",48,2727.2497319768,2613.58673801098,31,17,1,1
"4000730",67,3462.44662661138,2797.95380131742,42,25,1,1
"4000731",56,3032.98634000228,2697.24673169728,29,27,1,1
"4000732",89,3504.83104025609,2965.14449011489,52,37,1,1
"4000734",50,2907.7236913652,2635.48551585152,27,23,1,1
"4000735",45,2772.58971438039,2579.33597919865,25,20,1,1
"4000736",66,3481.81012945347,2789.3669207067,41,25,1,1
"4000737",52,2769.66073101013,2656.6981055205,31,21,1,1
"4000738",41,2694.13259390713,2530.72175773865,31,10,1,1
"4000739",40,2683.99685593164,2517.98110851286,25,15,1,1
"4000740",45,2938.1856890486,2579.33597919865,24,21,1,1
"4000741",39,2247.31135268909,2504.98447234734,26,13,1,1
"4000742",52,3048.77890848786,2656.6981055205,32,20,1,1
"4000743",43,3106.55061885539,2555.47878346624,28,15,1,1
"4000744",54,3398.50491734729,2677.2712016452,37,17,1,1
"4000745",43,2754.75327517648,2555.47878346624,31,12,1,1
"4000746",53,2604.90998809626,2667.061866114,32,21,1,1
"4000747",40,2521.84002100799,2517.98110851286,22,18,1,1
"4000748",51,2891.10856558403,2646.17454577679,37,14,1,1
"4000749",33,2487.40615822125,2420.89448855093,19,14,1,1
"4000750",54,2862.83616658186,2677.2712016452,30,24,1,1
"4000751",55,3205.77096581072,2687.33120998132,35,20,1,1
"4000752",62,2586.21980613006,2753.94837323248,33,29,1,1
"4000753",61,2471.43740083515,2744.81051624266,32,29,1,1
"4000754",63,2567.9583659293,2762.96971264875,33,30,1,1
"4000755",21,2247.48598041427,2207.26116887512,12,9,1,1
"4000756",26,2288.14594372439,2305.75108410937,12,14,1,1
"4000757",39,2182.21794608879,2504.98447234734,23,16,1,1
"4000758",29,2393.81693148576,2357.79423966008,16,13,1,1
"4000759",31,2526.23195321211,2390.15469389133,18,13,1,1
"4000760",18,2203.45376643352,2138.79896507223,12,6,1,1
"4000761",24,2076.27081372403,2268.33468283819,12,12,1,1
"4000762",16,2012.60779622151,2087.92318348224,10,6,1,1
"4000763",13,1975.87497581097,2001.16379457045,7,6,1,1
"4000764",20,2166.07370479253,2185.35845629437,11,9,1,1
"4000765",26,2298.04334897869,2305.75108410937,15,11,1,1
"4000766",16,2156.25045842833,2087.92318348224,9,7,1,1
"4000767",36,2347.2085287568,2464.33502634194,21,15,1,1
"4000768",29,2538.24730569101,2357.79423966008,19,10,1,1
"4000769",25,2008.79058823987,2287.34065519221,13,12,1,1
"4000770",20,2090.34368884549,2185.35845629437,13,7,1,1
"4000771",21,2080.23111181513,2207.26116887512,11,10,1,1
"4000772",22,2026.42341137504,2228.3491786518,13,9,1,1
"4000773",34,2136.57989522122,2435.71163614839,19,15,1,1
"4000774",34,2217.96331541978,2435.71163614839,14,20,1,1
"4000775",39,2585.78270983515,2504.98447234734,25,14,1,1
"4000776",43,2745.09979298867,2555.47878346624,27,16,1,1
"4000777",28,2358.25098844486,2340.94327947849,18,10,1,1
"4000778",44,2656.86097270482,2567.51523707907,27,17,1,1
"4000779",36,2541.47445568856,2464.33502634194,17,19,1,1
"4000781",24,2272.36953733295,2268.33468283819,18,6,1,1
"4000782",26,2282.41743201092,2305.75108410937,16,10,1,1
"4000783",26,2299.57268667946,2305.75108410937,16,10,1,1
"4000784",27,2477.34213020172,2323.60649590586,16,11,1,1
"4000785",25,2239.10561479252,2287.34065519221,17,8,1,1
"4000786",32,2404.39779640438,2405.71569249515,21,11,1,1
"4000787",34,2470.3738567433,2435.71163614839,17,17,1,1
"4000789",29,2436.14434443222,2357.79423966008,13,16,1,1
"4000790",52,2541.97510027713,2656.6981055205,27,25,1,1
"4000791",21,2253.61839874286,2207.26116887512,11,10,1,1
"4000792",22,2147.04711035856,2228.3491786518,11,11,1,1
"4000793",30,2432.44247293475,2374.18906024059,16,14,1,1
"4000794",24,2230.7502765124,2268.33468283819,13,11,1,1
"4000795",21,2262.68448754295,2207.26116887512,10,11,1,1
"4000797",53,2805.21893173181,2667.061866114,34,19,1,1
"4000798",42,2769.05575453328,2543.21752514954,26,16,1,1
"4000799",75,3186.32272022233,2863.21031780169,46,29,1,1
"4000800",52,2688.06059339506,2656.6981055205,30,22,1,1
"4000801",49,2598.5387553862,2624.62502504328,26,23,1,1
"4000802",35,2561.5301924251,2450.1860183293,14,21,1,1
"4000803",27,2164.8629610007,2323.60649590586,15,12,1,1
"4000804",22,2037.95117490153,2228.3491786518,13,9,1,1
"4000805",52,2379.67417322641,2656.6981055205,28,24,1,1
"4000806",54,2708.99736088694,2677.2712016452,30,24,1,1
"4000807",64,2369.75629590649,2771.87783482774,37,27,1,1
"4000808",62,2506.85137114732,2753.94837323248,37,25,1,1
"4000809",20,1989.36955988761,2185.35845629437,10,10,1,1
"4000810",8,1679.66106448818,1812.11073017574,5,3,1,1
"4000811",37,2314.14072709694,2478.17471526668,16,21,1,1
"4000814",36,2468.65774323012,2464.33502634194,19,17,1,1
"4000815",42,2908.35039482764,2543.21752514954,27,15,1,1
"4000816",13,1938.53891623808,2001.16379457045,7,6,1,1
"4000817",13,1851.79019980864,2001.16379457045,8,5,1,1
"4000818",23,2206.34921741014,2248.68783741607,12,11,1,1
"4000819",18,2205.27205174198,2138.79896507223,9,9,1,1
"4000820",25,2152.70628640934,2287.34065519221,13,12,1,1
"4000821",32,2404.10819820835,2405.71569249515,17,15,1,1
"4000822",26,2471.78734533863,2305.75108410937,10,16,1,1
"4000823",24,2327.00551396492,2268.33468283819,12,12,1,1
"4000824",22,2186.88783918688,2228.3491786518,9,13,1,1
"4000825",22,2320.75699839122,2228.3491786518,10,12,1,1
"4000826",19,2015.73059578381,2162.56636020013,10,9,1,1
"4000827",21,2203.4996462242,2207.26116887512,8,13,1,1
"4000828",17,2006.40697732692,2113.95669457394,8,9,1,1
"4000829",15,2109.57882856652,2060.56118614118,7,8,1,1
"4000830",33,2439.0174816841,2420.89448855093,16,17,1,1
"4000831",29,2279.85346780535,2357.79423966008,12,17,1,1
"4000832",35,2442.4626731828,2450.1860183293,21,14,1,1
"4000833",39,2497.71104950275,2504.98447234734,21,18,1,1
"4000834",22,2187.00073716091,2228.3491786518,12,10,1,1
"4000835",21,2206.91368311757,2207.26116887512,10,11,1,1
"4000836",27,2095.20530219985,2323.60649590586,13,14,1,1
"4000837",21,2199.49563363744,2207.26116887512,12,9,1,1
"4000838",22,2277.11717826787,2228.3491786518,13,9,1,1
"4000839",27,2119.50536522352,2323.60649590586,13,14,1,1
"4000840",17,1924.34518613862,2113.95669457394,10,7,1,1
"4000841",18,1932.67784348059,2138.79896507223,11,7,1,1
"4000842",24,1811.26570758289,2268.33468283819,16,8,1,1
"4000843",18,1854.06287296908,2138.79896507223,11,7,1,1
"4000844",32,2612.82924564158,2405.71569249515,21,11,1,1
"4000845",46,2402.98725208151,2590.94954296761,26,20,1,1
"4000846",40,2569.631989664,2517.98110851286,24,16,1,1
"4000847",38,2694.71377689059,2491.71993967651,17,21,1,1
"4000848",43,2673.47321899797,2555.47878346624,26,17,1,1
"4000849",40,2728.94156390808,2517.98110851286,23,17,1,1
"4000850",36,2478.11409410845,2464.33502634194,21,15,1,1
"4000851",39,2631.77019230314,2504.98447234734,23,16,1,1
"4000852",42,2557.69346054107,2543.21752514954,24,18,1,1
"4000853",35,2467.31419698903,2450.1860183293,21,14,1,1
"506002951",36,2046.20806196969,2464.33502634194,16,20,1,1
"506002952",24,2319.42728204573,2268.33468283819,14,10,1,1
"506002953",27,2584.75123585933,2323.60649590586,17,10,1,1
"506002954",32,2463.8044185157,2405.71569249515,19,13,1,1
"506002955",12,1871.5389428377,1968.69006049611,6,6,1,1
"506002956",27,2433.1027349047,2323.60649590586,14,13,1,1
"506002957",28,2458.77625134812,2340.94327947849,15,13,1,1
"506002958",23,2432.81609908715,2248.68783741607,12,11,1,1
"506002959",26,2404.033875477,2305.75108410937,13,13,1,1
"506002960",30,2440.47311894707,2374.18906024059,15,15,1,1
"506002961",31,2202.94707188968,2390.15469389133,13,18,1,1
"506002962",26,2376.95182394045,2305.75108410937,10,16,1,1
"506002963",29,2530.04320360724,2357.79423966008,15,14,1,1
"506002964",27,2281.97191822897,2323.60649590586,12,15,1,1
"506002965",21,2175.41577083148,2207.26116887512,11,10,1,1
"506002966",18,2250.43155180938,2138.79896507223,8,10,1,1
"506002967",31,2424.66551647047,2390.15469389133,14,17,1,1
"506002968",30,2413.66671574287,2374.18906024059,14,16,1,1
"506002969",29,2529.37586837388,2357.79423966008,17,12,1,1
"506002970",22,2180.37045958567,2228.3491786518,11,11,1,1
"506002971",28,2505.25533956159,2340.94327947849,15,13,1,1
"506002972",30,2245.91127406445,2374.18906024059,17,13,1,1
"506002973",25,2216.95699101291,2287.34065519221,13,12,1,1
"506002975",31,2464.24757555703,2390.15469389133,16,15,1,1
"506002976",33,2527.17137945003,2420.89448855093,17,16,1,1
"506002977",19,2182.03305833342,2162.56636020013,10,9,1,1
"506002979",11,1902.08772745515,1933.98659929558,3,8,1,1
"506002980",16,2008.61063003792,2087.92318348224,6,10,1,1
"506002981",15,1955.63136559859,2060.56118614118,5,10,1,1
"506002982",20,2010.18644630441,2185.35845629437,8,12,1,1
"506002983",8,1764.1632345173,1812.11073017574,3,5,1,1
"506002984",13,1905.23343480211,2001.16379457045,5,8,1,1
"506002985",6,1673.0448577904,1708.62817714657,3,3,1,1
"506002986",12,1926.14720097264,1968.69006049611,5,7,1,1
"506002987",21,2118.58419618038,2207.26116887512,9,12,1,1
"506002988",14,1960.5231354411,2031.70713799962,7,7,1,1
"506002989",14,1814.05302771633,2031.70713799962,4,10,1,1
"506002991",21,2070.31453541412,2207.26116887512,7,14,1,1
"506002993",14,1981.91514786739,2031.70713799962,6,8,1,1
"506002994",32,2283.66022398438,2405.71569249515,13,19,1,1
"506002995",31,2378.03934378408,2390.15469389133,12,19,1,1
"506002996",28,2218.76229472498,2340.94327947849,13,15,1,1
"506002997",22,2183.34454056055,2228.3491786518,11,11,1,1
"506002998",20,2238.48977164884,2185.35845629437,9,11,1,1
"506002999",31,2340.27290408579,2390.15469389133,15,16,1,1
"506003000",33,2312.52145312993,2420.89448855093,18,15,1,1
"506003002",24,2142.85154715042,2268.33468283819,10,14,1,1
"506003003",27,2248.74299191477,2323.60649590586,13,14,1,1
"506003004",29,2119.68916989021,2357.79423966008,16,13,1,1
"506003331",28,2445.68948350173,2340.94327947849,15,13,1,1
"506003332",17,2140.4480304032,2113.95669457394,8,9,1,1
"506003333",24,2517.81992552839,2268.33468283819,12,12,1,1
"506003335",25,2507.73723297566,2287.34065519221,14,11,1,1
"506003336",27,2547.24489336807,2323.60649590586,16,11,1,1
"506003337",30,2468.83888346621,2374.18906024059,17,13,1,1
"506003338",26,2493.23645825615,2305.75108410937,14,12,1,1
"506003339",28,2487.58069859858,2340.94327947849,15,13,1,1
"506003340",28,2472.95348092428,2340.94327947849,17,11,1,1
"506003341",18,2304.80848581155,2138.79896507223,11,7,1,1
"506003342",29,2675.72618298288,2357.79423966008,16,13,1,1
"506003343",18,2233.95672324488,2138.79896507223,13,5,1,1
"506003344",27,2530.13012452812,2323.60649590586,16,11,1,1
"506003346",28,2473.670595837,2340.94327947849,18,10,1,1
"506003348",29,2570.78669734975,2357.79423966008,18,11,1,1
"506003349",31,2499.05851806213,2390.15469389133,17,14,1,1
"506003351",26,2439.71853231181,2305.75108410937,16,10,1,1
"506003352",29,2427.64743538355,2357.79423966008,15,14,1,1
"506003353",31,2311.29213898832,2390.15469389133,18,13,1,1
"506003355",26,2390.09322450449,2305.75108410937,13,13,1,1
"506003356",31,2656.03299188518,2390.15469389133,16,15,1,1
"506003357",27,2513.9459282376,2323.60649590586,15,12,1,1
"506003358",31,2518.90742827731,2390.15469389133,18,13,1,1
"506003359",32,2469.41362386338,2405.71569249515,19,13,1,1
"506003360",38,2505.2306243658,2491.71993967651,19,19,1,1
"506003361",27,2444.61474231696,2323.60649590586,16,11,1,1
"506003362",26,2425.03334515255,2305.75108410937,14,12,1,1
"506003363",28,2428.48196258624,2340.94327947849,16,12,1,1
"506003364",14,2054.35283348887,2031.70713799962,10,4,1,1
"506003700",31,2534.25265706353,2390.15469389133,18,13,1,1
"506003704",28,2531.0332983362,2340.94327947849,14,14,1,1
"506003705",27,2427.10821814824,2323.60649590586,14,13,1,1
"506003707",27,2332.28247868926,2323.60649590586,14,13,1,1
"506003708",23,2459.81675162248,2248.68783741607,10,13,1,1
"506003709",30,2567.06580041077,2374.18906024059,15,15,1,1
"506003710",25,2508.20215718779,2287.34065519221,15,10,1,1
"506003711",30,2597.07653883739,2374.18906024059,15,15,1,1
"506003712",31,2463.17362502272,2390.15469389133,16,15,1,1
"506003805",29,2480.55589430642,2357.79423966008,12,17,1,1
"506003807",32,2639.27604863904,2405.71569249515,18,14,1,1
"506003808",28,2578.99058822686,2340.94327947849,15,13,1,1
"506003809",32,2778.72971640015,2405.71569249515,17,15,1,1
"506003810",27,2392.87795902157,2323.60649590586,15,12,1,1
"506003811",28,2418.35069913712,2340.94327947849,16,12,1,1
"506003812",26,2294.52392737907,2305.75108410937,14,12,1,1
"506003815",22,2273.51349330658,2228.3491786518,13,9,1,1
"506003816",24,2396.62942684247,2268.33468283819,14,10,1,1
"506003817",22,2394.18160769387,2228.3491786518,13,9,1,1
"506003818",28,2381.16103827076,2340.94327947849,15,13,1,1
"506003820",28,2472.03733257801,2340.94327947849,14,14,1,1
"506003821",33,2466.79222214429,2420.89448855093,17,16,1,1
"506003822",30,2067.35957499874,2374.18906024059,12,18,1,1
"506003823",12,1906.82313968172,1968.69006049611,5,7,1,1
"506003824",15,2023.27393140089,2060.56118614118,6,9,1,1
"506003825",11,1905.27334320762,1933.98659929558,5,6,1,1
"506003826",15,1903.63708959423,2060.56118614118,6,9,1,1
"506003827",18,2030.90800930726,2138.79896507223,8,10,1,1
"506003828",12,1885.33204130552,1968.69006049611,5,7,1,1
"506003829",15,2081.72803051315,2060.56118614118,7,8,1,1
"506003831",11,1895.25629761039,1933.98659929558,6,5,1,1
"506003832",13,1836.90851898589,2001.16379457045,4,9,1,1
"506003833",11,1830.23295065836,1933.98659929558,7,4,1,1
"506003834",29,2072.88731465556,2357.79423966008,12,17,1,1
"506003835",15,2093.17951000867,2060.56118614118,6,9,1,1
"506003836",15,2149.95106055979,2060.56118614118,8,7,1,1
"506003837",12,1856.1557954602,1968.69006049611,4,8,1,1
"506003838",20,2155.35751126558,2185.35845629437,10,10,1,1
"506003839",24,2406.69695296908,2268.33468283819,12,12,1,1
"506003840",25,2222.38517603563,2287.34065519221,12,13,1,1
"506003841",25,2324.78176199598,2287.34065519221,12,13,1,1
"506003842",27,2446.38775897951,2323.60649590586,14,13,1,1
"506003843",22,2267.24312143746,2228.3491786518,9,13,1,1
"506003844",30,2588.07356648457,2374.18906024059,17,13,1,1
"506003846",21,2027.23111739262,2207.26116887512,11,10,1,1
"507003166",33,2342.74415066433,2420.89448855093,17,16,1,1
"507003167",34,2379.45368019413,2435.71163614839,14,20,1,1
"507003168",24,2311.34719604146,2268.33468283819,12,12,1,1
"507003169",23,2416.04614190917,2248.68783741607,9,14,1,1
"507003170",30,2205.85849124785,2374.18906024059,13,17,1,1
"507003171",27,2116.94357913478,2323.60649590586,9,18,1,1
"507003172",34,2146.77282077856,2435.71163614839,15,19,1,1
"507003173",21,2224.61383111824,2207.26116887512,9,12,1,1
"507003174",25,2058.9756055214,2287.34065519221,10,15,1,1
"507003176",32,2135.58297202715,2405.71569249515,14,18,1,1
"507003177",39,2051.72619498421,2504.98447234734,16,23,1,1
"507003178",29,2358.3294509905,2357.79423966008,14,15,1,1
"507003179",25,2303.3103848073,2287.34065519221,10,15,1,1
"507003180",30,2211.23491984021,2374.18906024059,14,16,1,1
"507003181",23,2365.53255333767,2248.68783741607,11,12,1,1
"507003182",27,2196.5616902422,2323.60649590586,13,14,1,1
"507003183",22,2114.87843874536,2228.3491786518,11,11,1,1
"507003184",22,2101.41143859003,2228.3491786518,7,15,1,1
"507003185",20,2146.12582714041,2185.35845629437,10,10,1,1
"507003186",12,1851.19780089252,1968.69006049611,5,7,1,1
"507003187",23,2312.63341008003,2248.68783741607,11,12,1,1
"507003189",15,2076.95397214658,2060.56118614118,5,10,1,1
"507003190",29,2361.71870953771,2357.79423966008,15,14,1,1
"507003191",30,2289.0461780485,2374.18906024059,15,15,1,1
"507003192",16,2194.31823744272,2087.92318348224,8,8,1,1
"507003193",24,2284.46017507149,2268.33468283819,14,10,1,1
"507003194",27,2312.38704541544,2323.60649590586,13,14,1,1
"507003195",36,2282.0672185194,2464.33502634194,16,20,1,1
"507003196",29,2251.11403845776,2357.79423966008,15,14,1,1
"507003198",26,2371.05008673086,2305.75108410937,13,13,1,1
"507003199",27,2341.26438247548,2323.60649590586,13,14,1,1
"507003200",22,2260.67552003031,2228.3491786518,10,12,1,1
"507003201",29,2266.35593981256,2357.79423966008,13,16,1,1
"507003202",23,2109.20155781293,2248.68783741607,13,10,1,1
"507003203",30,2314.78933737968,2374.18906024059,15,15,1,1
"507003204",20,2130.11528642578,2185.35845629437,10,10,1,1
"507003205",31,2277.17686830558,2390.15469389133,14,17,1,1
"507003206",25,2314.21665695027,2287.34065519221,12,13,1,1
"507003207",39,2090.77595792413,2504.98447234734,20,19,1,1
"507003208",31,2390.54769641933,2390.15469389133,14,17,1,1
"507003209",10,1912.76075586253,1896.67490607898,3,7,1,1
"507003210",26,2372.48157228172,2305.75108410937,11,15,1,1
"507003211",26,2424.58151521473,2305.75108410937,14,12,1,1
"507003212",17,2140.75408119703,2113.95669457394,10,7,1,1
"507003213",25,2346.58727593473,2287.34065519221,13,12,1,1
"507003214",37,2245.77503106768,2478.17471526668,16,21,1,1
"507003215",31,2397.27316819639,2390.15469389133,17,14,1,1
"507003216",20,2332.88194580118,2185.35845629437,12,8,1,1
"507003217",24,2248.81803804564,2268.33468283819,11,13,1,1
"507003218",31,2293.97727812119,2390.15469389133,13,18,1,1
"507003219",33,2591.17907229307,2420.89448855093,17,16,1,1
"507003220",33,2344.89037266576,2420.89448855093,17,16,1,1
"507003221",29,2355.61084956937,2357.79423966008,14,15,1,1
"507003222",23,2344.25457159623,2248.68783741607,10,13,1,1
"507003223",18,2276.60128753032,2138.79896507223,8,10,1,1
"507003224",37,1966.03547112528,2478.17471526668,14,23,1,1
"507003225",26,2245.38976377059,2305.75108410937,11,15,1,1
"507003226",32,2423.19990874436,2405.71569249515,12,20,1,1
"507003227",31,2107.11133902027,2390.15469389133,13,18,1,1
"507003228",24,2277.50727185543,2268.33468283819,11,13,1,1
"507003229",28,2346.46098051103,2340.94327947849,15,13,1,1
"507003230",28,2282.3633164529,2340.94327947849,14,14,1,1
"507003231",22,2104.32044252417,2228.3491786518,10,12,1,1
"507003232",35,2122.89561488248,2450.1860183293,13,22,1,1
"507003233",22,2099.6856361504,2228.3491786518,8,14,1,1
"507003234",26,2296.04522204895,2305.75108410937,16,10,1,1
"507003235",21,2109.2204000657,2207.26116887512,9,12,1,1
"507003236",32,2174.72458312593,2405.71569249515,14,18,1,1
"507003237",27,2154.23424022858,2323.60649590586,13,14,1,1
"507003238",31,2068.1137994746,2390.15469389133,12,19,1,1
"507003524",20,2137.72296658383,2185.35845629437,9,11,1,1
"507003525",35,2576.91706489187,2450.1860183293,19,16,1,1
"507003526",27,2439.41363353072,2323.60649590586,12,15,1,1
"507003527",21,2302.66310814207,2207.26116887512,11,10,1,1
"507003528",19,2190.78825197271,2162.56636020013,9,10,1,1
"507003529",22,2274.81205707427,2228.3491786518,12,10,1,1
"507003530",23,2384.19068037739,2248.68783741607,12,11,1,1
"507003531",19,2148.89953338623,2162.56636020013,10,9,1,1
"507003532",25,2534.98651313842,2287.34065519221,11,14,1,1
"507003533",26,2497.38609052352,2305.75108410937,14,12,1,1
"507003534",22,2362.43730479699,2228.3491786518,10,12,1,1
"507003535",23,2219.18487446282,2248.68783741607,13,10,1,1
"507003536",26,2562.4542735594,2305.75108410937,12,14,1,1
"507003537",30,2217.45415989586,2374.18906024059,14,16,1,1
"507003538",20,2241.12249953623,2185.35845629437,11,9,1,1
"507003539",24,2350.30191942643,2268.33468283819,14,10,1,1
"507003540",24,2334.64331589993,2268.33468283819,12,12,1,1
"507003541",23,2288.71631036413,2248.68783741607,11,12,1,1
"507003542",21,2379.44480850509,2207.26116887512,11,10,1,1
"507003543",21,2264.43783801785,2207.26116887512,12,9,1,1
"507003545",23,2416.91872543795,2248.68783741607,10,13,1,1
"507003546",25,2361.37519848145,2287.34065519221,11,14,1,1
"507003547",25,2363.12279723598,2287.34065519221,13,12,1,1
"507003548",19,2276.6816769551,2162.56636020013,9,10,1,1
"507003549",30,2295.9036997507,2374.18906024059,15,15,1,1
"507003550",28,2475.95889007782,2340.94327947849,17,11,1,1
"507003551",25,2284.71954337594,2287.34065519221,13,12,1,1
"507003552",23,2403.00068858584,2248.68783741607,12,11,1,1
"507003553",22,2342.57488589157,2228.3491786518,13,9,1,1
"507003555",29,2283.61478473365,2357.79423966008,13,16,1,1
"507003556",22,2336.75430111673,2228.3491786518,10,12,1,1
"507003557",26,2429.11290681364,2305.75108410937,12,14,1,1
"507003558",23,2377.02670013243,2248.68783741607,11,12,1,1
"507003559",25,2286.65379379079,2287.34065519221,8,17,1,1
"507003560",17,2270.36032117853,2113.95669457394,10,7,1,1
"507003561",27,2330.17166042308,2323.60649590586,12,15,1,1
"507003562",27,2380.76300510683,2323.60649590586,13,14,1,1
"507003563",19,2289.22256128223,2162.56636020013,9,10,1,1
"507003564",28,2175.55686616995,2340.94327947849,16,12,1,1
"507003565",28,2292.67492398286,2340.94327947849,16,12,1,1
"507003566",31,2409.93409958757,2390.15469389133,16,15,1,1
"507003567",23,2321.15326714981,2248.68783741607,11,12,1,1
"507003568",27,2298.82050309365,2323.60649590586,13,14,1,1
"507003569",19,2359.1343431946,2162.56636020013,11,8,1,1
"507003570",23,2193.88804278359,2248.68783741607,12,11,1,1
"507003571",18,2275.16406463432,2138.79896507223,9,9,1,1
"507003572",20,2284.70389483844,2185.35845629437,9,11,1,1
"507003573",16,2235.01481665176,2087.92318348224,8,8,1,1
"507003574",23,2391.4467206548,2248.68783741607,12,11,1,1
"507003575",17,2244.03978579429,2113.95669457394,9,8,1,1
"507003576",24,2349.2741672682,2268.33468283819,11,13,1,1
"507003577",21,2198.83766577348,2207.26116887512,13,8,1,1
"507003578",35,2219.05968386389,2450.1860183293,17,18,1,1
"507003579",22,2221.04196591236,2228.3491786518,12,10,1,1
"507003580",30,2315.23271734226,2374.18906024059,14,16,1,1
"507003581",25,2169.2943498306,2287.34065519221,14,11,1,1
"507003582",15,2181.01921718296,2060.56118614118,6,9,1,1
"507003583",27,2230.23855561984,2323.60649590586,11,16,1,1
"507003584",24,2349.72767898506,2268.33468283819,11,13,1,1
"507003585",14,2006.98653489769,2031.70713799962,6,8,1,1
"507003586",17,2180.39935338105,2113.95669457394,9,8,1,1
"507003587",26,2296.6384166974,2305.75108410937,13,13,1,1
"507003588",27,2318.41331715024,2323.60649590586,14,13,1,1
"507003589",22,2376.24520493406,2228.3491786518,14,8,1,1
"507003590",22,2173.64513061672,2228.3491786518,11,11,1,1
"507003591",29,2278.88293541458,2357.79423966008,14,15,1,1
"507003592",14,2069.14142942113,2031.70713799962,8,6,1,1
"507003593",23,2284.38113872935,2248.68783741607,12,11,1,1
"507003594",18,2326.19867973249,2138.79896507223,8,10,1,1
"507003595",29,2439.86184398061,2357.79423966008,14,15,1,1
"507003596",17,2074.55709707599,2113.95669457394,9,8,1,1
"507003597",25,2331.29726537753,2287.34065519221,13,12,1,1
"507003598",17,2264.14958592069,2113.95669457394,8,9,1,1
"507003599",20,2243.99617443829,2185.35845629437,12,8,1,1
"507003600",19,2258.99742289763,2162.56636020013,11,8,1,1
"507003601",19,2206.00199818472,2162.56636020013,10,9,1,1
"507003602",20,2084.68184098651,2185.35845629437,11,9,1,1
"507003603",25,2148.44793433365,2287.34065519221,13,12,1,1
"507003604",26,2187.31131700153,2305.75108410937,16,10,1,1
"507003605",22,2221.9206142951,2228.3491786518,10,12,1,1
"507003606",20,2212.03882473021,2185.35845629437,8,12,1,1
"507003607",29,2478.99421844264,2357.79423966008,14,15,1,1
"507003608",27,2485.00544252981,2323.60649590586,12,15,1,1
"507003609",24,2319.58021075808,2268.33468283819,13,11,1,1
"507003610",22,2365.97908444906,2228.3491786518,13,9,1,1
"507003611",21,2189.14255854564,2207.26116887512,9,12,1,1
"507003612",29,2447.10916671696,2357.79423966008,14,15,1,1
"507003613",28,2192.55083572198,2340.94327947849,15,13,1,1
"507003614",22,2216.9912275749,2228.3491786518,13,9,1,1
"507003615",31,2504.64491173443,2390.15469389133,13,18,1,1
"507003616",16,2081.69492130494,2087.92318348224,6,10,1,1
"507003617",25,2334.275977672,2287.34065519221,12,13,1,1
"507003618",20,2319.7974688168,2185.35845629437,9,11,1,1
"507003619",36,2509.39364720317,2464.33502634194,18,18,1,1
"507003620",30,2336.41721705412,2374.18906024059,15,15,1,1
"507003621",22,2249.21584346334,2228.3491786518,8,14,1,1
"507003622",35,2409.82298183449,2450.1860183293,18,17,1,1
"507003623",30,2430.42400810638,2374.18906024059,16,14,1,1
"507003624",26,2359.4006056846,2305.75108410937,15,11,1,1
"507003627",36,2455.54638009974,2464.33502634194,18,18,1,1
"507003628",23,2260.44294758562,2248.68783741607,9,14,1,1
"507003794",17,2022.32868031583,2113.95669457394,8,9,1,1
"507003795",20,2059.4289539606,2185.35845629437,8,12,1,1
"507003798",21,2345.44686936719,2207.26116887512,11,10,1,1
"507003799",23,2387.81094359955,2248.68783741607,11,12,1,1
"507003801",32,2207.94015239376,2405.71569249515,12,20,1,1
"507003802",32,2470.79556451497,2405.71569249515,14,18,1,1
"507003803",25,2431.54359332801,2287.34065519221,11,14,1,1
"507003804",29,2453.87689435826,2357.79423966008,15,14,1,1
"507003847",25,2445.5482282584,2287.34065519221,13,12,1,1
"507003848",20,2021.47861558272,2185.35845629437,9,11,1,1
"507003849",24,2272.23907958624,2268.33468283819,10,14,1,1
"507003850",19,2094.17922152125,2162.56636020013,7,12,1,1
"507003851",18,2146.52152420787,2138.79896507223,7,11,1,1
"507003852",25,2335.0850294717,2287.34065519221,11,14,1,1
"507003854",24,2368.54541642638,2268.33468283819,11,13,1,1
"507003855",30,2311.03888949463,2374.18906024059,15,15,1,1
"507003856",26,2423.36307409941,2305.75108410937,12,14,1,1
"507003857",24,2434.33594610817,2268.33468283819,11,13,1,1
"507003858",22,2362.05840289253,2228.3491786518,11,11,1,1
"507003859",28,2445.04198471396,2340.94327947849,14,14,1,1
"507003860",27,2439.65943947853,2323.60649590586,12,15,1,1
"507003861",21,2356.69689655376,2207.26116887512,11,10,1,1
"507003862",24,2192.4508168981,2268.33468283819,13,11,1,1
"507003863",25,2423.27351729072,2287.34065519221,12,13,1,1
"507003864",29,2427.86615396389,2357.79423966008,13,16,1,1
"507003865",26,2248.15866406236,2305.75108410937,12,14,1,1
"507003866",24,2313.25817068061,2268.33468283819,13,11,1,1
"507003867",24,2033.99669996403,2268.33468283819,13,11,1,1
"507003868",25,2506.84542556771,2287.34065519221,12,13,1,1
"507003869",20,2299.97754704161,2185.35845629437,12,8,1,1
"507003870",22,2261.51317560464,2228.3491786518,11,11,1,1
"507003871",22,2383.75282504365,2228.3491786518,12,10,1,1
"507003872",46,2273.39939843322,2590.94954296761,21,25,1,1
"507003873",29,2409.91941698104,2357.79423966008,14,15,1,1
"507003874",6,1764.97896283994,1708.62817714657,2,4,1,1
"507003875",10,1956.02822938319,1896.67490607898,4,6,1,1
"507003876",29,2407.95204992845,2357.79423966008,13,16,1,1
"507003877",29,2393.26497593926,2357.79423966008,15,14,1,1
"507003878",13,2029.49709125056,2001.16379457045,6,7,1,1
"507003879",22,2298.15281082495,2228.3491786518,11,11,1,1
"507003880",30,2150.89574663002,2374.18906024059,14,16,1,1
"507003881",23,2389.60987255065,2248.68783741607,13,10,1,1
"507003882",26,2327.51173263381,2305.75108410937,16,10,1,1
"507003883",27,2349.63108868451,2323.60649590586,14,13,1,1
"507003884",25,2241.03105899695,2287.34065519221,10,15,1,1
"507003885",22,2371.09072016696,2228.3491786518,13,9,1,1
"507003886",25,2431.12195555712,2287.34065519221,13,12,1,1
"507003887",15,2117.21424581443,2060.56118614118,8,7,1,1
"507003888",40,2211.72831576266,2517.98110851286,18,22,1,1
"507003889",21,2303.51289874544,2207.26116887512,9,12,1,1
"507003890",22,2157.00542764736,2228.3491786518,8,14,1,1
"507003891",23,2252.05696808143,2248.68783741607,9,14,1,1
"507003892",26,2202.73532778118,2305.75108410937,11,15,1,1
"507003893",28,2253.83496446022,2340.94327947849,12,16,1,1
"507003894",26,2352.9105563665,2305.75108410937,15,11,1,1
"507003895",32,2428.38410438846,2405.71569249515,14,18,1,1
"507003896",29,2209.27763766363,2357.79423966008,13,16,1,1
"507003897",25,2254.75317864376,2287.34065519221,12,13,1,1
"507003898",12,2031.78672382575,1968.69006049611,4,8,1,1
"507003899",24,2261.66080723597,2268.33468283819,10,14,1,1
"507003900",16,2076.96610976421,2087.92318348224,6,10,1,1
"507003901",31,2182.62209693827,2390.15469389133,16,15,1,1
"507003902",24,2298.68906098077,2268.33468283819,13,11,1,1
"507003903",28,2160.73663407546,2340.94327947849,12,16,1,1
"507003904",25,2185.30204522184,2287.34065519221,14,11,1,1
"507003905",16,1943.05925288885,2087.92318348224,8,8,1,1
"507003906",25,2123.81116333876,2287.34065519221,14,11,1,1
"507003907",34,2012.49458952356,2435.71163614839,13,21,1,1
"57003305",18,2280.99350499666,2138.79896507223,11,7,1,1
"57003306",17,2209.13042333456,2113.95669457394,11,6,1,1
"57003307",18,2141.59076907762,2138.79896507223,11,7,1,1
"57003308",15,2084.86133382223,2060.56118614118,8,7,1,1
"57003309",20,2102.13005662588,2185.35845629437,11,9,1,1
"57003310",19,2191.49751481817,2162.56636020013,10,9,1,1
"57003311",18,2234.02710598499,2138.79896507223,10,8,1,1
"57003312",19,2112.42678606329,2162.56636020013,10,9,1,1
"57003313",13,2018.7715270662,2001.16379457045,8,5,1,1
"57003314",14,1997.7693457557,2031.70713799962,7,7,1,1
"57003315",18,2261.72256552117,2138.79896507223,10,8,1,1
"57003316",22,2295.44325355482,2228.3491786518,14,8,1,1
"57003317",19,2178.81303251183,2162.56636020013,11,8,1,1
"57003319",21,2316.62654931956,2207.26116887512,12,9,1,1
"57003320",18,2099.88775241917,2138.79896507223,9,9,1,1
"57003321",18,2049.54773010014,2138.79896507223,9,9,1,1
"57003322",16,2208.34745204319,2087.92318348224,8,8,1,1
"57003323",15,2129.17723177292,2060.56118614118,8,7,1,1
"57003325",19,2240.90098986228,2162.56636020013,10,9,1,1
"57003326",19,2380.19461786154,2162.56636020013,11,8,1,1
"57003327",15,2061.40129619515,2060.56118614118,8,7,1,1
"57003328",23,2300.62089891788,2248.68783741607,12,11,1,1
"593003373",13,1843.43819178516,2001.16379457045,6,7,1,1
"593003374",13,1933.81457726046,2001.16379457045,5,8,1,1
"593003377",16,2019.453161029,2087.92318348224,6,10,1,1
"593003378",15,1902.5679498231,2060.56118614118,5,10,1,1
"593003379",18,2022.86650309514,2138.79896507223,4,14,1,1
"593003383",15,1912.26347065746,2060.56118614118,6,9,1,1
"593003384",12,1873.01118448724,1968.69006049611,5,7,1,1
"593003385",14,1899.00313274996,2031.70713799962,4,10,1,1
"593003386",10,1927.25507802579,1896.67490607898,5,5,1,1
"593003387",14,1969.89690058383,2031.70713799962,5,9,1,1
"593003388",14,1955.76272137633,2031.70713799962,6,8,1,1
"593003389",15,1972.0955908285,2060.56118614118,4,11,1,1
"593003390",11,1913.29016836903,1933.98659929558,5,6,1,1
"593003391",12,1793.33923164056,1968.69006049611,2,10,1,1
"593003392",14,1949.10698595651,2031.70713799962,5,9,1,1
"593003393",18,2040.86657067279,2138.79896507223,5,13,1,1
"593003394",19,2059.9556889973,2162.56636020013,7,12,1,1
"593003395",21,1887.19223851144,2207.26116887512,4,17,1,1
"593003396",14,2034.45228761881,2031.70713799962,4,10,1,1
"593003397",11,1896.97621257655,1933.98659929558,4,7,1,1
"593003398",10,1868.70330379259,1896.67490607898,3,7,1,1
"593003399",15,2070.52024183046,2060.56118614118,6,9,1,1
"593003400",18,1969.77257655354,2138.79896507223,5,13,1,1
"593003401",18,2031.3477313793,2138.79896507223,5,13,1,1
"593003402",18,1930.10320132307,2138.79896507223,5,13,1,1
"593003403",13,1996.48686468998,2001.16379457045,4,9,1,1
"593003404",20,1969.77593422651,2185.35845629437,5,15,1,1
"593003405",18,2033.409233538,2138.79896507223,5,13,1,1
"593003406",16,2031.1157335249,2087.92318348224,5,11,1,1
"593003407",10,1969.9889185291,1896.67490607898,4,6,1,1
"593003408",15,1911.97489925675,2060.56118614118,4,11,1,1
"593003409",14,1942.83942765065,2031.70713799962,4,10,1,1
"593003410",5,1608.16461373379,1646.12614877363,1,4,1,1
"593003411",12,1890.98050601602,1968.69006049611,4,8,1,1
"593003412",10,1861.28360590645,1896.67490607898,4,6,1,1
"593003413",11,1884.9372661916,1933.98659929558,3,8,1,1
"593003415",13,1997.09002272507,2001.16379457045,5,8,1,1
"593003416",10,1865.04267968037,1896.67490607898,3,7,1,1
"593003417",12,2032.81999038331,1968.69006049611,5,7,1,1
"593003418",12,1937.43241736947,1968.69006049611,4,8,1,1
"593003419",12,1848.5006267704,1968.69006049611,3,9,1,1
"593003420",17,1930.62353632154,2113.95669457394,4,13,1,1
"593003421",9,1789.50933050387,1856.26587460569,2,7,1,1
"593003422",11,1957.46573401627,1933.98659929558,6,5,1,1
"593003423",21,2247.91745305084,2207.26116887512,9,12,1,1
"593003424",20,2301.68000487512,2185.35845629437,10,10,1,1
"593003425",15,2116.05777532133,2060.56118614118,10,5,1,1
"593003426",15,2100.07740942526,2060.56118614118,7,8,1,1
"593003427",9,1844.84191922719,1856.26587460569,4,5,1,1
"593003428",17,2125.30352758269,2113.95669457394,8,9,1,1
"593003429",25,2150.39757460685,2287.34065519221,8,17,1,1
"593003431",16,2094.78668564887,2087.92318348224,6,10,1,1
"593003432",12,1943.29918621866,1968.69006049611,6,6,1,1
"593003433",18,1923.40950724253,2138.79896507223,6,12,1,1
"593003434",22,2110.61106473479,2228.3491786518,8,14,1,1
"593003447",21,2240.58136130614,2207.26116887512,8,13,1,1
"593003448",26,2251.53002557583,2305.75108410937,12,14,1,1
"593003449",19,2168.35428719283,2162.56636020013,8,11,1,1
"593003454",26,2065.57954820137,2305.75108410937,11,15,1,1
"593003455",18,2138.1871063256,2138.79896507223,10,8,1,1
"593003456",13,2040.00619778406,2001.16379457045,6,7,1,1
"593003457",28,2374.78946978638,2340.94327947849,15,13,1,1
"593003464",18,2334.4183208199,2138.79896507223,11,7,1,1
"593003465",23,2391.73529137595,2248.68783741607,14,9,1,1
"593003466",23,2401.54216920161,2248.68783741607,12,11,1,1
"593003467",22,2240.13317399719,2228.3491786518,11,11,1,1
"593003468",23,2393.47027692408,2248.68783741607,12,11,1,1
"593003469",21,2342.992034631,2207.26116887512,11,10,1,1
"593003470",20,2352.15141362522,2185.35845629437,11,9,1,1
"593003471",23,2403.0581132811,2248.68783741607,12,11,1,1
"593003472",23,2170.55940957126,2248.68783741607,11,12,1,1
"593003473",27,2329.51846555075,2323.60649590586,17,10,1,1
"593003474",27,2312.27149420927,2323.60649590586,15,12,1,1
"593003475",23,2315.38316831879,2248.68783741607,13,10,1,1
"593003476",34,2331.44222881382,2435.71163614839,17,17,1,1
"593003478",15,2233.03569787869,2060.56118614118,5,10,1,1
"593003479",21,2405.06135717318,2207.26116887512,11,10,1,1
"593003482",17,2196.81081281427,2113.95669457394,6,11,1,1
"593003483",23,2261.91612913636,2248.68783741607,12,11,1,1
"593003484",18,2383.86845998563,2138.79896507223,7,11,1,1
"593003485",21,2148.25342970161,2207.26116887512,11,10,1,1
"593003487",18,2201.79783867646,2138.79896507223,9,9,1,1
"593003488",16,2087.87851623604,2087.92318348224,7,9,1,1
"593003490",22,2358.42138553151,2228.3491786518,10,12,1,1
"593003491",19,2190.29272476416,2162.56636020013,9,10,1,1
"593003492",17,2179.56229897191,2113.95669457394,10,7,1,1
"593003493",20,2380.14142871877,2185.35845629437,11,9,1,1
"593003494",22,2422.00227368772,2228.3491786518,12,10,1,1
"593003495",26,2112.6066468841,2305.75108410937,14,12,1,1
"593003496",17,1998.13009292036,2113.95669457394,9,8,1,1
"593003497",27,2153.44975090611,2323.60649590586,15,12,1,1
"593003498",18,2111.78182718583,2138.79896507223,9,9,1,1
"593003503",22,2227.31502263104,2228.3491786518,10,12,1,1
"593003505",16,2026.24779272014,2087.92318348224,7,9,1,1
"593003507",21,1996.92297959245,2207.26116887512,10,11,1,1
"593003508",12,1972.64326418567,1968.69006049611,5,7,1,1
"593003509",25,2176.89198023756,2287.34065519221,11,14,1,1
"593003510",15,2139.46565287206,2060.56118614118,8,7,1,1
"593003511",15,2248.02653570121,2060.56118614118,8,7,1,1
"593003512",16,2077.24374656199,2087.92318348224,8,8,1,1
"593003513",19,2090.71112081279,2162.56636020013,10,9,1,1
"593003514",23,2196.2528236628,2248.68783741607,11,12,1,1
"593003515",24,2258.61057057909,2268.33468283819,9,15,1,1
"593003516",13,2060.90392056512,2001.16379457045,7,6,1,1
"593003517",26,2069.54891523393,2305.75108410937,10,16,1,1
"593003518",16,2099.55531708028,2087.92318348224,7,9,1,1
"593003519",16,2086.98708393174,2087.92318348224,7,9,1,1
"593003520",25,2162.38265753077,2287.34065519221,11,14,1,1
"593003521",23,2109.22529959787,2248.68783741607,10,13,1,1
"593003522",23,2210.13677882468,2248.68783741607,9,14,1,1
"593003523",7,1717.30700238848,1763.32076508842,2,5,1,1
"6001977",23,1932.8611559621,2248.68783741607,3,20,1,1
"6001989",42,3017.37516191922,2543.21752514954,20,22,1,1
"6001993",18,1832.401587319,2138.79896507223,4,14,1,1
"6002003",28,2792.27718860694,2340.94327947849,17,11,1,1
"6002004",26,2499.72588019809,2305.75108410937,15,11,1,1
"6002009",15,1859.60753311404,2060.56118614118,1,14,1,1
"6002081",20,2264.2416459557,2185.35845629437,9,11,1,1
"6002082",22,2218.05240599652,2228.3491786518,11,11,1,1
"6002083",12,1842.86805034666,1968.69006049611,4,8,1,1
"6002084",11,1997.90617496502,1933.98659929558,6,5,1,1
"6002085",9,1874.45590346793,1856.26587460569,3,6,1,1
"6002108",47,3313.21153560477,2602.36394728806,25,22,1,1
"6002109",37,2931.04107222029,2478.17471526668,19,18,1,1
"6002110",25,2387.1168383293,2287.34065519221,15,10,1,1
"6002116",37,2576.8441238582,2478.17471526668,17,20,1,1
"6002117",37,2418.73586294559,2478.17471526668,24,13,1,1
"6002118",46,2627.71683546088,2590.94954296761,28,18,1,1
"6002119",23,2229.43031348111,2248.68783741607,13,10,1,1
"6002121",20,2112.44116335457,2185.35845629437,8,12,1,1
"6002122",32,2410.46673303082,2405.71569249515,19,13,1,1
"6002123",21,2014.06616084157,2207.26116887512,10,11,1,1
"6002124",32,2356.19995784493,2405.71569249515,20,12,1,1
"6002125",25,2270.13545157417,2287.34065519221,16,9,1,1
"6002126",28,2349.65090851192,2340.94327947849,19,9,1,1
"6002127",32,2414.37047229042,2405.71569249515,22,10,1,1
"6002128",22,1963.293204136,2228.3491786518,9,13,1,1
"6002129",23,1941.91334533838,2248.68783741607,10,13,1,1
"6002130",38,2387.66456495181,2491.71993967651,20,18,1,1
"6002131",32,2406.19798153381,2405.71569249515,17,15,1,1
"6002132",27,2158.40331761057,2323.60649590586,18,9,1,1
"6002133",35,2396.59905773859,2450.1860183293,18,17,1,1
"6002134",36,2621.99276763985,2464.33502634194,19,17,1,1
"6002135",34,2185.04026045151,2435.71163614839,18,16,1,1
"6002136",18,1957.04013090868,2138.79896507223,9,9,1,1
"6002137",18,1849.22118720321,2138.79896507223,8,10,1,1
"6002138",36,2325.30752341217,2464.33502634194,19,17,1,1
"6002139",35,2251.38785026342,2450.1860183293,19,16,1,1
"6002140",25,2201.79194944964,2287.34065519221,16,9,1,1
"6002141",23,1960.41264973666,2248.68783741607,12,11,1,1
"6002142",25,2268.06559336439,2287.34065519221,14,11,1,1
"6002143",34,2450.02245068727,2435.71163614839,19,15,1,1
"6002144",23,2057.62826523199,2248.68783741607,11,12,1,1
"6002145",16,1948.07273592582,2087.92318348224,6,10,1,1
"6002146",19,2052.29133696954,2162.56636020013,9,10,1,1
"6002147",30,2197.2320446932,2374.18906024059,17,13,1,1
"6002148",30,2017.22117290222,2374.18906024059,14,16,1,1
"6002154",26,2352.48644576318,2305.75108410937,17,9,1,1
"6002155",23,2383.18140390651,2248.68783741607,16,7,1,1
"6002156",23,2307.20142442168,2248.68783741607,14,9,1,1
"6002157",30,2552.36169366317,2374.18906024059,18,12,1,1
"6002158",16,2153.45306763437,2087.92318348224,8,8,1,1
"6002159",22,2336.36303962982,2228.3491786518,14,8,1,1
"6002160",21,2292.18176010137,2207.26116887512,11,10,1,1
"6002161",21,2263.04486790562,2207.26116887512,15,6,1,1
"6002162",23,2412.29771788303,2248.68783741607,16,7,1,1
"6002163",13,1976.16162214672,2001.16379457045,8,5,1,1
"6002164",14,2154.63950571731,2031.70713799962,6,8,1,1
"6002165",50,3067.94145121164,2635.48551585152,28,22,1,1
"6002166",36,2832.25679795433,2464.33502634194,21,15,1,1
"6002167",39,3027.14811301169,2504.98447234734,19,20,1,1
"6002168",42,3196.64573605247,2543.21752514954,26,16,1,1
"6002169",40,2871.02027659377,2517.98110851286,19,21,1,1
"6002170",44,2981.66793871449,2567.51523707907,20,24,1,1
"6002171",37,3110.6722841166,2478.17471526668,19,18,1,1
"6002172",30,2604.81494936923,2374.18906024059,15,15,1,1
"6002173",48,2762.99124623455,2613.58673801098,25,23,1,1
"6002174",67,3290.25503641079,2797.95380131742,33,34,1,1
"6002175",65,3184.37739700401,2780.67589681985,35,30,1,1
"6002176",58,2994.06059193279,2716.66249357165,29,29,1,1
"6002177",61,3399.92512889305,2744.81051624266,34,27,1,1
"6002178",59,3394.97177946043,2726.17127719361,30,29,1,1
"6002179",43,3107.28848950461,2555.47878346624,24,19,1,1
"6002180",40,3142.62283281789,2517.98110851286,22,18,1,1
"6002181",56,3141.59114811913,2697.24673169728,27,29,1,1
"6002182",31,2817.16632266192,2390.15469389133,17,14,1,1
"6002183",35,3030.53514380615,2450.1860183293,17,18,1,1
"6002184",45,3330.47500579827,2579.33597919865,20,25,1,1
"6002185",34,2494.17710566603,2435.71163614839,19,15,1,1
"6002186",33,2747.72588344987,2420.89448855093,18,15,1,1
"6002187",48,3091.79086970685,2613.58673801098,25,23,1,1
"6002188",40,3159.79620778671,2517.98110851286,22,18,1,1
"6002189",55,3406.20291477179,2687.33120998132,29,26,1,1
"6002190",35,2892.38733587077,2450.1860183293,19,16,1,1
"6002191",38,3125.83924631876,2491.71993967651,19,19,1,1
"6002192",39,2895.97800239033,2504.98447234734,24,15,1,1
"6002193",50,3110.35310529045,2635.48551585152,30,20,1,1
"6002228",38,2795.63697889331,2491.71993967651,18,20,1,1
"6002242",36,2661.53091954311,2464.33502634194,16,20,1,1
"6002243",38,2580.15587794759,2491.71993967651,20,18,1,1
"6002244",7,1776.14275922425,1763.32076508842,3,4,1,1
"6002245",8,1702.59427218793,1812.11073017574,3,5,1,1
"6002246",19,2168.82533713898,2162.56636020013,10,9,1,1
"6002247",13,1889.87259146477,2001.16379457045,7,6,1,1
"6002248",12,1931.92201617497,1968.69006049611,7,5,1,1
"6002255",12,1959.37250695072,1968.69006049611,6,6,1,1
"6002256",10,1835.70515536607,1896.67490607898,4,6,1,1
"6002258",22,1975.67152049115,2228.3491786518,8,14,1,1
"6002269",20,2106.40500501495,2185.35845629437,10,10,1,1
"6002270",17,2123.01027610073,2113.95669457394,6,11,1,1
"6002282",27,2397.72321999468,2323.60649590586,15,12,1,1
"6002289",24,1984.42442772789,2268.33468283819,9,15,1,1
"6002290",22,1801.38080959217,2228.3491786518,12,10,1,1
"6002291",8,1809.12375077361,1812.11073017574,5,3,1,1
"6002292",15,2034.68155719622,2060.56118614118,6,9,1,1
"6002293",12,2021.66050559941,1968.69006049611,5,7,1,1
"6002294",15,2150.75975892259,2060.56118614118,6,9,1,1
"6002295",21,2218.80105813998,2207.26116887512,7,14,1,1
"6002296",15,2027.43835126787,2060.56118614118,7,8,1,1
"6002297",31,2322.73676753839,2390.15469389133,10,21,1,1
"6002298",41,2142.13298515524,2530.72175773865,18,23,1,1
"6002299",36,2565.35241709383,2464.33502634194,16,20,1,1
"6002300",25,2530.78210892746,2287.34065519221,11,14,1,1
"6002301",28,2436.06565695169,2340.94327947849,9,19,1,1
"6002302",18,2118.25843517256,2138.79896507223,6,12,1,1
"6003293",66,3403.99434225514,2789.3669207067,29,37,1,1
"6003294",65,3506.59350043129,2780.67589681985,25,40,1,1
"6003295",77,3408.49523520377,2878.65357631343,29,48,1,1
"6003296",50,3181.90596180034,2635.48551585152,24,26,1,1
"6003297",68,3415.16281657134,2806.43931339586,27,41,1,1
"6003298",68,3576.48173382618,2806.43931339586,28,40,1,1
"6003299",64,3622.86214582054,2771.87783482774,21,43,1,1
"6003300",73,3184.46836498062,2847.4358582506,23,50,1,1
"6003302",53,3020.58861274977,2667.061866114,21,32,1,1
"6003303",55,3306.98128653887,2687.33120998132,24,31,1,1
"6003304",64,3319.54500645309,2771.87783482774,25,39,1,1
"6003757",50,3359.32942235651,2635.48551585152,20,30,1,1
"6003758",67,2913.74246342445,2797.95380131742,27,40,1,1
"62003086",79,4026.08235879878,2893.78092561085,38,41,1,1
"62003087",41,3249.30716176156,2530.72175773865,16,25,1,1
"62003088",53,3608.71286476177,2667.061866114,22,31,1,1
"62003089",59,3589.53978249344,2726.17127719361,25,34,1,1
"62003090",57,3368.20820186958,2707.02236739438,23,34,1,1
"62003091",36,2542.74095610706,2464.33502634194,22,14,1,1
"62003092",45,3046.86999162396,2579.33597919865,16,29,1,1
"62003093",62,3366.96536696691,2753.94837323248,23,39,1,1
"62003094",48,3448.66473115039,2613.58673801098,20,28,1,1
"62003095",59,3461.25522571016,2726.17127719361,26,33,1,1
"62003096",50,3464.59027738875,2635.48551585152,21,29,1,1
"62003097",68,3623.00880448611,2806.43931339586,34,34,1,1
"62003098",55,3607.15924914863,2687.33120998132,22,33,1,1
"62003099",38,2879.64669763355,2491.71993967651,13,25,1,1
"62003100",47,2579.27867382896,2602.36394728806,18,29,1,1
"62003101",66,3568.95953033727,2789.3669207067,28,38,1,1
"62003102",68,3960.16760677183,2806.43931339586,28,40,1,1
"62003103",71,3938.39334791255,2831.31372136695,28,43,1,1
"62003104",68,3601.8255877694,2806.43931339586,24,44,1,1
"62003105",51,3224.45386717523,2646.17454577679,21,30,1,1
"62003106",65,3725.2720396584,2780.67589681985,25,40,1,1
"62003107",95,4453.04623114744,3004.94950458202,40,55,1,1
"62003108",67,3985.20254884791,2797.95380131742,30,37,1,1
"62003109",67,3839.32538213168,2797.95380131742,29,38,1,1
"62003110",59,3488.57050420496,2726.17127719361,26,33,1,1
"62003111",76,3798.82625174202,2870.97236507783,28,48,1,1
"62003112",65,4011.91777989463,2780.67589681985,28,37,1,1
"62003113",61,3660.6870350389,2744.81051624266,25,36,1,1
"62003114",85,3937.32440582743,2937.40494579778,30,55,1,1
"62003115",73,3978.77198984793,2847.4358582506,24,49,1,1
"62003116",59,2804.94030282795,2726.17127719361,27,32,1,1
"62003117",68,3371.41373982214,2806.43931339586,40,28,1,1
"62003118",63,3179.32825262469,2762.96971264875,33,30,1,1
"62003119",76,3360.88339913969,2870.97236507783,32,44,1,1
"62003120",57,2903.93139759955,2707.02236739438,27,30,1,1
"62003121",83,3314.43401515769,2923.1438046077,36,47,1,1
"62003122",87,3364.08079425035,2951.40156710974,39,48,1,1
"62003123",67,3023.50344918032,2797.95380131742,29,38,1,1
"62003124",78,3693.28291247047,2886.25582696583,31,47,1,1
"62003125",68,3348.82124779088,2806.43931339586,28,40,1,1
"62003126",97,4444.58914938679,3017.77317381863,36,61,1,1
"62003713",45,3467.76740928201,2579.33597919865,21,24,1,1
"62003714",66,3782.86381448486,2789.3669207067,29,37,1,1
"62003715",50,3306.45758987587,2635.48551585152,19,31,1,1
"62003716",51,3599.47711088975,2646.17454577679,22,29,1,1
"62003717",67,3977.82396128507,2797.95380131742,29,38,1,1
"62003718",57,3218.86471483032,2707.02236739438,24,33,1,1
"62003719",52,3536.32269480789,2656.6981055205,21,31,1,1
"62003720",64,4131.71194671171,2771.87783482774,26,38,1,1
"62003721",70,3960.56189661136,2823.11677003184,26,44,1,1
"62003722",80,3958.42461766957,2901.2306171403,30,50,1,1
"62003723",73,3933.31519093843,2847.4358582506,35,38,1,1
"62003724",82,3687.65214389726,2915.91045786314,30,52,1,1
"62003725",56,3130.07341092817,2697.24673169728,23,33,1,1
"62003726",69,3758.53778578596,2814.82611826518,28,41,1,1
"62003727",35,2780.33670976102,2450.1860183293,12,23,1,1
"62003728",59,3453.16792125105,2726.17127719361,23,36,1,1
"62003729",68,4154.20559284316,2806.43931339586,28,40,1,1
"62003730",71,3727.49785229665,2831.31372136695,29,42,1,1
"62003731",79,3980.98421050891,2893.78092561085,29,50,1,1
"62003732",61,3890.10489681608,2744.81051624266,25,36,1,1
"62003733",65,3541.80277254555,2780.67589681985,25,40,1,1
"62003737",67,3144.21930579822,2797.95380131742,33,34,1,1
"676003239",52,3281.67017897783,2656.6981055205,25,27,1,1
"676003240",54,3488.05805665538,2677.2712016452,27,27,1,1
"676003241",38,3105.35216347802,2491.71993967651,16,22,1,1
"676003242",45,3418.58237414904,2579.33597919865,18,27,1,1
"676003243",69,3854.06632336336,2814.82611826518,32,37,1,1
"676003244",57,3496.88545341388,2707.02236739438,26,31,1,1
"676003245",56,3215.60432150695,2697.24673169728,29,27,1,1
"676003247",51,3260.75384398381,2646.17454577679,25,26,1,1
"676003248",45,3393.65727403544,2579.33597919865,22,23,1,1
"676003249",40,3054.6758364013,2517.98110851286,18,22,1,1
"676003250",60,3664.2185911321,2735.5526890818,27,33,1,1
"676003251",50,3449.62911038396,2635.48551585152,26,24,1,1
"676003252",60,3651.59688971007,2735.5526890818,35,25,1,1
"676003741",39,3299.43797997886,2504.98447234734,17,22,1,1
"676003742",39,3055.79324217479,2504.98447234734,15,24,1,1
"682002937",56,3900.10727718688,2697.24673169728,24,32,1,1
"682002938",44,3144.53126074105,2567.51523707907,18,26,1,1
"682002939",39,2500.97078759007,2504.98447234734,17,22,1,1
"682002940",56,3385.90194758873,2697.24673169728,24,32,1,1
"683003147",44,3110.46999509158,2567.51523707907,18,26,1,1
"683003148",43,3153.17894835323,2555.47878346624,17,26,1,1
"683003149",38,2759.40224505798,2491.71993967651,11,27,1,1
"683003150",55,3143.43985497312,2687.33120998132,20,35,1,1
"683003151",38,3078.8838384576,2491.71993967651,13,25,1,1
"683003152",40,3223.98268418135,2517.98110851286,13,27,1,1
"683003153",34,3047.81945643908,2435.71163614839,10,24,1,1
"683003932",31,2498.07229150259,2390.15469389133,10,21,1,1
"683003933",31,2790.85513064437,2390.15469389133,11,20,1,1
"683003934",36,2861.20729414165,2464.33502634194,14,22,1,1
"689003033",43,2786.5248510059,2555.47878346624,14,29,1,1
"689003034",40,2415.12112416231,2517.98110851286,15,25,1,1
"689003035",44,2706.83823225042,2567.51523707907,15,29,1,1
"689003036",49,2918.9208097202,2624.62502504328,20,29,1,1
"689003037",47,3076.46099692949,2602.36394728806,16,31,1,1
"689003038",39,2625.06062681123,2504.98447234734,16,23,1,1
"689003039",40,2740.45388569813,2517.98110851286,15,25,1,1
"689003040",61,3691.37297876637,2744.81051624266,31,30,1,1
"689003041",68,2964.30522839629,2806.43931339586,27,41,1,1
"689003042",36,2956.10850322311,2464.33502634194,19,17,1,1
"689003043",63,3148.01945661437,2762.96971264875,27,36,1,1
"689003044",55,3093.30424861105,2687.33120998132,27,28,1,1
"689003045",33,2913.27953316992,2420.89448855093,22,11,1,1
"689003046",41,3050.38810229141,2530.72175773865,24,17,1,1
"689003047",37,3145.20471355402,2478.17471526668,21,16,1,1
"689003048",52,3406.20084886706,2656.6981055205,26,26,1,1
"689003049",50,3384.07478449267,2635.48551585152,26,24,1,1
"689003050",49,3276.03245603651,2624.62502504328,20,29,1,1
"689003051",63,3192.19598566581,2762.96971264875,25,38,1,1
"689003052",43,3466.43258581256,2555.47878346624,17,26,1,1
"689003053",70,3392.94425307173,2823.11677003184,31,39,1,1
"689003054",51,3141.85011198791,2646.17454577679,26,25,1,1
"689003055",50,3593.23693881859,2635.48551585152,23,27,1,1
"689003056",41,3639.98197570323,2530.72175773865,22,19,1,1
"689003058",43,3372.27255367986,2555.47878346624,18,25,1,1
"689003059",45,3267.39519160934,2579.33597919865,19,26,1,1
"689003060",53,3558.29613761646,2667.061866114,22,31,1,1
"689003061",32,2678.8752821086,2405.71569249515,19,13,1,1
"689003735",39,2690.70879714123,2504.98447234734,12,27,1,1
"689003736",40,2843.70626672025,2517.98110851286,16,24,1,1
"689003738",35,3299.57087630632,2450.1860183293,15,20,1,1
"689003739",49,3331.07653989845,2624.62502504328,23,26,1,1
"8000649",9,1872.09216936193,1856.26587460569,2,7,1,1
"8000650",8,1896.00678019094,1812.11073017574,2,6,1,1
"8000651",10,1935.26718350412,1896.67490607898,4,6,1,1
"8000653",11,1960.88977305857,1933.98659929558,5,6,1,1
"8000654",8,1766.00019429054,1812.11073017574,2,6,1,1
"8000655",10,1993.55508677522,1896.67490607898,4,6,1,1
"8000656",14,2106.05711516883,2031.70713799962,8,6,1,1
"8000657",14,2197.24904809931,2031.70713799962,7,7,1,1
"8000658",18,2226.38900629998,2138.79896507223,7,11,1,1
"8000659",6,1734.52366992436,1708.62817714657,2,4,1,1
"8000660",19,2124.99744343376,2162.56636020013,6,13,1,1
"8000661",41,2972.63341171012,2530.72175773865,14,27,1,1
"8000662",47,3309.62030195875,2602.36394728806,17,30,1,1
"8000663",45,3072.88206648023,2579.33597919865,20,25,1,1
"8000664",15,2166.33078868361,2060.56118614118,7,8,1,1
"8000665",16,2147.64666494309,2087.92318348224,8,8,1,1
"8000666",10,2003.80848843157,1896.67490607898,5,5,1,1
"8000669",2,1374.4644476772,1364.97646362037,0,2,1,1
"8000670",6,1757.020925796,1708.62817714657,3,3,1,1
"8000671",10,1840.01413703554,1896.67490607898,3,7,1,1
"8000672",17,2201.99196083194,2113.95669457394,5,12,1,1
"8000673",6,1821.45489705406,1708.62817714657,2,4,1,1
"8000674",11,2059.43463512541,1933.98659929558,3,8,1,1
"8000675",10,2007.58381440615,1896.67490607898,6,4,1,1
"855003140",37,2257.27304177652,2478.17471526668,15,22,1,1
"855003141",25,2196.58438605768,2287.34065519221,10,15,1,1
"855003142",29,2519.95854419654,2357.79423966008,13,16,1,1
"855003143",28,2364.21429739715,2340.94327947849,10,18,1,1
"855003144",25,2317.45011236705,2287.34065519221,10,15,1,1
"855003145",28,2414.85388254319,2340.94327947849,13,15,1,1
"855003146",22,2158.29348196757,2228.3491786518,10,12,1,1
"912340011",48,3031.47945596873,2613.58673801098,29,19,1,1
"912340012",48,2970.1914931428,2613.58673801098,32,16,1,1
"912340013",61,2961.3079495576,2744.81051624266,27,34,1,1
"912340014",40,2730.40144748385,2517.98110851286,19,21,1,1
"912340015",51,2641.25726083245,2646.17454577679,24,27,1,1
"912340016",45,2752.29597188839,2579.33597919865,21,24,1,1
"912340017",49,2751.6486503139,2624.62502504328,20,29,1,1
"912340018",55,3202.28060632198,2687.33120998132,27,28,1,1
"912340019",50,3255.62940152682,2635.48551585152,30,20,1,1
"912340020",68,3748.02335106062,2806.43931339586,38,30,1,1
"912340021",63,3308.15931734609,2762.96971264875,36,27,1,1
"912340022",54,3223.86179938226,2677.2712016452,31,23,1,1
"912340023",39,2589.76515593888,2504.98447234734,18,21,1,1
"912340024",46,3002.14783168242,2590.94954296761,25,21,1,1
"912340025",64,3367.0786840449,2771.87783482774,34,30,1,1
"912340026",47,2962.58487664829,2602.36394728806,32,15,1,1
"912340027",62,3389.57247693397,2753.94837323248,34,28,1,1
"912340028",55,3191.69122855355,2687.33120998132,29,26,1,1
"912340029",39,2939.66914776256,2504.98447234734,22,17,1,1
"912340030",51,3385.18158840172,2646.17454577679,29,22,1,1
"912340031",30,2587.5369732613,2374.18906024059,11,19,1,1
"912340032",52,2891.87985027962,2656.6981055205,23,29,1,1
"912340033",59,3088.43824744057,2726.17127719361,34,25,1,1
"912340034",58,3374.32208009039,2716.66249357165,35,23,1,1
"912340035",40,3017.94582017637,2517.98110851286,23,17,1,1
"912340036",32,2621.36304625711,2405.71569249515,17,15,1,1
"912340295",32,2573.61132001012,2405.71569249515,14,18,1,1
"912340357",56,3465.09612546187,2697.24673169728,17,39,1,1
"912340358",7,1786.97066048386,1763.32076508842,5,2,1,1
"912340359",16,1907.61156029663,2087.92318348224,3,13,1,1
"912340360",59,3966.99024135501,2726.17127719361,21,38,1,1
"912340361",68,4501.28324997791,2806.43931339586,23,45,1,1
"912340362",69,4580.94121601866,2814.82611826518,25,44,1,1
"912340363",70,4113.89686429657,2823.11677003184,24,46,1,1
"912340364",75,4094.5524738392,2863.21031780169,28,47,1,1
"912340366",70,4079.5666943808,2823.11677003184,26,44,1,1
"912340367",69,4189.3236748983,2814.82611826518,26,43,1,1
"912340368",64,4328.28251438816,2771.87783482774,22,42,1,1
"912340369",54,3476.11322826367,2677.2712016452,18,36,1,1
"912340370",59,4055.85311150291,2726.17127719361,24,35,1,1
"912340371",57,4059.16002989936,2707.02236739438,17,40,1,1
"912340372",48,3383.50717914853,2613.58673801098,15,33,1,1
"912340373",52,3393.47205342043,2656.6981055205,19,33,1,1
"912340374",46,3432.34039144069,2590.94954296761,15,31,1,1
"912340375",59,3798.31082067962,2726.17127719361,21,38,1,1
"912340376",49,3440.55289527358,2624.62502504328,20,29,1,1
"912340377",65,3727.0227192603,2780.67589681985,24,41,1,1
"912340378",50,3615.11828950966,2635.48551585152,16,34,1,1
"912340379",59,3574.15501561674,2726.17127719361,19,40,1,1
"912340380",47,2923.60607787952,2602.36394728806,12,35,1,1
"912340381",54,3567.78563104022,2677.2712016452,17,37,1,1
"912340382",67,3297.27640696509,2797.95380131742,21,46,1,1
"912340383",57,3336.91705167476,2707.02236739438,20,37,1,1
"912340384",47,3549.12343055613,2602.36394728806,14,33,1,1
"912340385",45,3082.25891882092,2579.33597919865,21,24,1,1
"912340386",45,3111.24597754639,2579.33597919865,13,32,1,1
"912340387",48,3691.49597313164,2613.58673801098,13,35,1,1
"912340388",31,2976.6126219138,2390.15469389133,10,21,1,1
"912340389",37,3194.24151527573,2478.17471526668,15,22,1,1
"912340390",43,2870.41667082295,2555.47878346624,16,27,1,1
"912340391",65,3021.39757269535,2780.67589681985,26,39,1,1
"912340392",34,3033.08692745041,2435.71163614839,12,22,1,1
"912340393",71,3019.35841534378,2831.31372136695,32,39,1,1
"912340394",39,2758.51213856329,2504.98447234734,21,18,1,1
"912340395",32,2431.98007094089,2405.71569249515,12,20,1,1
"912340396",36,2621.58235119146,2464.33502634194,18,18,1,1
"912340397",42,2499.42653880351,2543.21752514954,23,19,1,1
"912340398",37,2600.50544162554,2478.17471526668,18,19,1,1
"912340399",35,2635.85270469435,2450.1860183293,17,18,1,1
"912340400",36,2675.13042624084,2464.33502634194,16,20,1,1
"912340401",30,2455.47873364601,2374.18906024059,18,12,1,1
"912340402",33,2547.24465026541,2420.89448855093,17,16,1,1
"912340403",36,2416.11459549973,2464.33502634194,19,17,1,1
"912340404",28,2374.51938524588,2340.94327947849,16,12,1,1
"912340405",39,2671.2274900451,2504.98447234734,17,22,1,1
"912340406",31,2444.31883779877,2390.15469389133,16,15,1,1
"912340407",33,2555.89318426359,2420.89448855093,16,17,1,1
"912340408",11,1858.67568612383,1933.98659929558,2,9,1,1
"912340414",10,1792.32851218022,1896.67490607898,1,9,1,1
"912340415",8,1828.37263155951,1812.11073017574,2,6,1,1
"912340416",8,1813.92146440574,1812.11073017574,1,7,1,1
"912340417",9,1806.20923724585,1856.26587460569,1,8,1,1
"912340418",10,1775.97608592176,1896.67490607898,2,8,1,1
"912340419",9,1783.18260691335,1856.26587460569,1,8,1,1
"912340420",9,1799.44271313308,1856.26587460569,2,7,1,1
"912340421",10,1858.51642192585,1896.67490607898,1,9,1,1
"912340422",11,1786.50732124788,1933.98659929558,1,10,1,1
"912340423",10,1879.57697684135,1896.67490607898,1,9,1,1
"912340424",9,1764.39703108683,1856.26587460569,2,7,1,1
"912340425",16,1866.70717171187,2087.92318348224,5,11,1,1
"912340426",12,1827.82659095545,1968.69006049611,1,11,1,1
"912340427",11,1833.60224082751,1933.98659929558,1,10,1,1
"912340428",13,1839.95575657642,2001.16379457045,3,10,1,1
"912340429",8,1792.87928012926,1812.11073017574,1,7,1,1
"912340430",6,1727.90176575961,1708.62817714657,0,6,1,1
"912340431",7,1670.25370547949,1763.32076508842,1,6,1,1
"912340432",8,1828.23319810744,1812.11073017574,1,7,1,1
"912340433",13,1776.41106726051,2001.16379457045,3,10,1,1
"912340434",10,1762.59828591475,1896.67490607898,2,8,1,1
"912340435",7,1710.388859067,1763.32076508842,1,6,1,1
"912340436",7,1747.99177743485,1763.32076508842,0,7,1,1
"912340437",7,1762.53363910924,1763.32076508842,0,7,1,1
"912340438",8,1802.30825496349,1812.11073017574,2,6,1,1
"912340439",8,1782.05443895535,1812.11073017574,0,8,1,1
"912340440",10,1798.43237726157,1896.67490607898,1,9,1,1
"912340441",7,1733.52698460885,1763.32076508842,2,5,1,1
"912340442",8,1859.25827289447,1812.11073017574,0,8,1,1
"912340443",15,1970.91554264458,2060.56118614118,3,12,1,1
"912340444",8,1622.69583794002,1812.11073017574,2,6,1,1
"912340445",8,1785.68897824697,1812.11073017574,1,7,1,1
"912340559",62,3246.00939222947,2753.94837323248,34,28,1,1
"912340560",48,3186.86589942467,2613.58673801098,29,19,1,1
"912340561",35,2830.17768530703,2450.1860183293,16,19,1,1
"912340562",43,3031.71695117256,2555.47878346624,19,24,1,1
"912340563",51,3141.02092923401,2646.17454577679,26,25,1,1
"912340564",32,3014.01153071098,2405.71569249515,15,17,1,1
"912340565",34,2925.69911816496,2435.71163614839,21,13,1,1
"912340566",29,2684.54767232378,2357.79423966008,13,16,1,1
"912340567",34,2705.32970110068,2435.71163614839,19,15,1,1
"912340568",30,2598.54053559921,2374.18906024059,18,12,1,1
"912340569",34,3032.66040762431,2435.71163614839,20,14,1,1
"912340570",38,2881.07330043969,2491.71993967651,23,15,1,1
"912340571",40,2967.18063020048,2517.98110851286,20,20,1,1
"912340572",37,2793.83389619034,2478.17471526668,24,13,1,1
"912340573",33,2703.09807025879,2420.89448855093,16,17,1,1
"912340574",55,3495.61488236287,2687.33120998132,26,29,1,1
"912340575",64,3800.9167529189,2771.87783482774,33,31,1,1
"912340576",51,3386.23024011257,2646.17454577679,30,21,1,1
"912340577",47,3123.67110417507,2602.36394728806,24,23,1,1
"912340578",45,2928.24890349119,2579.33597919865,26,19,1,1
"912340579",43,2643.85189811742,2555.47878346624,22,21,1,1
"912340580",40,2831.14593803398,2517.98110851286,24,16,1,1
"912340581",39,2807.43392927748,2504.98447234734,22,17,1,1
"912340582",36,3094.78091123944,2464.33502634194,17,19,1,1
"912340583",56,3464.10990089862,2697.24673169728,33,23,1,1
"912340584",43,3051.49173100573,2555.47878346624,25,18,1,1
"912340585",41,3007.91413703204,2530.72175773865,19,22,1,1
"912340586",47,3091.22940749925,2602.36394728806,24,23,1,1
"912340587",42,3229.01573503343,2543.21752514954,25,17,1,1
"912340588",37,3045.53592260789,2478.17471526668,19,18,1,1
"912340589",43,3207.74675122464,2555.47878346624,24,19,1,1
"912340590",42,3091.15076719048,2543.21752514954,21,21,1,1
"912340591",45,2843.00901060745,2579.33597919865,25,20,1,1
"912340592",23,2439.55127411918,2248.68783741607,15,8,1,1
"912340593",28,2233.24328391495,2340.94327947849,15,13,1,1
"912340594",42,2966.07176691248,2543.21752514954,19,23,1,1
"912340595",40,2661.37831816605,2517.98110851286,19,21,1,1
"912340596",41,2868.8383639966,2530.72175773865,21,20,1,1
"912340597",41,2816.96430083709,2530.72175773865,21,20,1,1
"912340598",32,2654.244006226,2405.71569249515,17,15,1,1
"912340599",34,2652.22967658063,2435.71163614839,15,19,1,1
"912340600",28,2459.04564828111,2340.94327947849,12,16,1,1
"912340601",25,2402.89058639869,2287.34065519221,11,14,1,1
"912340602",37,2706.75473414293,2478.17471526668,21,16,1,1
"912340603",51,2684.03766048343,2646.17454577679,26,25,1,1
"912340604",53,3425.95285393593,2667.061866114,26,27,1,1
"912340605",52,3443.49862263774,2656.6981055205,27,25,1,1
"912340606",38,2745.14620687956,2491.71993967651,19,19,1,1
"912340607",38,2789.63334254537,2491.71993967651,21,17,1,1
"912340608",37,2543.96808011737,2478.17471526668,25,12,1,1
"912340609",33,2573.99344421124,2420.89448855093,20,13,1,1
"912340610",39,2808.66240536926,2504.98447234734,20,19,1,1
"912340611",49,3150.49232886762,2624.62502504328,30,19,1,1
"912341092",54,3299.46845811187,2677.2712016452,24,30,1,1
"912341093",39,2998.5862553576,2504.98447234734,18,21,1,1
"912341094",44,3179.36229815756,2567.51523707907,17,27,1,1
"912341095",29,2542.35460594862,2357.79423966008,10,19,1,1
"912341096",51,2760.68756852806,2646.17454577679,19,32,1,1
"912341097",38,2459.77120440468,2491.71993967651,11,27,1,1
"912341098",45,2500.70480257315,2579.33597919865,14,31,1,1
"912341099",17,2280.81720558265,2113.95669457394,8,9,1,1
"912341100",29,2627.26045135418,2357.79423966008,13,16,1,1
"912341101",35,2643.09215873515,2450.1860183293,15,20,1,1
"912341102",38,2709.97672705101,2491.71993967651,13,25,1,1
"912341103",34,2530.22142607752,2435.71163614839,16,18,1,1
"912341104",32,2434.83177453261,2405.71569249515,14,18,1,1
"912341105",32,2451.35108607337,2405.71569249515,12,20,1,1
"912341106",33,2257.22864089361,2420.89448855093,13,20,1,1
"912341107",36,2855.74328169903,2464.33502634194,14,22,1,1
"912341108",33,2876.2106963734,2420.89448855093,12,21,1,1
"912341109",26,2613.82986329022,2305.75108410937,10,16,1,1
"912341110",41,3201.34356814515,2530.72175773865,17,24,1,1
"912341111",47,3204.03040287554,2602.36394728806,16,31,1,1
"912341112",38,2777.94193697468,2491.71993967651,11,27,1,1
"912341113",34,2584.44760150616,2435.71163614839,14,20,1,1
"912341114",43,3080.60996823335,2555.47878346624,16,27,1,1
"912341115",43,3139.81789682972,2555.47878346624,22,21,1,1
"912341116",35,2647.92135947645,2450.1860183293,19,16,1,1
"912341117",30,2654.58997947302,2374.18906024059,15,15,1,1
"912341118",28,2768.91596863024,2340.94327947849,15,13,1,1
"912341119",31,2709.67647992628,2390.15469389133,15,16,1,1
"912341120",33,2901.36557903745,2420.89448855093,17,16,1,1
"912341121",40,2738.74055974109,2517.98110851286,14,26,1,1
"912341122",34,2647.45368054246,2435.71163614839,14,20,1,1
"912341123",38,2748.47948009539,2491.71993967651,17,21,1,1
"912341124",32,2592.57358407976,2405.71569249515,14,18,1,1
"912341125",40,3057.5903640927,2517.98110851286,18,22,1,1
"912341126",50,3092.64740457201,2635.48551585152,18,32,1,1
"912341127",38,2791.92658150161,2491.71993967651,16,22,1,1
"912341128",39,2914.32887330195,2504.98447234734,15,24,1,1
"912341129",40,2843.4663543612,2517.98110851286,14,26,1,1
"912341130",43,2661.69652289648,2555.47878346624,16,27,1,1
"912341131",29,2709.39843219266,2357.79423966008,12,17,1,1
"912341132",31,2838.62430514298,2390.15469389133,11,20,1,1
"912341133",44,2713.58767993214,2567.51523707907,15,29,1,1
"912341134",23,2428.03377607237,2248.68783741607,4,19,1,1
"912341135",35,2835.23951546799,2450.1860183293,13,22,1,1
"912341136",32,2675.72593106825,2405.71569249515,12,20,1,1
"912341137",39,2732.36697827674,2504.98447234734,17,22,1,1
"912341138",17,2193.0797002562,2113.95669457394,3,14,1,1
"912341139",39,2651.54154268233,2504.98447234734,18,21,1,1
"912341140",59,2889.41946674316,2726.17127719361,27,32,1,1
"912341141",30,2607.66976595846,2374.18906024059,13,17,1,1
"912341142",26,2609.54329901336,2305.75108410937,9,17,1,1
"912341143",25,2579.72145728624,2287.34065519221,11,14,1,1
"912341144",58,3820.26561601412,2716.66249357165,23,35,1,1
"912341145",22,2651.69267287501,2228.3491786518,9,13,1,1
"912341146",45,3331.91003560091,2579.33597919865,16,29,1,1
"912341147",20,2337.24071657386,2185.35845629437,8,12,1,1
"912341148",29,2751.93951975234,2357.79423966008,12,17,1,1
"912341149",27,2638.27471275319,2323.60649590586,12,15,1,1
"912341150",30,3025.72650364991,2374.18906024059,12,18,1,1
"912341151",36,3211.79943879007,2464.33502634194,16,20,1,1
"912341152",16,2225.19881134993,2087.92318348224,6,10,1,1
"912341153",28,2926.0164479808,2340.94327947849,13,15,1,1
"912341154",41,3298.19919406025,2530.72175773865,20,21,1,1
"912341155",48,3001.9975201825,2613.58673801098,21,27,1,1
"912341156",27,2714.99883475253,2323.60649590586,10,17,1,1
"912341157",25,2582.17460868667,2287.34065519221,11,14,1,1
"912341158",44,2989.89278840743,2567.51523707907,18,26,1,1
"912341159",29,2769.4037009015,2357.79423966008,13,16,1,1
"912341160",35,2903.00596027449,2450.1860183293,14,21,1,1
"912341162",15,2198.01857629032,2060.56118614118,9,6,1,1
"912341163",31,2899.01169432146,2390.15469389133,15,16,1,1
"912341164",27,2979.3534169634,2323.60649590586,12,15,1,1
"912341165",29,3138.65023415872,2357.79423966008,15,14,1,1
"912341166",45,3249.88223990417,2579.33597919865,23,22,1,1
"912341167",36,3069.21392291945,2464.33502634194,14,22,1,1
"912341168",33,2856.68475120868,2420.89448855093,15,18,1,1
"912341169",33,2889.67387651161,2420.89448855093,10,23,1,1
"912341170",41,3357.25969692565,2530.72175773865,16,25,1,1
"912341171",27,2537.93219830465,2323.60649590586,11,16,1,1
"912341172",32,2512.41560268951,2405.71569249515,13,19,1,1
"912341173",39,3435.40184816242,2504.98447234734,17,22,1,1
"912341174",30,2852.03157536629,2374.18906024059,16,14,1,1
"912341175",36,3280.85314692745,2464.33502634194,16,20,1,1
"912341176",34,3073.6100591396,2435.71163614839,14,20,1,1
"912341177",45,3628.07521146313,2579.33597919865,21,24,1,1
"912341178",34,2760.11884329951,2435.71163614839,16,18,1,1
"912341179",39,2799.73044104392,2504.98447234734,16,23,1,1
"912341180",34,3159.34329965774,2435.71163614839,12,22,1,1
"912341181",42,2957.67958009669,2543.21752514954,17,25,1,1
"912341182",30,2773.18343584777,2374.18906024059,13,17,1,1
"912341183",36,2858.0753517615,2464.33502634194,17,19,1,1
"912341184",35,2747.80452153631,2450.1860183293,13,22,1,1
"912341185",28,2625.29556990062,2340.94327947849,11,17,1,1
"912341186",32,2901.24208344545,2405.71569249515,16,16,1,1
"912341187",36,3062.17265085711,2464.33502634194,15,21,1,1
"912341188",34,2873.19888916893,2435.71163614839,16,18,1,1
"912341189",27,2565.01000087184,2323.60649590586,12,15,1,1
"912341190",36,2837.934205362,2464.33502634194,18,18,1,1
"912341191",46,3158.21703879452,2590.94954296761,23,23,1,1
"912341192",48,3356.89234436182,2613.58673801098,28,20,1,1
"912341193",41,2820.38806300054,2530.72175773865,21,20,1,1
"912341194",43,3110.10880764423,2555.47878346624,22,21,1,1
"912341195",51,3067.63975363679,2646.17454577679,25,26,1,1
"912341196",41,3192.21956233723,2530.72175773865,20,21,1,1
"912341197",37,2804.81875031411,2478.17471526668,19,18,1,1
"912341198",47,2758.89006943531,2602.36394728806,24,23,1,1
"912341199",37,2761.33020089239,2478.17471526668,15,22,1,1
"912341200",34,2842.98715471335,2435.71163614839,18,16,1,1
"912341201",30,2785.36231672151,2374.18906024059,17,13,1,1
"912341202",49,2956.08895190331,2624.62502504328,25,24,1,1
"912341203",46,3170.40282854681,2590.94954296761,21,25,1,1
"912341204",33,2714.69425447358,2420.89448855093,21,12,1,1
"912341205",23,2703.66737673588,2248.68783741607,14,9,1,1
"912341206",43,3153.59239425913,2555.47878346624,21,22,1,1
"912341207",27,2730.113247809,2323.60649590586,12,15,1,1
"912341208",26,2491.60649017784,2305.75108410937,9,17,1,1
"912341209",30,2591.73445230959,2374.18906024059,17,13,1,1
"912341210",39,2716.5760468733,2504.98447234734,21,18,1,1
"912341211",29,2700.61341562277,2357.79423966008,17,12,1,1
"912341212",46,2718.46565889196,2590.94954296761,25,21,1,1
"912341213",30,2641.84480872815,2374.18906024059,18,12,1,1
"912341214",46,2575.0148159323,2590.94954296761,22,24,1,1
"912341215",53,3216.28324252387,2667.061866114,30,23,1,1
"912341216",25,2494.69343108399,2287.34065519221,13,12,1,1
"912341217",55,3298.55955934681,2687.33120998132,26,29,1,1
"912341218",32,2810.20486923301,2405.71569249515,17,15,1,1
"912341219",52,3048.9252359735,2656.6981055205,29,23,1,1
"912341220",38,2605.99091097871,2491.71993967651,18,20,1,1
"912341221",39,2998.81659620158,2504.98447234734,21,18,1,1
"912341222",28,2789.1063036884,2340.94327947849,14,14,1,1
"912341223",54,3423.5271491482,2677.2712016452,25,29,1,1
"912341789",18,2280.04846242577,2138.79896507223,11,7,1,1
"912341790",22,2276.84500696155,2228.3491786518,14,8,1,1
"912341791",20,2298.21053651125,2185.35845629437,10,10,1,1
"912341792",19,2233.83417814166,2162.56636020013,8,11,1,1
"912341793",17,2127.34456720918,2113.95669457394,12,5,1,1
"912341794",18,2335.71609805801,2138.79896507223,12,6,1,1
"912341795",24,2094.01757076692,2268.33468283819,14,10,1,1
"912341796",22,2174.40921117511,2228.3491786518,11,11,1,1
"912341797",16,2208.8688102262,2087.92318348224,10,6,1,1
"912341798",14,2071.33873471563,2031.70713799962,8,6,1,1
"912341799",26,2289.59343683617,2305.75108410937,15,11,1,1
"912341800",27,2380.00586456722,2323.60649590586,16,11,1,1
"912341801",17,2116.35755783268,2113.95669457394,9,8,1,1
"912341802",18,2160.73579611071,2138.79896507223,9,9,1,1
"912341803",17,2199.43789582979,2113.95669457394,9,8,1,1
"912341804",18,2210.04716450929,2138.79896507223,10,8,1,1
"912341805",19,2279.06842020051,2162.56636020013,12,7,1,1
"912341806",15,2133.91719704566,2060.56118614118,10,5,1,1
"912341807",19,2180.57907703494,2162.56636020013,8,11,1,1
"912341808",18,2150.86430212698,2138.79896507223,8,10,1,1
"912341809",22,2213.40104789553,2228.3491786518,11,11,1,1
"912341810",23,2334.64419573266,2248.68783741607,12,11,1,1
"912341811",18,2158.7472127261,2138.79896507223,5,13,1,1
"912341812",17,2024.69722442658,2113.95669457394,7,10,1,1
"912341813",18,2053.45922715019,2138.79896507223,7,11,1,1
"912341814",16,2094.86261696072,2087.92318348224,6,10,1,1
"912341815",9,1901.08030004216,1856.26587460569,5,4,1,1
"912341816",13,2052.7220964369,2001.16379457045,6,7,1,1
"912341817",30,2669.6741497869,2374.18906024059,16,14,1,1
"912341818",33,2873.89008680618,2420.89448855093,14,19,1,1
"912341819",26,2432.67657624674,2305.75108410937,14,12,1,1
"912341820",6,1740.85845279674,1708.62817714657,5,1,1,1
"912341821",9,1862.63225702545,1856.26587460569,2,7,1,1
"912341822",26,2629.21143135442,2305.75108410937,14,12,1,1
"912341823",31,2487.77372515237,2390.15469389133,14,17,1,1
"912341824",13,2093.97464022781,2001.16379457045,6,7,1,1
"912341825",33,2528.556702688,2420.89448855093,16,17,1,1
"912341826",39,2746.80228011232,2504.98447234734,18,21,1,1
"912341827",27,2643.7210136346,2323.60649590586,14,13,1,1
"912341837",63,3178.0496823709,2762.96971264875,30,33,1,1
"912341838",42,3040.30736352337,2543.21752514954,23,19,1,1
"912341839",41,3045.85911975717,2530.72175773865,21,20,1,1
"912341840",26,2616.30410656064,2305.75108410937,13,13,1,1
"912341841",44,2955.18421552989,2567.51523707907,23,21,1,1
"912341842",58,3418.00949112668,2716.66249357165,34,24,1,1
"912341843",68,3540.01286402826,2806.43931339586,35,33,1,1
"912341844",49,3135.01132749161,2624.62502504328,32,17,1,1
"912341845",46,3027.63543850853,2590.94954296761,26,20,1,1
"912341966",73,4072.42524572638,2847.4358582506,31,42,1,1
"912341967",86,4410.95966906152,2944.43562859908,38,48,1,1
"912341968",69,3376.73210608046,2814.82611826518,33,36,1,1
"912341969",75,3792.17917696163,2863.21031780169,30,45,1,1
"912341970",77,3665.55234304499,2878.65357631343,31,46,1,1
"912342032",95,4489.06600898907,3004.94950458202,46,49,1,1
"912342034",92,3662.96849426679,2985.30521778333,41,51,1,1
"912342035",76,3596.8051665135,2870.97236507783,39,37,1,1
"912342036",5,1670.08930527589,1646.12614877363,1,4,1,1
"912342037",6,1753.82270501979,1708.62817714657,1,5,1,1
"912342038",9,1826.69037014003,1856.26587460569,0,9,1,1
"912342039",13,1820.03720839454,2001.16379457045,2,11,1,1
"912342040",5,1679.50104732665,1646.12614877363,1,4,1,1
"912342041",7,1695.69318457373,1763.32076508842,0,7,1,1
"912342042",9,1762.0944117022,1856.26587460569,1,8,1,1
"912342043",7,1791.50190253212,1763.32076508842,1,6,1,1
"912342044",9,1796.57363640712,1856.26587460569,1,8,1,1
"912342045",11,1804.62702898428,1933.98659929558,0,11,1,1
"912342047",14,1814.55270143981,2031.70713799962,3,11,1,1
"912342049",14,1855.08252301203,2031.70713799962,4,10,1,1
"912342050",4,1632.43195767696,1572.73281143487,1,3,1,1
"912342051",6,1659.31021722951,1708.62817714657,1,5,1,1
"912342052",7,1754.94842010142,1763.32076508842,2,5,1,1
"912342053",6,1678.82645649962,1708.62817714657,0,6,1,1
"912342054",10,1791.21068413514,1896.67490607898,1,9,1,1
"912342055",4,1598.49886519612,1572.73281143487,0,4,1,1
"912342056",6,1714.86409871611,1708.62817714657,0,6,1,1
"912342057",9,1739.4454813256,1856.26587460569,2,7,1,1
"912342058",6,1719.28237633261,1708.62817714657,0,6,1,1
"912342059",10,1885.03224470899,1896.67490607898,3,7,1,1
"912342060",9,1835.07036929491,1856.26587460569,1,8,1,1
"912342061",9,1809.55333735547,1856.26587460569,0,9,1,1
"912342062",6,1740.87379438638,1708.62817714657,1,5,1,1
"912342063",7,1786.76497402477,1763.32076508842,1,6,1,1
"912342064",8,1837.60953473395,1812.11073017574,1,7,1,1
"912342065",8,1768.9789598743,1812.11073017574,1,7,1,1
"912342066",11,1712.31048760185,1933.98659929558,1,10,1,1
"912342067",7,1739.96609625588,1763.32076508842,0,7,1,1
"912342068",8,1779.11165295952,1812.11073017574,0,8,1,1
"912342069",6,1768.7396495308,1708.62817714657,0,6,1,1
"912342070",7,1819.32167090561,1763.32076508842,0,7,1,1
"912342071",6,1600.58134723807,1708.62817714657,1,5,1,1
"912342072",6,1756.31576273589,1708.62817714657,0,6,1,1
"912342073",5,1684.74990748949,1646.12614877363,0,5,1,1
"912342074",9,1766.31810782488,1856.26587460569,1,8,1,1
"912342075",7,1780.9597522461,1763.32076508842,0,7,1,1
"912342076",7,1782.02452530679,1763.32076508842,0,7,1,1
"912342077",5,1684.74990748949,1646.12614877363,0,5,1,1
"912342078",5,1684.74990748949,1646.12614877363,0,5,1,1
"912342079",10,1822.65276619431,1896.67490607898,1,9,1,1
"912342080",5,1684.74990748949,1646.12614877363,0,5,1,1
"912342081",6,1755.26635085425,1708.62817714657,0,6,1,1
"912342082",2,1399.19231957997,1364.97646362037,0,2,1,1
"912342083",4,1623.45851670784,1572.73281143487,0,4,1,1
"912342084",12,1780.83000470623,1968.69006049611,2,10,1,1
"912342085",13,1889.50383492955,2001.16379457045,3,10,1,1
"912342086",9,1827.56562091862,1856.26587460569,0,9,1,1
"912342087",10,1786.05816756625,1896.67490607898,1,9,1,1
"912342088",12,1849.08187585674,1968.69006049611,0,12,1,1
"912342089",7,1733.69365013235,1763.32076508842,0,7,1,1
"912342096",17,2080.06331360399,2113.95669457394,8,9,1,1
"912342098",18,2117.80627697368,2138.79896507223,6,12,1,1
"912342099",10,1784.61768360572,1896.67490607898,3,7,1,1
"912342107",12,1882.75956801595,1968.69006049611,5,7,1,1
"912342109",19,2162.3298524914,2162.56636020013,8,11,1,1
"912342111",17,2096.35909227505,2113.95669457394,6,11,1,1
"912342112",14,2015.20324435758,2031.70713799962,6,8,1,1
"912342113",9,1875.80144090881,1856.26587460569,5,4,1,1
"912342115",15,2072.67262107634,2060.56118614118,5,10,1,1
"912342118",46,3044.78403738495,2590.94954296761,24,22,1,1
"912342119",46,3132.40361787749,2590.94954296761,21,25,1,1
"912342120",40,3229.81724586823,2517.98110851286,15,25,1,1
"912342121",49,3243.2921064906,2624.62502504328,25,24,1,1
"912342122",47,2920.31205161039,2602.36394728806,21,26,1,1
"912342123",35,2583.97578977983,2450.1860183293,13,22,1,1
"912342124",37,2735.04951446556,2478.17471526668,15,22,1,1
"912342125",36,2825.32570841989,2464.33502634194,15,21,1,1
"912342126",42,3109.1493331814,2543.21752514954,21,21,1,1
"912342127",87,3302.21018293771,2951.40156710974,36,51,1,1
"912342128",30,2522.90212807309,2374.18906024059,12,18,1,1
"912342129",59,3184.4257156852,2726.17127719361,25,34,1,1
"912342130",68,3426.09220100575,2806.43931339586,29,39,1,1
"912342131",53,3393.3036783252,2667.061866114,26,27,1,1
"912342132",79,3674.12986253133,2893.78092561085,31,48,1,1
"912342133",65,2923.38385715768,2780.67589681985,26,39,1,1
"912342134",73,3072.44339397391,2847.4358582506,33,40,1,1
"912342135",73,3901.36543781384,2847.4358582506,32,41,1,1
"912342136",74,3375.17746764589,2855.36548874306,30,44,1,1
"912342137",52,3088.29549324076,2656.6981055205,24,28,1,1
"912342138",78,2903.04136670937,2886.25582696583,32,46,1,1
"912342139",81,3806.67846463405,2908.60658576875,33,48,1,1
"912342140",61,3322.63797663457,2744.81051624266,21,40,1,1
"912342141",52,3558.05079080276,2656.6981055205,26,26,1,1
"912342142",91,3195.40874310971,2978.64386243803,37,54,1,1
"912342144",59,3207.52373510059,2726.17127719361,29,30,1,1
"912342145",47,3057.52187362683,2602.36394728806,28,19,1,1
"912342146",57,3027.87238448759,2707.02236739438,26,31,1,1
"912342147",60,3138.14487707754,2735.5526890818,27,33,1,1
"912342148",72,3093.9094180881,2839.4193288992,27,45,1,1
"912342150",61,3555.97178590995,2744.81051624266,29,32,1,1
"912342151",71,3264.88297255757,2831.31372136695,28,43,1,1
"912342152",51,2832.76002229912,2646.17454577679,22,29,1,1
"912342153",73,3353.58506444006,2847.4358582506,27,46,1,1
"912342154",81,3403.2340422721,2908.60658576875,32,49,1,1
"912342155",41,2926.11112411927,2530.72175773865,18,23,1,1
"912342156",47,3100.33312692294,2602.36394728806,21,26,1,1
"912342157",37,2572.72969096153,2478.17471526668,15,22,1,1
"912342158",33,2745.31988149968,2420.89448855093,16,17,1,1
"912342159",30,2470.38978136136,2374.18906024059,15,15,1,1
"912342160",34,2594.85662955462,2435.71163614839,16,18,1,1
"912342161",31,2680.52899637657,2390.15469389133,16,15,1,1
"912342162",25,2280.88011854535,2287.34065519221,8,17,1,1
"912342163",35,2429.86268438449,2450.1860183293,15,20,1,1
"912342164",30,2459.11010843339,2374.18906024059,11,19,1,1
"912342165",72,3173.43012495614,2839.4193288992,34,38,1,1
"912342166",57,3195.62236152404,2707.02236739438,27,30,1,1
"912342167",40,2893.33226766256,2517.98110851286,18,22,1,1
"912342168",44,3189.19845666365,2567.51523707907,21,23,1,1
"912342169",23,1922.60160380468,2248.68783741607,7,16,1,1
"912342173",27,2222.02189663621,2323.60649590586,14,13,1,1
"912342174",23,2388.30402189622,2248.68783741607,13,10,1,1
"912342175",18,2157.85907071975,2138.79896507223,11,7,1,1
"912342176",20,2164.78237539987,2185.35845629437,9,11,1,1
"912342177",12,1988.07088124604,1968.69006049611,8,4,1,1
"912342178",21,2261.79935339861,2207.26116887512,9,12,1,1
"912342179",16,2108.62135318104,2087.92318348224,8,8,1,1
"912342180",16,2118.51576744603,2087.92318348224,8,8,1,1
"912342181",19,2179.36347537247,2162.56636020013,10,9,1,1
"912342182",20,2238.45285979767,2185.35845629437,10,10,1,1
"912342183",12,1891.92294251038,1968.69006049611,7,5,1,1
"912342184",23,2060.77587537909,2248.68783741607,13,10,1,1
"912342185",26,2357.10705198932,2305.75108410937,10,16,1,1
"912342186",29,2509.38181354369,2357.79423966008,14,15,1,1
"912342187",39,2668.0966864288,2504.98447234734,20,19,1,1
"912342188",40,2599.33740915592,2517.98110851286,17,23,1,1
"912342189",45,2699.72296204727,2579.33597919865,21,24,1,1
"912342190",48,2833.76404066128,2613.58673801098,19,29,1,1
"912342191",38,2747.90994873525,2491.71993967651,16,22,1,1
"912342205",13,1853.46166337906,2001.16379457045,7,6,1,1
"912342206",18,2046.87247899548,2138.79896507223,11,7,1,1
"912342207",23,2170.78587709809,2248.68783741607,12,11,1,1
"912342208",19,2140.75286601639,2162.56636020013,12,7,1,1
"912342209",24,2200.68791965105,2268.33468283819,11,13,1,1
"912342210",27,2052.77220985077,2323.60649590586,14,13,1,1
"912342211",22,2092.56233345431,2228.3491786518,11,11,1,1
"912342212",8,1807.48420425216,1812.11073017574,5,3,1,1
"912342213",15,1918.00684179446,2060.56118614118,6,9,1,1
"912342214",22,2133.5631329798,2228.3491786518,12,10,1,1
"912342215",13,1940.09919415479,2001.16379457045,8,5,1,1
"912342216",21,2207.22552152513,2207.26116887512,11,10,1,1
"912342217",24,2118.32351987502,2268.33468283819,12,12,1,1
"912342218",22,2098.74721688475,2228.3491786518,10,12,1,1
"912342219",20,2066.96809522893,2185.35845629437,9,11,1,1
"912342220",28,2098.70008853081,2340.94327947849,10,18,1,1
"912342221",21,1952.5235204482,2207.26116887512,12,9,1,1
"912342222",26,2144.25718813161,2305.75108410937,12,14,1,1
"912342223",25,2004.20084004016,2287.34065519221,12,13,1,1
"912342224",13,2023.53195562113,2001.16379457045,7,6,1,1
"912342225",23,2507.34224728058,2248.68783741607,9,14,1,1
"912342226",25,2590.0435701627,2287.34065519221,10,15,1,1
"912342227",28,2789.35632442119,2340.94327947849,11,17,1,1
"912342228",33,2828.14009096095,2420.89448855093,15,18,1,1
"912342229",35,2954.89270665574,2450.1860183293,14,21,1,1
"912342230",54,2947.651984501,2677.2712016452,27,27,1,1
"912342232",62,2906.21245179042,2753.94837323248,27,35,1,1
"912342233",53,3128.06696693651,2667.061866114,26,27,1,1
"912342234",58,3266.92849725622,2716.66249357165,24,34,1,1
"912342235",72,3722.63021970187,2839.4193288992,40,32,1,1
"912342236",81,4164.77201312009,2908.60658576875,43,38,1,1
"912342237",58,3006.07980121966,2716.66249357165,27,31,1,1
"912342238",47,3233.4515006951,2602.36394728806,20,27,1,1
"912342239",29,2556.45969245459,2357.79423966008,15,14,1,1
"912342240",41,2787.08018738351,2530.72175773865,22,19,1,1
"912342241",42,3070.16701134996,2543.21752514954,18,24,1,1
"912342242",44,2879.40633767266,2567.51523707907,18,26,1,1
"912342243",51,3104.76906552511,2646.17454577679,24,27,1,1
"912342245",20,2371.22757120874,2185.35845629437,8,12,1,1
"912342266",46,3036.07492327625,2590.94954296761,20,26,1,1
"912342267",61,3418.65534587181,2744.81051624266,30,31,1,1
"912342268",57,2918.92431538713,2707.02236739438,27,30,1,1
"912342269",66,2890.80124646659,2789.3669207067,32,34,1,1
"912342270",64,3020.33797156121,2771.87783482774,33,31,1,1
"912342271",76,3171.34746630447,2870.97236507783,38,38,1,1
"912342272",41,2921.22584001778,2530.72175773865,21,20,1,1
"912342273",56,3427.29343092578,2697.24673169728,27,29,1,1
"912342274",52,3040.71374110247,2656.6981055205,27,25,1,1
"912342275",40,2678.53102023647,2517.98110851286,21,19,1,1
"912342276",45,2697.83609382923,2579.33597919865,17,28,1,1
"912342277",48,3191.62866461328,2613.58673801098,20,28,1,1
"912342278",48,3006.05756370833,2613.58673801098,22,26,1,1
"912342279",68,2974.18312436204,2806.43931339586,34,34,1,1
"912342280",50,2978.32313190745,2635.48551585152,21,29,1,1
"912342281",47,3015.02589133171,2602.36394728806,21,26,1,1
"912342282",59,3085.68985062799,2726.17127719361,32,27,1,1
"912342283",44,2636.86983672851,2567.51523707907,24,20,1,1
"912342284",47,2763.06625798255,2602.36394728806,24,23,1,1
"912342285",72,3386.67720965851,2839.4193288992,35,37,1,1
"912342373",60,3065.37927855209,2735.5526890818,27,33,1,1
"912342374",40,3073.67133623951,2517.98110851286,16,24,1,1
"912342375",75,3243.87977988938,2863.21031780169,29,46,1,1
"912342376",71,3421.33716418485,2831.31372136695,27,44,1,1
"912342377",73,3271.56371574984,2847.4358582506,30,43,1,1
"912342378",66,3025.12785019349,2789.3669207067,25,41,1,1
"912342379",85,4397.66520016429,2937.40494579778,44,41,1,1
"912342380",67,3607.61441725902,2797.95380131742,33,34,1,1
"912342381",86,4077.65227181001,2944.43562859908,36,50,1,1
"912342382",86,4027.9501908943,2944.43562859908,46,40,1,1
"912342385",71,3903.85385532648,2831.31372136695,33,38,1,1
"912342386",49,2781.45191419271,2624.62502504328,19,30,1,1
"912342387",65,3010.60532469513,2780.67589681985,35,30,1,1
"912342388",71,3650.30461989993,2831.31372136695,37,34,1,1
"912342389",19,2046.85512411575,2162.56636020013,8,11,1,1
"912342390",13,1908.59901483272,2001.16379457045,6,7,1,1
"912342391",17,1987.0441132661,2113.95669457394,10,7,1,1
"912342392",14,1873.16019551031,2031.70713799962,7,7,1,1
"912342393",16,1967.74848511925,2087.92318348224,7,9,1,1
"912342394",11,1848.69488442908,1933.98659929558,5,6,1,1
"912342395",16,1954.15926554425,2087.92318348224,8,8,1,1
"912342396",12,1887.84024250803,1968.69006049611,4,8,1,1
"912342397",13,1889.40399707373,2001.16379457045,6,7,1,1
"912342398",6,1658.00110655364,1708.62817714657,2,4,1,1
"912342399",8,1813.5695243488,1812.11073017574,4,4,1,1
"912342408",18,1843.95238247057,2138.79896507223,10,8,1,1
"912342409",24,2111.77967451916,2268.33468283819,11,13,1,1
"912342410",22,2046.29329182002,2228.3491786518,14,8,1,1
"912342411",24,2092.71789890335,2268.33468283819,12,12,1,1
"912342412",17,1922.53315337768,2113.95669457394,9,8,1,1
"912342413",20,1897.72036430428,2185.35845629437,11,9,1,1
"912342414",21,2012.75158942775,2207.26116887512,11,10,1,1
"912342419",18,2034.75362235121,2138.79896507223,9,9,1,1
"912342420",18,2066.282136294,2138.79896507223,12,6,1,1
"912342421",27,2189.39308255106,2323.60649590586,12,15,1,1
"912342422",15,1849.23098025215,2060.56118614118,7,8,1,1
"912342423",18,2031.47898566615,2138.79896507223,11,7,1,1
"912342424",19,1948.84489407159,2162.56636020013,9,10,1,1
"912342425",16,1989.35893584746,2087.92318348224,9,7,1,1
"912342427",12,1849.14366475414,1968.69006049611,5,7,1,1
"912342428",15,1944.63619345275,2060.56118614118,9,6,1,1
"912342429",41,2884.70639659383,2530.72175773865,22,19,1,1
"912342430",17,2029.83978648879,2113.95669457394,9,8,1,1
"912342431",41,2686.64099102651,2530.72175773865,21,20,1,1
"912342432",25,2288.64706805201,2287.34065519221,14,11,1,1
"912342433",47,2763.69896755423,2602.36394728806,31,16,1,1
"912342434",42,2553.37075445791,2543.21752514954,24,18,1,1
"912342435",30,2602.41001200109,2374.18906024059,16,14,1,1
"912342436",26,2211.87130736125,2305.75108410937,14,12,1,1
"912342437",43,2825.89464804336,2555.47878346624,24,19,1,1
"912342438",47,2915.18466974856,2602.36394728806,26,21,1,1
"912342439",32,2837.41819486553,2405.71569249515,17,15,1,1
"912342440",31,2792.44934009844,2390.15469389133,16,15,1,1
"912342441",30,2632.27393312229,2374.18906024059,19,11,1,1
"912342442",36,2784.48106035372,2464.33502634194,23,13,1,1
"912342443",23,1825.26660514932,2248.68783741607,12,11,1,1
"912342444",25,2143.58548880609,2287.34065519221,14,11,1,1
"912342445",27,2350.21414216391,2323.60649590586,17,10,1,1
"912342446",27,2356.41999972556,2323.60649590586,16,11,1,1
"912342447",23,2215.02119956739,2248.68783741607,14,9,1,1
"912342448",21,2204.57454972298,2207.26116887512,14,7,1,1
"912342449",22,2211.39838456262,2228.3491786518,13,9,1,1
"912342450",38,2523.41746439884,2491.71993967651,21,17,1,1
"912342451",27,2151.88459757142,2323.60649590586,14,13,1,1
"912342452",25,2360.38307699812,2287.34065519221,15,10,1,1
"912342453",40,2728.19343491499,2517.98110851286,23,17,1,1
"912342454",34,2583.57913324193,2435.71163614839,22,12,1,1
"912342455",28,2511.73130403991,2340.94327947849,16,12,1,1
"912342456",35,2661.57385457689,2450.1860183293,21,14,1,1
"912342457",24,2360.54418933261,2268.33468283819,12,12,1,1
"912342458",26,2628.14412792797,2305.75108410937,16,10,1,1
"912342459",19,2123.6445811418,2162.56636020013,11,8,1,1
"912342460",31,2578.96315517842,2390.15469389133,16,15,1,1
"912342461",34,2823.24698498286,2435.71163614839,20,14,1,1
"912342462",36,2838.6690150539,2464.33502634194,20,16,1,1
"912342463",29,2758.09005118646,2357.79423966008,16,13,1,1
"912342464",42,3055.20337189449,2543.21752514954,23,19,1,1
"912342465",33,2740.72400999152,2420.89448855093,19,14,1,1
"912342466",24,2436.45670958927,2268.33468283819,14,10,1,1
"912342467",22,2233.81096261586,2228.3491786518,8,14,1,1
"912342468",22,2315.98811150271,2228.3491786518,9,13,1,1
"912342469",15,1877.53430684411,2060.56118614118,6,9,1,1
"912342470",35,2606.9689290344,2450.1860183293,19,16,1,1
"912342471",15,2112.7286233026,2060.56118614118,8,7,1,1
"912342472",26,2308.61940643181,2305.75108410937,14,12,1,1
"912342473",10,1891.06103713815,1896.67490607898,5,5,1,1
"912342474",16,1969.87916380547,2087.92318348224,10,6,1,1
"912342475",22,2089.26146820516,2228.3491786518,12,10,1,1
"912342476",25,2319.31651179683,2287.34065519221,13,12,1,1
"912342477",26,2292.34657727252,2305.75108410937,16,10,1,1
"912342478",41,2575.38551635168,2530.72175773865,24,17,1,1
"912342479",28,2470.99778112022,2340.94327947849,15,13,1,1
"912342480",45,2649.57524326284,2579.33597919865,25,20,1,1
"912342481",41,2939.27679674528,2530.72175773865,23,18,1,1
"912342482",49,3318.38196718501,2624.62502504328,30,19,1,1
"912342483",39,2608.11177353592,2504.98447234734,18,21,1,1
"912342484",25,2398.64571956818,2287.34065519221,15,10,1,1
"912342485",42,2765.65246919501,2543.21752514954,26,16,1,1
"912342486",49,2792.56197180799,2624.62502504328,28,21,1,1
"912342487",12,1875.10427248942,1968.69006049611,8,4,1,1
"912342488",13,1921.60144640041,2001.16379457045,10,3,1,1
"912342489",28,2458.55751970358,2340.94327947849,14,14,1,1
"912342490",46,2240.14675852006,2590.94954296761,24,22,1,1
"912342491",26,2339.02500699009,2305.75108410937,14,12,1,1
"912342492",35,2692.47300355631,2450.1860183293,21,14,1,1
"912342493",28,2363.42614360485,2340.94327947849,17,11,1,1
"912342494",42,2636.24205725901,2543.21752514954,23,19,1,1
"912342506",61,3580.53375373393,2744.81051624266,33,28,1,1
"912342507",75,3687.50039739234,2863.21031780169,44,31,1,1
"912342944",9,1848.68133679814,1856.26587460569,1,8,1,1
"912342945",10,1767.99683782689,1896.67490607898,2,8,1,1
"912342946",7,1777.50555521672,1763.32076508842,1,6,1,1
"912342947",9,1836.29628980298,1856.26587460569,1,8,1,1
"912342948",8,1810.54194458098,1812.11073017574,0,8,1,1
"912342949",6,1722.49823538877,1708.62817714657,0,6,1,1
"912342950",9,1815.40952823676,1856.26587460569,0,9,1,1
"912342951",11,1856.1919032431,1933.98659929558,2,9,1,1
"912342952",12,1792.09777334353,1968.69006049611,3,9,1,1
"912342953",6,1687.31259470073,1708.62817714657,1,5,1,1
"912342954",8,1749.63075949707,1812.11073017574,1,7,1,1
"912342955",8,1798.39970753569,1812.11073017574,2,6,1,1
"912342956",8,1718.41084273866,1812.11073017574,1,7,1,1
"912342957",8,1760.74407882123,1812.11073017574,2,6,1,1
"912342958",11,1821.49351565315,1933.98659929558,2,9,1,1
"912342959",13,1835.00832962458,2001.16379457045,3,10,1,1
"912342960",9,1792.27198012834,1856.26587460569,1,8,1,1
"912342961",9,1809.36217710295,1856.26587460569,1,8,1,1
"912343026",9,1817.46045344383,1856.26587460569,1,8,1,1
"912343028",6,1762.42435404811,1708.62817714657,0,6,1,1
"912343055",6,1692.960255028,1708.62817714657,0,6,1,1
"912343056",4,1623.45851670784,1572.73281143487,0,4,1,1
"912343057",4,1623.45851670784,1572.73281143487,0,4,1,1
"912343058",6,1764.58788100619,1708.62817714657,1,5,1,1
"912343059",9,1696.72634771287,1856.26587460569,3,6,1,1
"912343060",9,1757.99826366752,1856.26587460569,1,8,1,1
"912343088",32,2560.51164091727,2405.71569249515,19,13,1,1
"912343089",42,3112.32199869211,2543.21752514954,22,20,1,1
"912343090",51,3120.04308742317,2646.17454577679,24,27,1,1
"912343091",44,3158.92813080768,2567.51523707907,25,19,1,1
"912343092",48,3537.76451564617,2613.58673801098,23,25,1,1
"912343093",40,3020.93193557008,2517.98110851286,18,22,1,1
"912343094",36,2605.20631568263,2464.33502634194,21,15,1,1
"912343095",35,2755.68448243476,2450.1860183293,19,16,1,1
"912343096",53,3335.55071228715,2667.061866114,27,26,1,1
"912343097",38,2979.66817026425,2491.71993967651,20,18,1,1
"912343098",44,2740.20551782359,2567.51523707907,21,23,1,1
"912343100",34,2836.65236537671,2435.71163614839,16,18,1,1
"912343101",41,3020.02244179213,2530.72175773865,21,20,1,1
"912343102",49,2894.28075197652,2624.62502504328,23,26,1,1
"912343103",31,2444.34920857137,2390.15469389133,15,16,1,1
"912343104",30,2486.658882632,2374.18906024059,16,14,1,1
"912343105",46,2862.65286078702,2590.94954296761,27,19,1,1
"912343106",43,3068.36692021219,2555.47878346624,22,21,1,1
"912343107",41,2830.56522048594,2530.72175773865,23,18,1,1
"912343108",35,2840.50651435047,2450.1860183293,14,21,1,1
"912343109",39,2828.97836255508,2504.98447234734,21,18,1,1
"912343110",41,3130.45712218502,2530.72175773865,23,18,1,1
"912343111",47,3141.16221775955,2602.36394728806,25,22,1,1
"912343112",30,2508.39771857131,2374.18906024059,14,16,1,1
"912343113",24,2459.30103687469,2268.33468283819,12,12,1,1
"912343114",41,2833.91381808961,2530.72175773865,22,19,1,1
"912343115",33,2578.21866201882,2420.89448855093,12,21,1,1
"912343116",52,2929.43565377203,2656.6981055205,26,26,1,1
"912343117",28,2425.58322058111,2340.94327947849,15,13,1,1
"912343118",40,2856.61382297338,2517.98110851286,20,20,1,1
"912343119",39,2930.34336410037,2504.98447234734,19,20,1,1
"912343120",42,3309.20461521171,2543.21752514954,23,19,1,1
"912343121",43,2826.18648306969,2555.47878346624,22,21,1,1
"912343122",29,2603.75378060719,2357.79423966008,16,13,1,1
"912343123",51,3151.40382456976,2646.17454577679,30,21,1,1
"912343124",61,3293.5564476161,2744.81051624266,28,33,1,1
"912343125",37,2871.82384065241,2478.17471526668,20,17,1,1
"912343126",32,2993.40396017132,2405.71569249515,17,15,1,1
"912343127",53,3617.56725666522,2667.061866114,31,22,1,1
"912343128",55,3238.32077685839,2687.33120998132,31,24,1,1
"912343129",42,2811.43893786337,2543.21752514954,24,18,1,1
"912343130",31,2543.71778617365,2390.15469389133,17,14,1,1
"912343133",33,2707.97994829948,2420.89448855093,16,17,1,1
"912343134",24,2509.42558779454,2268.33468283819,14,10,1,1
"912343135",39,3071.98257744878,2504.98447234734,16,23,1,1
"912343136",34,2959.24012347145,2435.71163614839,15,19,1,1
"912343137",37,3007.79940006091,2478.17471526668,20,17,1,1
"912343138",30,2739.75068616593,2374.18906024059,18,12,1,1
"912343139",33,2617.49312400845,2420.89448855093,15,18,1,1
"912343140",37,2669.67107398402,2478.17471526668,16,21,1,1
"912343141",34,2807.04891067242,2435.71163614839,20,14,1,1
"912343142",50,3542.06599115331,2635.48551585152,29,21,1,1
"912343143",28,2625.85916889195,2340.94327947849,13,15,1,1
"912343144",39,2877.00289389499,2504.98447234734,22,17,1,1
"912343145",51,3249.19912482663,2646.17454577679,26,25,1,1
"912343146",43,3216.79380286366,2555.47878346624,20,23,1,1
"912343147",43,3026.00233531061,2555.47878346624,24,19,1,1
"912343149",49,3091.65468971476,2624.62502504328,20,29,1,1
"912343150",50,3118.53862941372,2635.48551585152,26,24,1,1
"912343151",38,2810.59591936108,2491.71993967651,13,25,1,1
"912343152",39,2981.18599511654,2504.98447234734,20,19,1,1
"912343153",40,2926.22231052745,2517.98110851286,20,20,1,1
"912343154",53,2675.06304282345,2667.061866114,25,28,1,1
"912343155",23,2487.70814516313,2248.68783741607,11,12,1,1
"912343156",33,2565.79055016718,2420.89448855093,22,11,1,1
"912343157",28,2494.37804345019,2340.94327947849,17,11,1,1
"912343158",44,2573.4275156591,2567.51523707907,26,18,1,1
"912343159",43,2989.06945893493,2555.47878346624,22,21,1,1
"912343160",34,2659.35089644327,2435.71163614839,21,13,1,1
"912343161",48,2980.31569792091,2613.58673801098,22,26,1,1
"912343162",32,2882.35002554988,2405.71569249515,16,16,1,1
"912343163",41,2800.55278205653,2530.72175773865,19,22,1,1
"912343164",50,2905.05933411114,2635.48551585152,25,25,1,1
"912343165",36,2533.34971893461,2464.33502634194,18,18,1,1
"912343166",49,2964.42763976949,2624.62502504328,29,20,1,1
"912343167",44,2884.06062053489,2567.51523707907,24,20,1,1
"912343168",30,2627.5896046538,2374.18906024059,17,13,1,1
"912343169",41,2694.52334273888,2530.72175773865,21,20,1,1
"912343170",54,2957.11225138974,2677.2712016452,30,24,1,1
"912343171",47,3022.16810549488,2602.36394728806,23,24,1,1
"912343173",54,2721.17969789855,2677.2712016452,27,27,1,1
"912343174",43,2825.6930505097,2555.47878346624,20,23,1,1
"912343175",52,3373.99902650731,2656.6981055205,26,26,1,1
"912343176",55,3202.96363792352,2687.33120998132,23,32,1,1
"912343177",45,3073.38214841735,2579.33597919865,26,19,1,1
"912343178",50,3332.04965829762,2635.48551585152,27,23,1,1
"912343179",27,2636.39061198502,2323.60649590586,12,15,1,1
"912343180",58,2857.91520951213,2716.66249357165,31,27,1,1
"912343181",46,2912.22108204627,2590.94954296761,23,23,1,1
"912343182",53,2752.94226333794,2667.061866114,27,26,1,1
"912343183",46,2944.3567547053,2590.94954296761,22,24,1,1
"912343184",46,2952.0572931295,2590.94954296761,26,20,1,1
"912343185",31,2558.49038184908,2390.15469389133,15,16,1,1
"912343186",35,3058.10772416949,2450.1860183293,21,14,1,1
"912343187",42,2945.16209675498,2543.21752514954,22,20,1,1
"912343189",46,2954.20885268931,2590.94954296761,19,27,1,1
"912343190",51,2813.31448050574,2646.17454577679,25,26,1,1
"912343191",39,2580.22638312355,2504.98447234734,19,20,1,1
"912343193",21,2453.31391984625,2207.26116887512,12,9,1,1
"912343194",22,2357.70031982206,2228.3491786518,11,11,1,1
"912343195",41,3393.52630566364,2530.72175773865,19,22,1,1
"912343196",49,3334.91168243224,2624.62502504328,22,27,1,1
"912343197",45,3418.05194694786,2579.33597919865,23,22,1,1
"912343198",44,3164.48561528923,2567.51523707907,19,25,1,1
"912343199",50,2949.02640139011,2635.48551585152,24,26,1,1
"912343200",44,2913.84333125173,2567.51523707907,23,21,1,1
"912343201",46,2772.19868910556,2590.94954296761,23,23,1,1
"912343202",40,2842.27795009827,2517.98110851286,16,24,1,1
"912343203",39,2730.78723072688,2504.98447234734,15,24,1,1
"912343204",44,3014.03367022137,2567.51523707907,18,26,1,1
"912343205",43,3161.89157848985,2555.47878346624,22,21,1,1
"912343206",67,3370.89445602963,2797.95380131742,36,31,1,1
"912343207",55,2850.5255071883,2687.33120998132,25,30,1,1
"912343208",51,2449.73818031369,2646.17454577679,27,24,1,1
"912343209",57,2850.25331336367,2707.02236739438,28,29,1,1
"912343210",38,3066.91014201365,2491.71993967651,19,19,1,1
"912343211",46,2918.5718094412,2590.94954296761,18,28,1,1
"912343212",46,3117.74777014501,2590.94954296761,21,25,1,1
"912343213",44,3158.57996761194,2567.51523707907,24,20,1,1
"912343214",38,2912.42921020727,2491.71993967651,18,20,1,1
"912343215",23,2345.07950192585,2248.68783741607,12,11,1,1
"912343216",40,2550.87164333818,2517.98110851286,17,23,1,1
"912343217",56,3007.84927920561,2697.24673169728,26,30,1,1
"912343218",41,3092.58676175948,2530.72175773865,21,20,1,1
"912343219",36,3042.30663028701,2464.33502634194,17,19,1,1
"912343220",39,2975.88108147569,2504.98447234734,16,23,1,1
"912343221",40,2762.33251301305,2517.98110851286,19,21,1,1
"912343222",41,3144.26867763005,2530.72175773865,16,25,1,1
"912343223",39,2812.29965085768,2504.98447234734,16,23,1,1
"912343224",48,3133.3322083062,2613.58673801098,26,22,1,1
"912343225",54,3384.92317549549,2677.2712016452,23,31,1,1
"912343226",51,3616.45914017855,2646.17454577679,31,20,1,1
"912343227",47,2747.92950244004,2602.36394728806,19,28,1,1
"912343228",57,2676.17340956108,2707.02236739438,24,33,1,1
"912343229",74,3314.61244331956,2855.36548874306,32,42,1,1
"912343230",49,3321.65852384503,2624.62502504328,22,27,1,1
"912343231",56,3397.28200057596,2697.24673169728,23,33,1,1
"912343232",62,3345.65155936151,2753.94837323248,30,32,1,1
"912343233",51,3135.21062537153,2646.17454577679,20,31,1,1
"912343235",59,3277.09269911335,2726.17127719361,29,30,1,1
"912343236",39,2867.86503152562,2504.98447234734,21,18,1,1
"912343237",31,2556.87380681452,2390.15469389133,13,18,1,1
"912343238",26,2330.70065012035,2305.75108410937,10,16,1,1
"912343239",29,2323.91921097043,2357.79423966008,15,14,1,1
"912343240",35,2658.04534924846,2450.1860183293,23,12,1,1
"912343241",39,2991.47911248859,2504.98447234734,23,16,1,1
"912343242",43,2693.36737529997,2555.47878346624,21,22,1,1
"912343243",20,2404.11934715902,2185.35845629437,11,9,1,1
"912343245",57,2951.38107995896,2707.02236739438,28,29,1,1
"912343246",48,2727.06738104708,2613.58673801098,24,24,1,1
"912343247",58,2883.5597658911,2716.66249357165,30,28,1,1
"912343248",47,3033.32507002711,2602.36394728806,24,23,1,1
"912343250",45,3396.42800093746,2579.33597919865,23,22,1,1
"912343252",43,3071.63234439708,2555.47878346624,23,20,1,1
"912343253",53,3280.97030375218,2667.061866114,27,26,1,1
"912343254",61,3117.04819868592,2744.81051624266,30,31,1,1
"912343255",57,3301.86798382182,2707.02236739438,26,31,1,1
"912343256",50,2852.7693449831,2635.48551585152,25,25,1,1
"912343257",40,2957.37869524903,2517.98110851286,23,17,1,1
"912343258",50,3111.37970317047,2635.48551585152,22,28,1,1
"912343259",38,2646.37841365573,2491.71993967651,21,17,1,1
"912343261",61,3244.42263303693,2744.81051624266,27,34,1,1
"912343262",58,3341.86891293264,2716.66249357165,26,32,1,1
"912343263",49,3034.91571581732,2624.62502504328,22,27,1,1
"912343264",37,2803.67772102736,2478.17471526668,19,18,1,1
"912343265",44,2856.58081847067,2567.51523707907,18,26,1,1
"912343266",39,2672.75372378843,2504.98447234734,16,23,1,1
"912343267",51,2623.43630154038,2646.17454577679,31,20,1,1
"912343268",44,2916.25871252923,2567.51523707907,23,21,1,1
"912343269",51,3230.92916766689,2646.17454577679,23,28,1,1
"912343270",44,2977.29854725318,2567.51523707907,17,27,1,1
"912343271",35,2462.8555372722,2450.1860183293,18,17,1,1
"912343272",37,2654.86445452625,2478.17471526668,16,21,1,1
"912343273",33,2742.63135746551,2420.89448855093,17,16,1,1
"912343274",41,2694.12488688143,2530.72175773865,16,25,1,1
"912343275",53,2868.08650159868,2667.061866114,23,30,1,1
"912343277",49,2893.9581355326,2624.62502504328,23,26,1,1
"912343278",41,2764.510545986,2530.72175773865,19,22,1,1
"912343280",40,2760.25612070286,2517.98110851286,20,20,1,1
"912343281",45,3200.77686644649,2579.33597919865,18,27,1,1
"912343282",39,2732.87400500413,2504.98447234734,16,23,1,1
"912343283",51,2856.66291956922,2646.17454577679,28,23,1,1
"912343284",48,3094.20391025985,2613.58673801098,23,25,1,1
"912343285",53,3241.18923988003,2667.061866114,26,27,1,1
"912343286",58,3138.29698978768,2716.66249357165,25,33,1,1
"912343287",69,3316.68344966569,2814.82611826518,34,35,1,1
"912343288",31,2523.69502159209,2390.15469389133,16,15,1,1
"912343289",62,3127.82085260022,2753.94837323248,29,33,1,1
"912343290",29,2639.0893405101,2357.79423966008,13,16,1,1
"912343291",32,2416.31853393978,2405.71569249515,14,18,1,1
"912343292",57,3446.14012355252,2707.02236739438,30,27,1,1
"912343293",45,2794.91067336783,2579.33597919865,20,25,1,1
"912343294",57,3346.2686024569,2707.02236739438,30,27,1,1
"912343295",45,2812.92175881376,2579.33597919865,26,19,1,1
"912343296",49,2744.74425549495,2624.62502504328,21,28,1,1
"912343297",53,2901.18614154092,2667.061866114,27,26,1,1
"912343298",43,3029.24327792307,2555.47878346624,23,20,1,1
"912343299",51,2961.6208965369,2646.17454577679,32,19,1,1
"912343300",38,2767.22526183294,2491.71993967651,20,18,1,1
"912343301",57,3154.76091890903,2707.02236739438,25,32,1,1
"912343303",43,2788.03674195807,2555.47878346624,19,24,1,1
"912343304",40,2962.61509923573,2517.98110851286,20,20,1,1
"912343305",58,2921.70399688838,2716.66249357165,26,32,1,1
"912343306",43,2890.76910817894,2555.47878346624,20,23,1,1
"912343307",46,2958.38268074642,2590.94954296761,18,28,1,1
"912343308",56,2924.52529451719,2697.24673169728,24,32,1,1
"912343309",54,3131.17504910137,2677.2712016452,28,26,1,1
"912343310",38,2887.89123019288,2491.71993967651,18,20,1,1
"912343311",38,2980.01589884747,2491.71993967651,21,17,1,1
"912343312",57,3403.52567580315,2707.02236739438,30,27,1,1
"912343313",62,3233.83346174232,2753.94837323248,30,32,1,1
"912343314",29,2851.48795491705,2357.79423966008,15,14,1,1
"912343315",22,2643.83810909589,2228.3491786518,8,14,1,1
"912343316",49,2550.60212692998,2624.62502504328,25,24,1,1
"912343317",44,2641.20484347203,2567.51523707907,25,19,1,1
"912343318",56,3144.22191746913,2697.24673169728,29,27,1,1
"912343319",55,3321.59172132668,2687.33120998132,23,32,1,1
"912343320",35,2699.08635940165,2450.1860183293,14,21,1,1
"912343321",42,2928.96171067945,2543.21752514954,19,23,1,1
"912343322",43,2731.34134027237,2555.47878346624,16,27,1,1
"912343323",36,2716.38274998681,2464.33502634194,14,22,1,1
"912343324",66,2824.52456506105,2789.3669207067,28,38,1,1
"912343325",49,2645.64110528767,2624.62502504328,25,24,1,1
"912343326",65,3541.17082235087,2780.67589681985,26,39,1,1
"912343327",68,3396.57626180277,2806.43931339586,27,41,1,1
"912343328",54,3138.10752803508,2677.2712016452,27,27,1,1
"912343329",50,3106.84536889657,2635.48551585152,23,27,1,1
"912343330",55,3322.15756235341,2687.33120998132,26,29,1,1
"912343331",36,2723.21747221777,2464.33502634194,12,24,1,1
"912343332",50,2857.27562023868,2635.48551585152,25,25,1,1
"912343333",44,2917.15136728549,2567.51523707907,19,25,1,1
"912343335",57,3085.865377564,2707.02236739438,26,31,1,1
"912343336",52,2689.04342675283,2656.6981055205,29,23,1,1
"912343337",53,2681.64652922418,2667.061866114,24,29,1,1
"912343338",43,2855.69015879953,2555.47878346624,19,24,1,1
"912343339",60,2814.33611708774,2735.5526890818,23,37,1,1
"912343340",69,3465.96330823559,2814.82611826518,31,38,1,1
"912343342",56,2874.5532906991,2697.24673169728,33,23,1,1
"912343343",50,3063.41569505493,2635.48551585152,27,23,1,1
"912343344",50,2934.89356527934,2635.48551585152,24,26,1,1
"912343345",55,2891.37455196643,2687.33120998132,30,25,1,1
"912343346",62,2988.74922737725,2753.94837323248,29,33,1,1
"912343347",54,2647.17108811925,2677.2712016452,24,30,1,1
"912343348",71,3307.18350148152,2831.31372136695,30,41,1,1
"912343349",51,2866.45246945716,2646.17454577679,24,27,1,1
"912343350",63,3270.39989967691,2762.96971264875,31,32,1,1
"912343351",70,2804.26288856769,2823.11677003184,31,39,1,1
"912343352",41,2467.16905371278,2530.72175773865,21,20,1,1
"912343353",28,2452.15222966831,2340.94327947849,14,14,1,1
"912343354",53,3228.92444399678,2667.061866114,25,28,1,1
"912343355",36,2776.21587781918,2464.33502634194,21,15,1,1
"912343356",44,3052.78867366074,2567.51523707907,26,18,1,1
"912343357",51,3355.98528573377,2646.17454577679,30,21,1,1
"912343358",36,2154.85955667003,2464.33502634194,16,20,1,1
"912343359",37,2000.16877050594,2478.17471526668,16,21,1,1
"912343400",43,3009.4411473894,2555.47878346624,21,22,1,1
"912343401",40,2921.78933026502,2517.98110851286,22,18,1,1
"912343407",57,2989.41537810382,2707.02236739438,29,28,1,1
"912343408",47,2951.89242919019,2602.36394728806,22,25,1,1
"912343409",53,3308.01365031407,2667.061866114,25,28,1,1
"912343410",55,3208.22969101958,2687.33120998132,25,30,1,1
"912343411",44,2939.40643873295,2567.51523707907,23,21,1,1
"912343412",46,3096.87849644515,2590.94954296761,20,26,1,1
"912343413",58,3140.12791554343,2716.66249357165,27,31,1,1
"912343414",58,3466.38710274677,2716.66249357165,30,28,1,1
"912343415",53,3073.13096860753,2667.061866114,21,32,1,1
"912343416",55,3613.05600275654,2687.33120998132,32,23,1,1
"912343417",50,2981.58369222911,2635.48551585152,22,28,1,1
"912343418",45,3535.33883698621,2579.33597919865,18,27,1,1
"912343419",35,2577.52958509828,2450.1860183293,21,14,1,1
"912343421",19,2102.25865334552,2162.56636020013,11,8,1,1
"912343422",38,2568.89362155608,2491.71993967651,25,13,1,1
"912343423",61,3385.33912721582,2744.81051624266,23,38,1,1
"912343424",50,3426.7715104339,2635.48551585152,20,30,1,1
"912343425",53,2822.8196884715,2667.061866114,27,26,1,1
"912343427",44,2921.61310805294,2567.51523707907,28,16,1,1
"912343428",40,2706.2830995132,2517.98110851286,23,17,1,1
"912343429",42,2655.72401745084,2543.21752514954,26,16,1,1
"912343430",49,2876.63546359194,2624.62502504328,27,22,1,1
"912343431",32,2485.8628989293,2405.71569249515,20,12,1,1
"912343432",36,2699.72562239843,2464.33502634194,19,17,1,1
"912343433",39,2583.58540638345,2504.98447234734,26,13,1,1
"912343434",43,2713.18895970747,2555.47878346624,26,17,1,1
"912343748",38,2816.84098608134,2491.71993967651,16,22,1,1
"912343750",65,2956.97492187665,2780.67589681985,31,34,1,1
"912343751",43,3086.08021140539,2555.47878346624,19,24,1,1
"912343752",41,2937.08138936875,2530.72175773865,24,17,1,1
"912343753",53,3336.45408743471,2667.061866114,30,23,1,1
"912343754",42,3064.21292973064,2543.21752514954,25,17,1,1
"912343755",54,2909.76992041851,2677.2712016452,22,32,1,1
"912343756",68,2891.8721726865,2806.43931339586,29,39,1,1
"912343757",46,2836.04528562283,2590.94954296761,20,26,1,1
"912343758",55,3528.98830428449,2687.33120998132,24,31,1,1
"912343759",46,3283.98884700018,2590.94954296761,19,27,1,1
"912343760",43,2985.69854975358,2555.47878346624,18,25,1,1
"912343761",40,2794.601585658,2517.98110851286,21,19,1,1
"912343762",34,2748.20370021039,2435.71163614839,16,18,1,1
"912343763",66,3536.58006830402,2789.3669207067,30,36,1,1
"912343764",60,2969.01085643204,2735.5526890818,30,30,1,1
"912343765",61,2853.83437323968,2744.81051624266,28,33,1,1
"912343766",69,2939.72569361563,2814.82611826518,31,38,1,1
"912343767",60,3445.63679978642,2735.5526890818,30,30,1,1
"912343768",57,3266.57673232704,2707.02236739438,26,31,1,1
"912343769",55,3030.9805008599,2687.33120998132,25,30,1,1
"912343770",69,3581.45454499799,2814.82611826518,34,35,1,1
"912343771",54,3191.47539572142,2677.2712016452,27,27,1,1
"912343772",69,3505.52281608933,2814.82611826518,33,36,1,1
"912343773",53,3444.22510582755,2667.061866114,23,30,1,1
"912343774",56,3640.03007307394,2697.24673169728,23,33,1,1
"912343775",73,4008.25280920717,2847.4358582506,32,41,1,1
"912343776",66,3847.10520031292,2789.3669207067,31,35,1,1
"912343777",61,3883.36258626424,2744.81051624266,25,36,1,1
"912343778",70,2992.96838654236,2823.11677003184,32,38,1,1
"912343779",36,2535.18716086952,2464.33502634194,16,20,1,1
"912343780",43,3034.74844646323,2555.47878346624,19,24,1,1
"912343781",40,2938.73967575959,2517.98110851286,19,21,1,1
"912343782",37,2987.25857229797,2478.17471526668,17,20,1,1
"912343783",33,2776.00294558208,2420.89448855093,17,16,1,1
"912343784",45,2520.19512964173,2579.33597919865,24,21,1,1
"912343785",42,2867.7031060568,2543.21752514954,20,22,1,1
"912343786",40,2975.453495581,2517.98110851286,19,21,1,1
"912343787",38,2628.8625267225,2491.71993967651,20,18,1,1
"912343788",29,2646.19036888865,2357.79423966008,15,14,1,1
"912343789",40,2592.0382805632,2517.98110851286,25,15,1,1
"912343790",50,2690.64969114973,2635.48551585152,24,26,1,1
"912343791",50,3032.14291611623,2635.48551585152,24,26,1,1
"912343792",58,2901.5362086261,2716.66249357165,32,26,1,1
"912343793",53,2958.62601903655,2667.061866114,29,24,1,1
"912343794",51,3142.40407070296,2646.17454577679,30,21,1,1
"912343795",47,3012.35747503048,2602.36394728806,26,21,1,1
"912343796",53,2917.77484472093,2667.061866114,23,30,1,1
"912343797",50,3311.71250786461,2635.48551585152,24,26,1,1
"912343798",54,3173.33513777372,2677.2712016452,19,35,1,1
"912343799",51,3096.46194863278,2646.17454577679,25,26,1,1
"912343800",49,3471.95051698497,2624.62502504328,20,29,1,1
"912343801",61,2869.18628918896,2744.81051624266,23,38,1,1
"912343802",59,3221.88282902778,2726.17127719361,28,31,1,1
"912343803",59,3689.76797158664,2726.17127719361,28,31,1,1
"912343804",50,2690.74540535433,2635.48551585152,22,28,1,1
"912343805",65,2972.85110067834,2780.67589681985,34,31,1,1
"912343807",47,2943.11878341746,2602.36394728806,22,25,1,1
"912343808",52,3095.60357951314,2656.6981055205,24,28,1,1
"912343809",60,3472.99233061668,2735.5526890818,29,31,1,1
"912343810",63,3380.46271239317,2762.96971264875,27,36,1,1
"912343811",50,3017.87923739923,2635.48551585152,28,22,1,1
"912343813",46,2850.69399643531,2590.94954296761,21,25,1,1
"912343814",27,2466.8527295504,2323.60649590586,15,12,1,1
"912343815",65,3243.91366910387,2780.67589681985,34,31,1,1
"912343816",74,3027.55050181068,2855.36548874306,40,34,1,1
"912343817",85,3442.18841508172,2937.40494579778,44,41,1,1
"912343818",55,2816.31159517162,2687.33120998132,27,28,1,1
"912343819",34,2578.2868802214,2435.71163614839,18,16,1,1
"912343820",8,1805.97122911304,1812.11073017574,6,2,1,1
"912343821",26,2319.59446158843,2305.75108410937,14,12,1,1
"912343822",32,2583.78111057439,2405.71569249515,15,17,1,1
"912343823",24,2429.25596772708,2268.33468283819,9,15,1,1
"912343824",6,1812.02593354677,1708.62817714657,2,4,1,1
"912343825",29,2275.54255359388,2357.79423966008,16,13,1,1
"912343826",35,2542.93064079758,2450.1860183293,16,19,1,1
"912343827",22,2206.3547042248,2228.3491786518,11,11,1,1
"912343828",9,1931.91265071024,1856.26587460569,5,4,1,1
"912343829",28,2523.11576277406,2340.94327947849,16,12,1,1
"912343831",24,2337.09793860772,2268.33468283819,13,11,1,1
"912344164",34,2627.24159866539,2435.71163614839,11,23,1,1
"912344165",34,2755.14464019564,2435.71163614839,15,19,1,1
"912344166",39,2903.96049537989,2504.98447234734,16,23,1,1
"912344167",47,3113.07170517997,2602.36394728806,16,31,1,1
"912344168",43,3162.30615656631,2555.47878346624,18,25,1,1
"912344169",49,3261.17366399256,2624.62502504328,25,24,1,1
"912344170",42,3211.867120432,2543.21752514954,20,22,1,1
"912344171",34,2885.52135233882,2435.71163614839,16,18,1,1
"912344172",34,3232.99916978956,2435.71163614839,17,17,1,1
"912344173",54,3255.51351458868,2677.2712016452,23,31,1,1
"912344174",52,3367.07536107329,2656.6981055205,21,31,1,1
"912344175",34,2719.13343740941,2435.71163614839,16,18,1,1
"912344176",30,2775.28155519577,2374.18906024059,17,13,1,1
"912344177",29,2316.97596774333,2357.79423966008,14,15,1,1
"912344178",36,2577.7621346652,2464.33502634194,18,18,1,1
"912344179",65,3652.01539857786,2780.67589681985,23,42,1,1
"912344180",53,3058.50223053603,2667.061866114,17,36,1,1
"912344181",49,3177.18642272902,2624.62502504328,18,31,1,1
"912344183",50,3087.05186986636,2635.48551585152,19,31,1,1
"912344185",44,2761.41015969996,2567.51523707907,20,24,1,1
"912344186",52,2752.41856574901,2656.6981055205,20,32,1,1
"912344187",51,3269.46009099314,2646.17454577679,21,30,1,1
"912344188",38,2958.19680610688,2491.71993967651,16,22,1,1
"912344189",61,3439.2823556596,2744.81051624266,22,39,1,1
"912344190",56,3003.34150665456,2697.24673169728,20,36,1,1
"912344191",74,3737.55992778602,2855.36548874306,31,43,1,1
"912344192",47,2944.87606098374,2602.36394728806,20,27,1,1
"912344193",61,3364.83630135783,2744.81051624266,30,31,1,1
"912344194",38,2720.45211280673,2491.71993967651,19,19,1,1
"912344195",42,2935.85180341903,2543.21752514954,19,23,1,1
"912344196",59,3525.03804165773,2726.17127719361,26,33,1,1
"912344197",63,3307.14473928813,2762.96971264875,29,34,1,1
"912344198",41,2944.41683246703,2530.72175773865,17,24,1,1
"912344199",44,3055.18530265655,2567.51523707907,15,29,1,1
"912344200",49,3016.50882239186,2624.62502504328,17,32,1,1
"912344201",52,3121.83252846487,2656.6981055205,22,30,1,1
"912344202",43,3065.86023850784,2555.47878346624,16,27,1,1
"912344203",44,3025.45231749694,2567.51523707907,18,26,1,1
"912344204",51,3663.87467788028,2646.17454577679,18,33,1,1
"912344205",59,3861.67564865583,2726.17127719361,20,39,1,1
"912344206",55,3445.28297818278,2687.33120998132,18,37,1,1
"912344207",36,2855.04144463145,2464.33502634194,17,19,1,1
"912344208",34,2762.75373848351,2435.71163614839,15,19,1,1
"912344209",40,2930.93691103946,2517.98110851286,17,23,1,1
"912344210",47,2938.52882582004,2602.36394728806,24,23,1,1
"912344211",46,3196.75155620813,2590.94954296761,21,25,1,1
"912344213",57,4148.6739012952,2707.02236739438,25,32,1,1
"912344214",60,4022.21306526149,2735.5526890818,22,38,1,1
"912344215",74,3798.14523200212,2855.36548874306,33,41,1,1
"912344217",52,3328.37399255036,2656.6981055205,21,31,1,1
"912344218",48,3359.50914075519,2613.58673801098,25,23,1,1
"912344219",47,3218.88922279146,2602.36394728806,21,26,1,1
"912344220",38,2904.50559799492,2491.71993967651,18,20,1,1
"912344221",55,3341.09721046917,2687.33120998132,21,34,1,1
"912344222",54,3395.62512476502,2677.2712016452,23,31,1,1
"912344223",37,2943.38590839922,2478.17471526668,15,22,1,1
"912344224",44,3075.17100591497,2567.51523707907,16,28,1,1
"912344225",44,3168.33843477602,2567.51523707907,13,31,1,1
"912344226",53,2992.86551647564,2667.061866114,17,36,1,1
"912344227",55,3596.60810579573,2687.33120998132,24,31,1,1
"912344228",77,3707.22840006357,2878.65357631343,35,42,1,1
"912344229",41,2986.34350903704,2530.72175773865,16,25,1,1
"912344230",54,3368.02252144264,2677.2712016452,20,34,1,1
"912344231",52,3645.85258322199,2656.6981055205,20,32,1,1
"912344232",53,3562.87744567154,2667.061866114,20,33,1,1
"912344233",45,2973.03705717557,2579.33597919865,19,26,1,1
"912344234",60,3415.03106913298,2735.5526890818,28,32,1,1
"912344235",52,2920.39458697187,2656.6981055205,23,29,1,1
"912344236",43,2759.44399197909,2555.47878346624,20,23,1,1
"912344237",92,3418.83938877029,2985.30521778333,41,51,1,1
"912344238",57,3687.95361940579,2707.02236739438,23,34,1,1
"912344239",59,3486.91230643798,2726.17127719361,21,38,1,1
"912344240",53,3341.626118855,2667.061866114,24,29,1,1
"912344241",69,4078.03121674326,2814.82611826518,27,42,1,1
"912344242",63,3231.23441154992,2762.96971264875,26,37,1,1
"912344243",53,3340.80203303964,2667.061866114,20,33,1,1
"912344244",66,3221.08598092839,2789.3669207067,33,33,1,1
"912344245",49,3467.27643316297,2624.62502504328,23,26,1,1
"912344246",65,3856.7569558369,2780.67589681985,27,38,1,1
"912344247",43,3309.9880635059,2555.47878346624,19,24,1,1
"912344248",36,2957.64336246133,2464.33502634194,14,22,1,1
"912344249",31,2516.25554624798,2390.15469389133,10,21,1,1
"912344250",30,2607.57578043213,2374.18906024059,17,13,1,1
"912344251",36,2670.38868867235,2464.33502634194,19,17,1,1
"912344252",29,2594.47497485098,2357.79423966008,10,19,1,1
"912344253",33,2679.26940767401,2420.89448855093,15,18,1,1
"912344254",35,2731.96853292752,2450.1860183293,14,21,1,1
"912344255",37,2568.77232290344,2478.17471526668,14,23,1,1
"912344256",30,2256.37863664992,2374.18906024059,15,15,1,1
"912344257",33,2613.1565571701,2420.89448855093,15,18,1,1
"912344258",39,2449.90353695892,2504.98447234734,17,22,1,1
"912344259",31,2509.77968741252,2390.15469389133,13,18,1,1
"912344260",50,2996.13132676307,2635.48551585152,22,28,1,1
"912344261",38,2616.28792096237,2491.71993967651,18,20,1,1
"912344262",50,2871.60474614164,2635.48551585152,24,26,1,1
"912344263",60,3231.90143084267,2735.5526890818,29,31,1,1
"912344264",46,2955.61688698246,2590.94954296761,16,30,1,1
"912344265",44,2991.8737464998,2567.51523707907,18,26,1,1
"912344266",62,3291.39384303941,2753.94837323248,23,39,1,1
"912344267",67,3459.18818603416,2797.95380131742,27,40,1,1
"912344268",42,3128.88182522348,2543.21752514954,17,25,1,1
"912344269",10,1884.98834345008,1896.67490607898,5,5,1,1
"912344270",35,2572.65739175243,2450.1860183293,19,16,1,1
"912344271",30,2607.25191490168,2374.18906024059,13,17,1,1
"912344272",11,1935.55680805888,1933.98659929558,6,5,1,1
"912344273",34,2442.30080143534,2435.71163614839,18,16,1,1
"912344274",40,2766.82391691325,2517.98110851286,21,19,1,1
"912344275",27,2356.51262775172,2323.60649590586,14,13,1,1
"912344276",39,2850.74555619924,2504.98447234734,21,18,1,1
"912344278",17,2023.66488735152,2113.95669457394,10,7,1,1
"912344279",13,1855.7749984089,2001.16379457045,8,5,1,1
"912344280",6,1746.98960530475,1708.62817714657,2,4,1,1
"912344281",10,1901.53074607584,1896.67490607898,5,5,1,1
"912344282",23,2563.02557677698,2248.68783741607,13,10,1,1
"912344283",29,2236.8571255352,2357.79423966008,13,16,1,1
"912344284",26,2471.74258439042,2305.75108410937,13,13,1,1
"912344285",2,1370.5414309119,1364.97646362037,2,0,1,1
"912344286",23,2219.05616253901,2248.68783741607,14,9,1,1
"912344287",28,2405.98095789766,2340.94327947849,14,14,1,1
"912344288",33,2322.18099190732,2420.89448855093,16,17,1,1
"912344290",38,2553.66848119453,2491.71993967651,20,18,1,1
"912344291",35,2441.98321475731,2450.1860183293,21,14,1,1
"912344292",26,2067.33508753206,2305.75108410937,13,13,1,1
"912344293",36,2567.78384095091,2464.33502634194,17,19,1,1
"912344294",30,2343.2551201298,2374.18906024059,16,14,1,1
"912344295",38,2476.61799476079,2491.71993967651,18,20,1,1
"912344296",43,2359.84335135173,2555.47878346624,20,23,1,1
"912344297",44,2481.73035045148,2567.51523707907,22,22,1,1
"912344298",38,2714.07070466574,2491.71993967651,21,17,1,1
"912344299",32,2398.33882962311,2405.71569249515,17,15,1,1
"912344300",33,2390.75321613776,2420.89448855093,14,19,1,1
"912344301",27,2242.63081059194,2323.60649590586,11,16,1,1
"912344302",39,2375.56376465729,2504.98447234734,23,16,1,1
"912344303",37,2383.27489901654,2478.17471526668,20,17,1,1
"912344304",45,2502.85587841282,2579.33597919865,23,22,1,1
"912344305",41,2375.58345252255,2530.72175773865,20,21,1,1
"912344306",33,2249.05245085737,2420.89448855093,18,15,1,1
"912344307",34,2407.44666329304,2435.71163614839,17,17,1,1
"912344308",28,2448.38692524863,2340.94327947849,13,15,1,1
"912344309",38,2468.37695297312,2491.71993967651,21,17,1,1
"912344310",28,2403.0724204226,2340.94327947849,14,14,1,1
"912344311",29,2460.38276230762,2357.79423966008,15,14,1,1
"912344312",34,2421.95182650806,2435.71163614839,20,14,1,1
"912344313",28,2458.96515823336,2340.94327947849,15,13,1,1
"912344314",23,2340.66070175855,2248.68783741607,11,12,1,1
"912344315",31,2409.89324518748,2390.15469389133,16,15,1,1
"912344316",63,2795.0171378088,2762.96971264875,33,30,1,1
"912344317",49,2723.24063174481,2624.62502504328,23,26,1,1
"912344318",26,2225.68603492247,2305.75108410937,13,13,1,1
"912344319",31,2347.21946257134,2390.15469389133,14,17,1,1
"912344320",43,2691.18310828005,2555.47878346624,24,19,1,1
"912344321",40,2529.34109957338,2517.98110851286,22,18,1,1
"912344322",33,2695.9207605794,2420.89448855093,16,17,1,1
"912344323",47,2704.55752935705,2602.36394728806,25,22,1,1
"912344324",45,2953.89697371857,2579.33597919865,30,15,1,1
"912344325",41,2839.32950980144,2530.72175773865,24,17,1,1
"912344326",38,3021.77329430585,2491.71993967651,23,15,1,1
"912344327",21,2282.32512213466,2207.26116887512,12,9,1,1
"912344328",53,2816.43262611359,2667.061866114,23,30,1,1
"912344329",48,2759.31647189124,2613.58673801098,21,27,1,1
"912344330",28,2481.2227056268,2340.94327947849,15,13,1,1
"912344331",25,2639.78035184654,2287.34065519221,13,12,1,1
"912344332",31,2476.69332759987,2390.15469389133,19,12,1,1
"912344333",39,2691.42477907022,2504.98447234734,23,16,1,1
"912344334",40,2876.21182665398,2517.98110851286,21,19,1,1
"912344335",42,2700.67132242126,2543.21752514954,23,19,1,1
"912344336",43,2840.6892128225,2555.47878346624,27,16,1,1
"912344337",38,2543.99502071197,2491.71993967651,19,19,1,1
"912344338",45,2717.28614926986,2579.33597919865,23,22,1,1
"912344339",36,2929.6294121366,2464.33502634194,20,16,1,1
"912344340",58,2909.42275092063,2716.66249357165,31,27,1,1
"912344341",45,2857.12974285393,2579.33597919865,27,18,1,1
"912344342",36,2769.24092031456,2464.33502634194,18,18,1,1
"912344343",35,2738.63120295067,2450.1860183293,19,16,1,1
"912344344",53,3057.68104347124,2667.061866114,28,25,1,1
"912344345",50,3091.98311377082,2635.48551585152,25,25,1,1
"912344346",46,2802.5562220173,2590.94954296761,25,21,1,1
"912344347",51,2922.11052761399,2646.17454577679,29,22,1,1
"912344348",22,2413.69135151081,2228.3491786518,10,12,1,1
"912344349",37,2806.17180119448,2478.17471526668,21,16,1,1
"912344350",41,2734.47401938999,2530.72175773865,23,18,1,1
"912344351",45,2749.67972297159,2579.33597919865,27,18,1,1
"912344352",39,2885.3782661553,2504.98447234734,23,16,1,1
"912344353",53,3063.07427934056,2667.061866114,33,20,1,1
"912344354",23,2290.21433800852,2248.68783741607,13,10,1,1
"912344355",19,2131.93823605481,2162.56636020013,12,7,1,1
"912344356",23,2400.8792933441,2248.68783741607,13,10,1,1
"912344357",46,2754.29869134547,2590.94954296761,24,22,1,1
"912344358",48,2561.79919560598,2613.58673801098,28,20,1,1
"912344359",51,3027.07794629746,2646.17454577679,27,24,1,1
"912344360",51,2761.75729269328,2646.17454577679,22,29,1,1
"912344361",61,2554.62346316093,2744.81051624266,31,30,1,1
"912344363",28,2642.56229678096,2340.94327947849,16,12,1,1
"912344364",41,2613.68853711668,2530.72175773865,25,16,1,1
"912344365",41,2718.5856689997,2530.72175773865,25,16,1,1
"912344366",44,2557.22493220687,2567.51523707907,21,23,1,1
"912344367",40,2403.43040278334,2517.98110851286,20,20,1,1
"912344368",30,2620.72411431186,2374.18906024059,21,9,1,1
"912344369",29,2417.48483113832,2357.79423966008,18,11,1,1
"912344370",29,2027.13801794612,2357.79423966008,9,20,1,1
"912344371",23,1983.72534519895,2248.68783741607,8,15,1,1
"912344372",24,2015.10000938736,2268.33468283819,11,13,1,1
"912344373",62,3145.34047717253,2753.94837323248,30,32,1,1
"912344374",57,3233.58092052911,2707.02236739438,27,30,1,1
"912344375",56,3465.10810509711,2697.24673169728,29,27,1,1
"912344376",65,3638.06482318542,2780.67589681985,33,32,1,1
"912344377",47,3036.63898680316,2602.36394728806,24,23,1,1
"912344378",39,2822.64942057908,2504.98447234734,21,18,1,1
"912344379",10,1878.7907392436,1896.67490607898,5,5,1,1
"912344380",3,1471.12497731539,1482.92019466158,2,1,1,1
"912344381",14,1884.13652340046,2031.70713799962,5,9,1,1
"912344382",19,2090.42924242454,2162.56636020013,4,15,1,1
"912344383",14,1932.72094019748,2031.70713799962,3,11,1,1
"912344384",17,1945.61675886802,2113.95669457394,4,13,1,1
"912344385",45,2485.19267116735,2579.33597919865,22,23,1,1
"912344386",40,2522.73775574346,2517.98110851286,22,18,1,1
"912344387",43,2481.38502980104,2555.47878346624,24,19,1,1
"912344388",31,2385.59016631531,2390.15469389133,18,13,1,1
"912344389",40,2560.22574015713,2517.98110851286,23,17,1,1
"912344390",29,2299.75946224577,2357.79423966008,16,13,1,1
"912344391",34,2255.60259345268,2435.71163614839,13,21,1,1
"912344392",19,1978.0806381318,2162.56636020013,7,12,1,1
"912344464",85,3759.65586399041,2937.40494579778,44,41,1,1
"912344465",76,3446.50505176548,2870.97236507783,45,31,1,1
"912344466",76,3641.96729066395,2870.97236507783,32,44,1,1
"912344467",99,3482.39934365587,3030.38817685238,44,55,1,1
"912344468",36,2572.90012587179,2464.33502634194,23,13,1,1
"912344469",33,2893.9737309534,2420.89448855093,15,18,1,1
"912344470",17,2162.2567244268,2113.95669457394,10,7,1,1
"912344471",67,3177.8250069181,2797.95380131742,35,32,1,1
"912344472",55,2763.74081320429,2687.33120998132,26,29,1,1
"912344473",81,3307.73302970551,2908.60658576875,39,42,1,1
"912344474",80,3943.11753540491,2901.2306171403,30,50,1,1
"912344475",76,3580.19631060799,2870.97236507783,35,41,1,1
"912344476",98,3515.85893535011,3024.10627920296,48,50,1,1
"912344477",92,3416.3490056701,2985.30521778333,40,52,1,1
"912344478",80,4075.4876107072,2901.2306171403,30,50,1,1
"912344480",85,3382.15587729453,2937.40494579778,45,40,1,1
"912344481",76,3280.55024255833,2870.97236507783,40,36,1,1
"912344482",105,3590.15636572206,3067.05425459434,40,65,1,1
"912344483",89,3574.53686849954,2965.14449011489,47,42,1,1
"912344484",79,3237.39112261689,2893.78092561085,37,42,1,1
"912344485",66,3556.21110834712,2789.3669207067,27,39,1,1
"912344487",84,2791.23945540315,2930.30814451558,40,44,1,1
"912344488",81,3249.03319695478,2908.60658576875,38,43,1,1
"912344489",61,2887.81362753006,2744.81051624266,31,30,1,1
"912344490",75,3912.56326907135,2863.21031780169,34,41,1,1
"912344491",64,3171.07677189213,2771.87783482774,31,33,1,1
"912344492",65,3687.21821279886,2780.67589681985,30,35,1,1
"912344493",79,3425.05827757979,2893.78092561085,37,42,1,1
"912344494",89,3548.42615738036,2965.14449011489,41,48,1,1
"912344495",61,3140.89369108205,2744.81051624266,29,32,1,1
"912344496",60,2849.26292367875,2735.5526890818,29,31,1,1
"912344498",120,3322.42018822235,3151.91769689326,51,69,1,1
"912344499",94,3191.06970730961,2998.45695239283,41,53,1,1
"912344500",43,3042.90965307225,2555.47878346624,20,23,1,1
"912344502",79,3727.19479033663,2893.78092561085,37,42,1,1
"912344503",75,3832.45913756374,2863.21031780169,41,34,1,1
"912344504",36,2425.17788175611,2464.33502634194,20,16,1,1
"912344505",46,2489.28743794097,2590.94954296761,27,19,1,1
"912344506",78,2877.59966376633,2886.25582696583,38,40,1,1
"912344507",63,3030.71003778287,2762.96971264875,34,29,1,1
"912344508",74,3449.36756467042,2855.36548874306,35,39,1,1
"912344509",72,3317.8674800679,2839.4193288992,36,36,1,1
"912344510",79,3157.50649783279,2893.78092561085,37,42,1,1
"912344511",82,3788.24923856794,2915.91045786314,42,40,1,1
"912344512",98,3257.35370470391,3024.10627920296,39,59,1,1
"912344513",73,3165.25834568592,2847.4358582506,41,32,1,1
"912344515",57,3409.77554209257,2707.02236739438,30,27,1,1
"912344516",66,3538.07576886994,2789.3669207067,32,34,1,1
"912344517",91,4234.59268719938,2978.64386243803,41,50,1,1
"912344518",77,3502.62141445441,2878.65357631343,36,41,1,1
"912344519",65,2895.82626098532,2780.67589681985,31,34,1,1
"912344520",123,3691.5193594834,3167.86598086922,59,64,1,1
"912344521",86,3054.983021155,2944.43562859908,47,39,1,1
"912344522",110,4009.03692387746,3096.3566638509,46,64,1,1
"912344524",96,3658.04748462182,3011.38790884243,45,51,1,1
"912344526",91,4003.10573337078,2978.64386243803,40,51,1,1
"912344527",74,3366.7490507767,2855.36548874306,37,37,1,1
"912344528",88,3359.25531445123,2958.30409156145,44,44,1,1
"912344530",47,2918.5243244004,2602.36394728806,20,27,1,1
"912344531",33,2645.31762935214,2420.89448855093,14,19,1,1
"912344532",41,2837.1808622387,2530.72175773865,15,26,1,1
"912344533",52,3283.85194150295,2656.6981055205,22,30,1,1
"912344536",48,3295.99443949909,2613.58673801098,20,28,1,1
"912344537",28,2512.0557741856,2340.94327947849,9,19,1,1
"912344538",45,2793.21958032006,2579.33597919865,23,22,1,1
"912344539",59,2886.66315410636,2726.17127719361,32,27,1,1
"912344540",46,2727.87898705425,2590.94954296761,15,31,1,1
"912344541",42,2610.97634437055,2543.21752514954,17,25,1,1
"912344542",24,2435.99232228787,2268.33468283819,13,11,1,1
"912344543",54,3053.57628256428,2677.2712016452,21,33,1,1
"912344544",52,3197.23825754066,2656.6981055205,21,31,1,1
"912344545",56,3088.65462565939,2697.24673169728,28,28,1,1
"912344546",60,3285.97147764259,2735.5526890818,27,33,1,1
"912344547",59,3047.37047135231,2726.17127719361,28,31,1,1
"912344548",51,3102.2904979483,2646.17454577679,23,28,1,1
"912344549",48,3363.84983010402,2613.58673801098,20,28,1,1
"912344550",27,2316.50117165336,2323.60649590586,11,16,1,1
"912344551",42,2590.18226871789,2543.21752514954,18,24,1,1
"912344553",20,2282.46041283682,2185.35845629437,7,13,1,1
"912344554",17,2003.96098156639,2113.95669457394,5,12,1,1
"912344556",22,2427.68045504373,2228.3491786518,12,10,1,1
"912344557",24,2439.1015874406,2268.33468283819,12,12,1,1
"912344558",24,2294.9861810815,2268.33468283819,11,13,1,1
"912344559",25,2256.08071925618,2287.34065519221,10,15,1,1
"912344560",21,2053.43920995445,2207.26116887512,11,10,1,1
"912344561",17,2072.81226079733,2113.95669457394,9,8,1,1
"912344562",19,2178.21340010706,2162.56636020013,10,9,1,1
"912344563",16,2069.10316159742,2087.92318348224,8,8,1,1
"912344564",16,2014.12853576769,2087.92318348224,7,9,1,1
"912344565",22,2086.49047777728,2228.3491786518,8,14,1,1
"912344566",19,2146.13383324014,2162.56636020013,10,9,1,1
"912344568",24,2232.34066848253,2268.33468283819,12,12,1,1
"912344569",21,2069.12615446176,2207.26116887512,10,11,1,1
"912344570",25,2401.27092673887,2287.34065519221,15,10,1,1
"912344571",24,2247.71144372649,2268.33468283819,13,11,1,1
"912344572",30,2473.20115884172,2374.18906024059,16,14,1,1
"912344573",85,2702.05438950002,2937.40494579778,48,37,1,1
"912344575",95,2903.82783913529,3004.94950458202,50,45,1,1
"912344576",70,3017.35856391398,2823.11677003184,34,36,1,1
"912344581",91,3885.16394526646,2978.64386243803,39,52,1,1
"912344644",74,3755.63323689682,2855.36548874306,33,41,1,1
"912344645",76,4082.42920917472,2870.97236507783,29,47,1,1
"912344646",87,4003.0696728768,2951.40156710974,33,54,1,1
"912344647",79,4063.86984520513,2893.78092561085,35,44,1,1
"912344648",83,4417.36302118397,2923.1438046077,35,48,1,1
"912344726",22,2395.57831276486,2228.3491786518,10,12,1,1
"912344727",11,1997.0286208408,1933.98659929558,7,4,1,1
"912344728",15,2099.93100541774,2060.56118614118,8,7,1,1
"912344729",14,2095.53866640541,2031.70713799962,8,6,1,1
"912344730",9,1784.97524905576,1856.26587460569,7,2,1,1
"912344731",10,1961.82801021815,1896.67490607898,6,4,1,1
"912344732",21,2235.25366450041,2207.26116887512,13,8,1,1
"912344733",17,2133.12040088832,2113.95669457394,9,8,1,1
"912344734",15,2120.4087510785,2060.56118614118,8,7,1,1
"912344735",20,2247.25560900432,2185.35845629437,12,8,1,1
"912344736",8,1768.70275304428,1812.11073017574,5,3,1,1
"912344737",14,2211.3751705014,2031.70713799962,8,6,1,1
"912344738",14,2086.16756534378,2031.70713799962,9,5,1,1
"912344739",12,2031.3695285938,1968.69006049611,8,4,1,1
"912344740",21,2151.13159835404,2207.26116887512,13,8,1,1
"912344741",15,2008.89283442367,2060.56118614118,9,6,1,1
"912344742",17,2201.49843962904,2113.95669457394,9,8,1,1
"912344743",19,2278.97693688623,2162.56636020013,9,10,1,1
"912344744",21,2391.65425382587,2207.26116887512,12,9,1,1
"912344745",16,2211.8908868737,2087.92318348224,9,7,1,1
"912344746",17,2135.40254976869,2113.95669457394,12,5,1,1
"912344747",12,1988.39296789484,1968.69006049611,7,5,1,1
"912344748",13,1941.68817228981,2001.16379457045,8,5,1,1
"912344749",9,1844.09010752111,1856.26587460569,5,4,1,1
"912344750",12,2144.54797218524,1968.69006049611,5,7,1,1
"912344751",16,2167.8125719509,2087.92318348224,10,6,1,1
"912344753",10,1930.63051625029,1896.67490607898,8,2,1,1
"912344754",19,2181.44606527053,2162.56636020013,12,7,1,1
"912344755",27,2463.45316358656,2323.60649590586,15,12,1,1
"912344756",17,2077.07015846673,2113.95669457394,11,6,1,1
"912344757",15,2191.76561284768,2060.56118614118,8,7,1,1
"912344794",22,2141.83501124662,2228.3491786518,11,11,1,1
"912344795",23,2108.29805916928,2248.68783741607,10,13,1,1
"912344796",18,2106.59152267823,2138.79896507223,9,9,1,1
"912344797",19,2095.30550077072,2162.56636020013,9,10,1,1
"912344798",14,1940.91668528497,2031.70713799962,6,8,1,1
"912344799",9,1875.81683880403,1856.26587460569,4,5,1,1
"912344800",11,1778.42054557368,1933.98659929558,5,6,1,1
"912344801",19,1983.47013894716,2162.56636020013,7,12,1,1
"912344802",17,2021.13033700826,2113.95669457394,7,10,1,1
"912344803",16,2007.18667378105,2087.92318348224,7,9,1,1
"912344804",24,2091.5242853083,2268.33468283819,11,13,1,1
"912344805",19,2101.45938509052,2162.56636020013,9,10,1,1
"912344806",19,2137.13448564274,2162.56636020013,11,8,1,1
"912344807",12,1926.63339572356,1968.69006049611,5,7,1,1
"912344808",20,2098.52263747564,2185.35845629437,10,10,1,1
"912344809",13,1982.0978137101,2001.16379457045,8,5,1,1
"912344810",18,1996.16429078121,2138.79896507223,10,8,1,1
"912344811",20,2136.62888023026,2185.35845629437,10,10,1,1
"912344812",19,2036.77200196333,2162.56636020013,7,12,1,1
"912344813",16,2022.82108353076,2087.92318348224,9,7,1,1
"912344814",18,1960.07038740049,2138.79896507223,8,10,1,1
"912344815",13,1944.04270111736,2001.16379457045,6,7,1,1
"912344816",12,1924.68417831925,1968.69006049611,6,6,1,1
"912344818",21,2078.02112999281,2207.26116887512,6,15,1,1
"912344819",23,2153.66553445623,2248.68783741607,9,14,1,1
"912344820",15,2125.49227605489,2060.56118614118,7,8,1,1
"912344821",20,2129.90345531671,2185.35845629437,10,10,1,1
"912344822",21,2123.11895117888,2207.26116887512,10,11,1,1
"912344823",15,1967.36400223501,2060.56118614118,7,8,1,1
"912344824",16,1972.05291841108,2087.92318348224,5,11,1,1
"912344825",11,1924.24575128825,1933.98659929558,5,6,1,1
"912344826",20,2177.8393722394,2185.35845629437,7,13,1,1
"912344827",15,1988.09218778403,2060.56118614118,7,8,1,1
"912344828",15,1953.13512286622,2060.56118614118,7,8,1,1
"912344877",41,3026.82179719339,2530.72175773865,21,20,1,1
"912344878",35,2935.63599781744,2450.1860183293,16,19,1,1
"912344879",36,2897.21846913709,2464.33502634194,20,16,1,1
"912344880",32,2508.41342999493,2405.71569249515,17,15,1,1
"912344881",46,2850.78157722307,2590.94954296761,22,24,1,1
"912344882",47,2982.46330640769,2602.36394728806,23,24,1,1
"912344883",55,3451.20849801441,2687.33120998132,33,22,1,1
"912344884",39,2752.02336967357,2504.98447234734,19,20,1,1
"912344885",12,1896.28589214733,1968.69006049611,6,6,1,1
"912344886",42,2779.53031455914,2543.21752514954,20,22,1,1
"912344887",29,2467.58081255763,2357.79423966008,15,14,1,1
"912344888",45,2950.63502150155,2579.33597919865,22,23,1,1
"912344889",41,2343.7361906264,2530.72175773865,20,21,1,1
"912344890",33,2950.82410603977,2420.89448855093,18,15,1,1
"912344891",54,3320.16738192864,2677.2712016452,27,27,1,1
"912344892",36,2984.8775816897,2464.33502634194,22,14,1,1
"912344893",26,2448.39360265956,2305.75108410937,14,12,1,1
"912344894",24,2391.6773244265,2268.33468283819,13,11,1,1
"912344895",38,2907.22804946601,2491.71993967651,22,16,1,1
"912344896",42,2985.6734062887,2543.21752514954,24,18,1,1
"912344897",46,2648.77385554266,2590.94954296761,22,24,1,1
"912344898",35,2523.60388662599,2450.1860183293,20,15,1,1
"912344899",42,2910.71027741106,2543.21752514954,21,21,1,1
"912344900",49,2903.02658825213,2624.62502504328,23,26,1,1
"912344901",20,2355.63377287668,2185.35845629437,10,10,1,1
"912344902",52,3040.49430356261,2656.6981055205,28,24,1,1
"912344903",33,2613.79799529514,2420.89448855093,16,17,1,1
"912344904",38,2694.71362463059,2491.71993967651,21,17,1,1
"912344905",46,3119.19611137421,2590.94954296761,23,23,1,1
"912344906",45,3069.32995671679,2579.33597919865,21,24,1,1
"912344907",44,3005.28127957217,2567.51523707907,18,26,1,1
"912344908",34,2635.32881815409,2435.71163614839,15,19,1,1
"912344909",36,2952.93312615409,2464.33502634194,19,17,1,1
"912344910",59,3292.36854394513,2726.17127719361,35,24,1,1
"912344911",52,3188.85021421028,2656.6981055205,29,23,1,1
"912344912",31,2576.49938609823,2390.15469389133,17,14,1,1
"912344913",37,2586.01531909225,2478.17471526668,17,20,1,1
"912344914",34,2823.19954267023,2435.71163614839,19,15,1,1
"912344915",58,3319.76284325579,2716.66249357165,28,30,1,1
"912344916",56,3589.43195318625,2697.24673169728,30,26,1,1
"912344917",44,3186.07434838792,2567.51523707907,22,22,1,1
"912344918",34,2820.4352779768,2435.71163614839,17,17,1,1
"912344919",58,3340.98002597591,2716.66249357165,28,30,1,1
"912344920",33,2539.3683396563,2420.89448855093,14,19,1,1
"912344921",41,2900.59299336861,2530.72175773865,24,17,1,1
"912344923",39,2643.30465520994,2504.98447234734,21,18,1,1
"912344925",38,2334.25626239289,2491.71993967651,22,16,1,1
"912344926",47,3339.38003733548,2602.36394728806,25,22,1,1
"912344927",25,2319.56849935193,2287.34065519221,14,11,1,1
"912344928",43,3021.55394613973,2555.47878346624,22,21,1,1
"912344929",47,2813.88027699223,2602.36394728806,24,23,1,1
"912344930",59,3338.64669936263,2726.17127719361,30,29,1,1
"912344931",49,3162.1121120589,2624.62502504328,26,23,1,1
"912344932",51,3220.62426593116,2646.17454577679,27,24,1,1
"912344933",45,3146.77643756825,2579.33597919865,21,24,1,1
"912344934",33,2550.20974143306,2420.89448855093,20,13,1,1
"912344935",51,2995.66188554763,2646.17454577679,29,22,1,1
"912344936",40,2875.36254883891,2517.98110851286,22,18,1,1
"912344937",34,2643.77216256102,2435.71163614839,20,14,1,1
"912344938",34,2778.14364999799,2435.71163614839,18,16,1,1
"912344939",30,2718.6479202793,2374.18906024059,16,14,1,1
"912344940",41,3021.78415649656,2530.72175773865,23,18,1,1
"912344941",42,3207.40990819006,2543.21752514954,23,19,1,1
"912344942",47,2868.19971616799,2602.36394728806,25,22,1,1
"912344943",42,2774.99978905828,2543.21752514954,26,16,1,1
"912344944",43,3010.18191157086,2555.47878346624,25,18,1,1
"912344945",38,2911.04133408188,2491.71993967651,19,19,1,1
"912344946",42,2772.93224106822,2543.21752514954,23,19,1,1
"912344947",22,2285.55475246856,2228.3491786518,13,9,1,1
"912344948",31,2661.16383810256,2390.15469389133,18,13,1,1
"912344949",34,2645.29534174812,2435.71163614839,15,19,1,1
"912344950",38,2754.4618876383,2491.71993967651,21,17,1,1
"912344951",36,2909.99860482902,2464.33502634194,19,17,1,1
"912344952",41,3140.27146273615,2530.72175773865,22,19,1,1
"912344953",41,2920.12268588725,2530.72175773865,22,19,1,1
"912344954",57,3226.03826530821,2707.02236739438,33,24,1,1
"912344955",46,2874.78285396977,2590.94954296761,27,19,1,1
"912344956",43,2901.19641062216,2555.47878346624,23,20,1,1
"912344957",45,2898.37084198562,2579.33597919865,21,24,1,1
"912344958",37,2777.01955695042,2478.17471526668,20,17,1,1
"912344959",45,3041.54384429334,2579.33597919865,24,21,1,1
"912344960",43,3176.68420206792,2555.47878346624,25,18,1,1
"912344961",35,2765.00020289614,2450.1860183293,19,16,1,1
"912344962",35,2893.42506789339,2450.1860183293,18,17,1,1
"912344963",46,2770.93677360356,2590.94954296761,27,19,1,1
"912344964",56,3201.38576214282,2697.24673169728,31,25,1,1
"912344965",38,2606.0572084586,2491.71993967651,24,14,1,1
"912344967",35,2629.63738010703,2450.1860183293,19,16,1,1
"912344969",42,2901.08118988416,2543.21752514954,21,21,1,1
"912344970",67,3731.85776389776,2797.95380131742,34,33,1,1
"912344971",58,3488.74497282568,2716.66249357165,32,26,1,1
"912344972",41,3032.3855288302,2530.72175773865,21,20,1,1
"912345033",20,2439.8191786437,2185.35845629437,11,9,1,1
"912345034",22,2531.68904217952,2228.3491786518,12,10,1,1
"912345035",21,2502.71577743754,2207.26116887512,13,8,1,1
"912345036",19,2439.08872267055,2162.56636020013,11,8,1,1
"912345037",24,2547.81968756937,2268.33468283819,14,10,1,1
"912345038",28,2696.24006468184,2340.94327947849,16,12,1,1
"912345091",7,1708.85829699578,1763.32076508842,3,4,1,1
"912345092",9,1771.79372261847,1856.26587460569,4,5,1,1
"912345093",7,1709.44178204952,1763.32076508842,1,6,1,1
"912345094",11,1831.94426587645,1933.98659929558,1,10,1,1
"912345095",12,1770.7404049763,1968.69006049611,1,11,1,1
"912345097",8,1773.88629579208,1812.11073017574,0,8,1,1
"912345098",5,1613.6643576441,1646.12614877363,1,4,1,1
"912345099",7,1800.98529850456,1763.32076508842,0,7,1,1
"912345101",8,1731.48013502835,1812.11073017574,3,5,1,1
"912345102",13,1831.05044093558,2001.16379457045,3,10,1,1
"912345103",10,1814.64909376498,1896.67490607898,2,8,1,1
"912345104",9,1739.68729002108,1856.26587460569,2,7,1,1
"912345105",6,1724.71805881063,1708.62817714657,1,5,1,1
"912345106",5,1670.08930527589,1646.12614877363,1,4,1,1
"912345107",10,1846.90765365067,1896.67490607898,1,9,1,1
"912345108",12,1842.73068561317,1968.69006049611,2,10,1,1
"912345109",13,1846.47979267944,2001.16379457045,5,8,1,1
"912345110",8,1724.77665678977,1812.11073017574,2,6,1,1
"912345111",7,1735.65264058968,1763.32076508842,1,6,1,1
"912345112",5,1690.60958766006,1646.12614877363,0,5,1,1
"912345113",6,1711.62683872933,1708.62817714657,0,6,1,1
"912345114",6,1741.03239833594,1708.62817714657,1,5,1,1
"912345115",7,1826.48188013437,1763.32076508842,2,5,1,1
"912345116",9,1842.30130135335,1856.26587460569,2,7,1,1
"912345117",9,1790.11427536156,1856.26587460569,2,7,1,1
"912345118",8,1845.61308785146,1812.11073017574,2,6,1,1
"912345119",7,1799.92849721869,1763.32076508842,1,6,1,1
"912345360",42,2892.16683827288,2543.21752514954,30,12,1,1
"912345361",39,3021.2956915479,2504.98447234734,26,13,1,1
"912345362",45,2907.35562327061,2579.33597919865,29,16,1,1
"912345363",45,3058.48454264041,2579.33597919865,28,17,1,1
"912345364",44,2995.2494675565,2567.51523707907,27,17,1,1
"912345365",47,3137.71913940481,2602.36394728806,31,16,1,1
"912345366",42,3142.2601232235,2543.21752514954,26,16,1,1
"912345367",51,3334.16558491337,2646.17454577679,32,19,1,1
"912345368",55,3413.03202858915,2687.33120998132,32,23,1,1
"912345369",44,2783.06234457282,2567.51523707907,27,17,1,1
"912345370",56,3093.48249619492,2697.24673169728,31,25,1,1
"912345371",55,3392.51191403399,2687.33120998132,31,24,1,1
"912345372",37,2971.4321194815,2478.17471526668,24,13,1,1
"912345373",31,2555.80946368256,2390.15469389133,19,12,1,1
"912345374",58,3277.9732637414,2716.66249357165,32,26,1,1
"912345375",47,2898.84247088881,2602.36394728806,30,17,1,1
"912345376",65,3584.81073891474,2780.67589681985,37,28,1,1
"912345377",59,3534.42965746724,2726.17127719361,34,25,1,1
"912345378",39,2726.21351148834,2504.98447234734,20,19,1,1
"912345379",32,2577.44869795714,2405.71569249515,16,16,1,1
"912345380",46,2854.21361680441,2590.94954296761,25,21,1,1
"912345381",62,3287.08889832597,2753.94837323248,32,30,1,1
"912345382",56,3207.24123028601,2697.24673169728,31,25,1,1
"912345383",75,3400.8649995482,2863.21031780169,43,32,1,1
"912345384",55,2963.00454201391,2687.33120998132,30,25,1,1
"912345385",50,2809.22868607549,2635.48551585152,28,22,1,1
"912345386",52,2896.7430361883,2656.6981055205,28,24,1,1
"912345387",58,3135.31380808422,2716.66249357165,35,23,1,1
"912345388",66,3744.02437074667,2789.3669207067,38,28,1,1
"912345389",59,3595.90013320495,2726.17127719361,35,24,1,1
"912345390",55,3338.74064683319,2687.33120998132,30,25,1,1
"912345391",16,2094.96778554542,2087.92318348224,12,4,1,1
"912345392",28,2471.85225889551,2340.94327947849,16,12,1,1
"912345393",24,2268.55032220054,2268.33468283819,12,12,1,1
"912345394",21,2164.69637591806,2207.26116887512,12,9,1,1
"912345395",19,2230.13986074409,2162.56636020013,9,10,1,1
"912345396",32,2473.35401142619,2405.71569249515,17,15,1,1
"912345397",48,3192.81794658706,2613.58673801098,26,22,1,1
"912345398",24,2348.1126892649,2268.33468283819,16,8,1,1
"912345399",45,2729.71577309273,2579.33597919865,31,14,1,1
"912345400",47,2962.72230536907,2602.36394728806,30,17,1,1
"912345402",45,2761.97669624621,2579.33597919865,26,19,1,1
"912345403",42,2739.36959130556,2543.21752514954,28,14,1,1
"912345404",8,1848.9548710573,1812.11073017574,4,4,1,1
"912345405",13,2073.79776238927,2001.16379457045,8,5,1,1
"912345406",22,2244.40132416917,2228.3491786518,12,10,1,1
"912345407",38,2624.43090510434,2491.71993967651,21,17,1,1
"912345408",41,2724.72374713613,2530.72175773865,21,20,1,1
"912345409",36,2665.99667216837,2464.33502634194,21,15,1,1
"912345410",46,2927.73037133231,2590.94954296761,26,20,1,1
"912345411",56,3057.57276462669,2697.24673169728,34,22,1,1
"912345412",46,2840.2450495524,2590.94954296761,24,22,1,1
"912345413",48,3090.50542490136,2613.58673801098,34,14,1,1
"912345414",49,2739.55324230775,2624.62502504328,34,15,1,1
"912345415",53,3196.09251448825,2667.061866114,32,21,1,1
"912345416",40,2297.97820412706,2517.98110851286,26,14,1,1
"912345417",54,2771.06276864238,2677.2712016452,33,21,1,1
"912345418",37,2551.7695189846,2478.17471526668,23,14,1,1
"912345419",45,2605.40042972681,2579.33597919865,29,16,1,1
"912345420",53,3016.76851309107,2667.061866114,34,19,1,1
"912345421",48,2820.86369010901,2613.58673801098,30,18,1,1
"912345422",43,2884.58752479095,2555.47878346624,24,19,1,1
"912345423",54,3408.07521364618,2677.2712016452,31,23,1,1
"912345425",49,2981.77226187895,2624.62502504328,26,23,1,1
"912345426",66,3105.00168030151,2789.3669207067,32,34,1,1
"912345427",64,3545.98778712697,2771.87783482774,37,27,1,1
"912345428",54,3093.12459420163,2677.2712016452,28,26,1,1
"912345429",49,3093.92388851153,2624.62502504328,31,18,1,1
"912345432",63,3488.24881426555,2762.96971264875,35,28,1,1
"912345433",67,3975.2932128739,2797.95380131742,36,31,1,1
"912345434",40,2866.82641430326,2517.98110851286,24,16,1,1
"912345435",27,2645.87913073295,2323.60649590586,15,12,1,1
"912345436",56,2711.59055258652,2697.24673169728,31,25,1,1
"912345437",62,3119.34700675344,2753.94837323248,32,30,1,1
"912345438",30,2373.05384607225,2374.18906024059,19,11,1,1
"912345439",51,2876.89226020367,2646.17454577679,31,20,1,1
"912345440",57,2999.43330248916,2707.02236739438,25,32,1,1
"912345441",40,2766.1958971143,2517.98110851286,17,23,1,1
"912345442",58,3099.41066517811,2716.66249357165,30,28,1,1
"912345443",53,3190.71872793416,2667.061866114,25,28,1,1
"912345444",61,3415.11459423595,2744.81051624266,32,29,1,1
"912345445",70,3348.66585056996,2823.11677003184,33,37,1,1
"912345446",67,3315.29954749293,2797.95380131742,38,29,1,1
"912345447",57,3002.88606407563,2707.02236739438,31,26,1,1
"912345448",40,2968.86082885912,2517.98110851286,19,21,1,1
"912345449",51,3171.42226604456,2646.17454577679,30,21,1,1
"912345450",65,3402.45990690806,2780.67589681985,29,36,1,1
"912345451",80,3227.66471071133,2901.2306171403,36,44,1,1
"912345453",66,2986.34769545266,2789.3669207067,35,31,1,1
"912345454",9,1825.84710410213,1856.26587460569,5,4,1,1
"912345455",8,1820.89135816754,1812.11073017574,3,5,1,1
"912345456",54,3089.76123108314,2677.2712016452,28,26,1,1
"912345457",54,3320.44357188004,2677.2712016452,30,24,1,1
"912345458",70,3429.39707043409,2823.11677003184,34,36,1,1
"912345459",77,3670.61985579322,2878.65357631343,45,32,1,1
"912345460",50,2981.44628621306,2635.48551585152,29,21,1,1
"912345461",60,3280.39123613844,2735.5526890818,26,34,1,1
"912345462",61,3279.0433998476,2744.81051624266,32,29,1,1
"912345463",47,3039.65068385413,2602.36394728806,26,21,1,1
"912345464",33,2530.11287638525,2420.89448855093,20,13,1,1
"912345465",42,3015.76560117872,2543.21752514954,23,19,1,1
"912345466",41,2938.54134146444,2530.72175773865,23,18,1,1
"912345467",19,2136.76949314279,2162.56636020013,11,8,1,1
"912345468",18,2193.8940300328,2138.79896507223,8,10,1,1
"912345469",52,2468.52988203136,2656.6981055205,28,24,1,1
"912345470",35,2869.04684675247,2450.1860183293,24,11,1,1
"912345471",87,3676.59970579019,2951.40156710974,48,39,1,1
"912345472",39,3029.40366621155,2504.98447234734,22,17,1,1
"912345473",44,2932.3302708177,2567.51523707907,22,22,1,1
"912345474",53,3675.8134949053,2667.061866114,24,29,1,1
"912345475",45,3080.41971435638,2579.33597919865,25,20,1,1
"912345477",76,3616.61432383324,2870.97236507783,43,33,1,1
"912345478",25,2542.71766152966,2287.34065519221,13,12,1,1
"912345479",20,2147.26856168384,2185.35845629437,11,9,1,1
"912345480",51,2863.92640000187,2646.17454577679,33,18,1,1
"912345481",33,2620.99091251293,2420.89448855093,21,12,1,1
"912345482",48,2819.55010190048,2613.58673801098,23,25,1,1
"912345483",45,3030.85436989084,2579.33597919865,20,25,1,1
"912345484",52,3207.69154632592,2656.6981055205,27,25,1,1
"912345485",59,3182.08385915752,2726.17127719361,32,27,1,1
"912345486",80,3496.97602192691,2901.2306171403,41,39,1,1
"912345487",79,3617.0283296056,2893.78092561085,47,32,1,1
"912345488",84,3401.90129058806,2930.30814451558,41,43,1,1
"912345489",37,2669.85495433528,2478.17471526668,21,16,1,1
"912345490",53,3228.04027143424,2667.061866114,32,21,1,1
"912345491",44,2922.94322911977,2567.51523707907,26,18,1,1
"912345492",56,2841.70611969677,2697.24673169728,30,26,1,1
"912345493",28,2237.65101888362,2340.94327947849,14,14,1,1
"912345494",41,2919.86232834654,2530.72175773865,19,22,1,1
"912345495",57,3520.67168812102,2707.02236739438,29,28,1,1
"912345496",65,3668.59666836343,2780.67589681985,30,35,1,1
"912345497",57,3759.33235458708,2707.02236739438,29,28,1,1
"912345498",54,3030.8611379539,2677.2712016452,27,27,1,1
"912345499",38,2667.58783611974,2491.71993967651,16,22,1,1
"912345500",76,3434.30325977212,2870.97236507783,42,34,1,1
"912345501",43,2686.59059089132,2555.47878346624,22,21,1,1
"912345502",60,2950.64389256066,2735.5526890818,33,27,1,1
"912345505",45,2783.23423647462,2579.33597919865,18,27,1,1
"912345506",51,3165.939505986,2646.17454577679,25,26,1,1
"912345507",66,3699.89708916932,2789.3669207067,33,33,1,1
"912345508",65,3561.41235101817,2780.67589681985,37,28,1,1
"912345509",62,3051.16020743236,2753.94837323248,36,26,1,1
"912345510",56,3262.58089726705,2697.24673169728,31,25,1,1
"912345511",70,3582.31543706666,2823.11677003184,35,35,1,1
"912345512",60,3092.09251058062,2735.5526890818,23,37,1,1
"912345513",52,3350.57098066018,2656.6981055205,23,29,1,1
"912345514",52,3166.38359429655,2656.6981055205,26,26,1,1
"912345515",80,3945.18039229054,2901.2306171403,43,37,1,1
"912345516",75,4076.3545097725,2863.21031780169,39,36,1,1
"912345517",75,3427.82332261682,2863.21031780169,41,34,1,1
"912345518",79,4108.33134524099,2893.78092561085,43,36,1,1
"912345519",67,3538.84095291517,2797.95380131742,31,36,1,1
"912345520",41,2940.396099524,2530.72175773865,29,12,1,1
"912345521",49,2753.4349060242,2624.62502504328,29,20,1,1
"912345522",30,2391.57336106805,2374.18906024059,20,10,1,1
"912345523",57,3226.66629860619,2707.02236739438,38,19,1,1
"912345524",70,3904.35186099062,2823.11677003184,45,25,1,1
"912345525",58,3517.39944734789,2716.66249357165,40,18,1,1
"912345526",55,2903.55164962954,2687.33120998132,25,30,1,1
"912345527",57,3521.62324033424,2707.02236739438,36,21,1,1
"912345528",70,4153.35536526477,2823.11677003184,33,37,1,1
"912345529",79,3642.33147422778,2893.78092561085,45,34,1,1
"912345530",46,3038.00058036821,2590.94954296761,29,17,1,1
"912345531",46,2913.73541728289,2590.94954296761,31,15,1,1
"912345532",48,3082.18661977408,2613.58673801098,24,24,1,1
"912345533",63,3724.66325013422,2762.96971264875,36,27,1,1
"912345534",55,3355.68097467669,2687.33120998132,29,26,1,1
"912345535",61,2879.60326391287,2744.81051624266,28,33,1,1
"912345536",56,3760.38655783061,2697.24673169728,31,25,1,1
"912345537",68,3529.8230487836,2806.43931339586,37,31,1,1
"912345538",64,3205.11627618099,2771.87783482774,33,31,1,1
"912345609",12,1868.77329950407,1968.69006049611,5,7,1,1
"912345610",16,2021.06095371179,2087.92318348224,8,8,1,1
"912345611",17,2089.06050978052,2113.95669457394,8,9,1,1
"912345710",56,3154.06914003508,2697.24673169728,27,29,1,1
"912345711",45,2915.19300601083,2579.33597919865,28,17,1,1
"912345712",46,2901.16514960622,2590.94954296761,26,20,1,1
"912345713",47,2926.11591287428,2602.36394728806,27,20,1,1
"912345714",45,2752.98284065496,2579.33597919865,27,18,1,1
"912345715",40,2779.65971859119,2517.98110851286,21,19,1,1
"912345716",33,2660.3713897486,2420.89448855093,20,13,1,1
"912345717",39,2909.69130352066,2504.98447234734,21,18,1,1
"912345718",60,3780.48811076285,2735.5526890818,35,25,1,1
"912345719",52,3268.39114468894,2656.6981055205,27,25,1,1
"912345720",81,3854.99297570161,2908.60658576875,45,36,1,1
"912345721",68,3727.47647888899,2806.43931339586,41,27,1,1
"912345722",61,3494.2351818465,2744.81051624266,34,27,1,1
"912345723",62,3808.31743233395,2753.94837323248,33,29,1,1
"912345724",61,3288.83263806335,2744.81051624266,37,24,1,1
"912345725",53,3500.14950934527,2667.061866114,28,25,1,1
"912345726",72,4069.88129069678,2839.4193288992,41,31,1,1
"912345727",61,3814.1583389701,2744.81051624266,38,23,1,1
"912345728",61,4047.02998081058,2744.81051624266,32,29,1,1
"912345729",73,4425.05586430382,2847.4358582506,42,31,1,1
"912345730",63,3685.102513995,2762.96971264875,34,29,1,1
"912345731",58,3459.12797106191,2716.66249357165,33,25,1,1
"912345732",60,3605.05969943894,2735.5526890818,35,25,1,1
"912345733",65,3746.43514697723,2780.67589681985,38,27,1,1
"912345734",36,2750.44155840486,2464.33502634194,16,20,1,1
"912345735",41,2764.52891083157,2530.72175773865,20,21,1,1
"912345736",33,2586.5285809086,2420.89448855093,13,20,1,1
"912345737",55,2825.74821044121,2687.33120998132,23,32,1,1
"912345738",33,2568.94909211079,2420.89448855093,14,19,1,1
"912345739",33,2782.8576212713,2420.89448855093,16,17,1,1
"912345740",46,2680.50670314992,2590.94954296761,19,27,1,1
"912345741",33,2560.470807036,2420.89448855093,19,14,1,1
"912345742",36,2412.56278512768,2464.33502634194,19,17,1,1
"912345743",51,2560.98661292857,2646.17454577679,25,26,1,1
"912345744",40,2409.74243412537,2517.98110851286,20,20,1,1
"912345745",46,2856.38993260897,2590.94954296761,24,22,1,1
"912345746",47,2650.41894376528,2602.36394728806,25,22,1,1
"912345747",53,2697.37403168685,2667.061866114,27,26,1,1
"912345748",41,2696.37825548763,2530.72175773865,19,22,1,1
"912345749",32,2539.14660662335,2405.71569249515,17,15,1,1
"912345750",45,2918.08893470189,2579.33597919865,25,20,1,1
"912345751",41,2670.87312717603,2530.72175773865,17,24,1,1
"912345752",28,2366.79761056538,2340.94327947849,14,14,1,1
"912345753",38,2327.9416433756,2491.71993967651,17,21,1,1
"912345754",22,2206.02328139277,2228.3491786518,9,13,1,1
"912345755",24,2171.46581604187,2268.33468283819,8,16,1,1
"912345756",19,2023.01330957221,2162.56636020013,7,12,1,1
"912345757",17,2131.98554053479,2113.95669457394,10,7,1,1
"912345758",12,1991.65773772245,1968.69006049611,6,6,1,1
"912345759",14,1972.0962539608,2031.70713799962,5,9,1,1
"912345760",17,2227.89626381953,2113.95669457394,8,9,1,1
"912345761",18,2060.33885625484,2138.79896507223,6,12,1,1
"912345762",14,2096.8825514371,2031.70713799962,4,10,1,1
"912345763",7,1735.650956686,1763.32076508842,4,3,1,1
"912345764",17,2226.61627523163,2113.95669457394,7,10,1,1
"912345765",19,2304.73782044171,2162.56636020013,8,11,1,1
"912345766",32,2415.26251235553,2405.71569249515,18,14,1,1
"912345767",20,2186.89549549215,2185.35845629437,11,9,1,1
"912345768",30,2344.71108230162,2374.18906024059,18,12,1,1
"912345769",24,2176.58856956408,2268.33468283819,14,10,1,1
"912345770",30,2405.45372428183,2374.18906024059,15,15,1,1
"912345771",23,2442.91350629953,2248.68783741607,12,11,1,1
"912345772",16,2082.51888202822,2087.92318348224,7,9,1,1
"912345773",23,2228.73656563523,2248.68783741607,13,10,1,1
"912345774",28,2432.70693800082,2340.94327947849,11,17,1,1
"912345775",30,2411.24132538529,2374.18906024059,10,20,1,1
"912345776",31,2177.38256272726,2390.15469389133,10,21,1,1
"912345777",27,2253.03908915039,2323.60649590586,10,17,1,1
"912345778",17,2137.88784362115,2113.95669457394,6,11,1,1
"912345779",19,2169.30029533231,2162.56636020013,7,12,1,1
"912345780",13,2017.5033722261,2001.16379457045,6,7,1,1
"912345781",16,2091.56689033462,2087.92318348224,9,7,1,1
"912345782",19,2169.24453065983,2162.56636020013,8,11,1,1
"912345783",21,2184.95085689796,2207.26116887512,10,11,1,1
"912345784",31,2388.03640070774,2390.15469389133,16,15,1,1
"912345785",20,2122.98329682,2185.35845629437,12,8,1,1
"912345786",30,2240.81535184671,2374.18906024059,18,12,1,1
"912345787",20,2206.86147370061,2185.35845629437,11,9,1,1
"912345788",18,2241.74927594791,2138.79896507223,9,9,1,1
"912345789",36,2650.12712638741,2464.33502634194,17,19,1,1
"912345790",41,2473.22920728613,2530.72175773865,19,22,1,1
"912345791",30,2248.12130145061,2374.18906024059,14,16,1,1
"912345792",33,2437.01011556527,2420.89448855093,14,19,1,1
"912345793",38,2666.97638044189,2491.71993967651,19,19,1,1
"912345794",28,2454.01036897007,2340.94327947849,13,15,1,1
"912345795",34,2576.72072182557,2435.71163614839,17,17,1,1
"912345796",25,2294.69905618406,2287.34065519221,14,11,1,1
"912345797",29,2212.11164316933,2357.79423966008,13,16,1,1
"912345798",25,2274.40577526954,2287.34065519221,10,15,1,1
"912345799",32,2332.76492209939,2405.71569249515,15,17,1,1
"912345800",36,2239.8459100213,2464.33502634194,15,21,1,1
"912345801",35,2483.95365304562,2450.1860183293,16,19,1,1
"912345802",35,2475.18658107217,2450.1860183293,16,19,1,1
"912345803",30,2565.61310271897,2374.18906024059,17,13,1,1
"912345804",34,2715.13454427431,2435.71163614839,20,14,1,1
"912345805",34,2349.2899390578,2435.71163614839,20,14,1,1
"912345806",35,2476.81168045417,2450.1860183293,20,15,1,1
"912345807",29,2230.48962218508,2357.79423966008,16,13,1,1
"912345808",18,2141.1010174411,2138.79896507223,12,6,1,1
"912345809",28,2472.5045124787,2340.94327947849,16,12,1,1
"912345810",27,2362.29953600804,2323.60649590586,14,13,1,1
"912345811",33,2047.04589564196,2420.89448855093,14,19,1,1
"912345812",39,2075.79561026874,2504.98447234734,14,25,1,1
"912345813",33,2344.35161559297,2420.89448855093,13,20,1,1
"912345814",22,2020.99028768437,2228.3491786518,9,13,1,1
"912345815",29,2411.53147406414,2357.79423966008,15,14,1,1
"912345816",26,2337.77770145076,2305.75108410937,11,15,1,1
"912345817",38,2356.25435400082,2491.71993967651,17,21,1,1
"912345818",39,2446.25043304683,2504.98447234734,21,18,1,1
"912345819",41,2208.63806123105,2530.72175773865,20,21,1,1
"912345820",36,2454.37219570987,2464.33502634194,18,18,1,1
"912345821",37,2309.4180895449,2478.17471526668,17,20,1,1
"912345823",33,2251.48114949991,2420.89448855093,8,25,1,1
"912345824",29,2138.44284141645,2357.79423966008,8,21,1,1
"912345826",12,2024.22951481955,1968.69006049611,7,5,1,1
"912345827",14,2211.80944911731,2031.70713799962,6,8,1,1
"912345828",28,2286.52091645301,2340.94327947849,14,14,1,1
"912345829",11,1930.43025574607,1933.98659929558,2,9,1,1
"912345830",24,2348.16601794211,2268.33468283819,9,15,1,1
"912345831",18,2234.94309098762,2138.79896507223,6,12,1,1
"912345832",22,2351.10795972692,2228.3491786518,8,14,1,1
"912345833",25,2214.68469653159,2287.34065519221,12,13,1,1
"912345834",30,2124.88682837204,2374.18906024059,14,16,1,1
"912345835",18,1912.03740821094,2138.79896507223,9,9,1,1
"912345836",29,2318.42422854917,2357.79423966008,15,14,1,1
"912345837",37,2730.84878387376,2478.17471526668,18,19,1,1
"912345838",31,2690.69251434181,2390.15469389133,15,16,1,1
"912345839",31,2399.48160930776,2390.15469389133,16,15,1,1
"912345840",28,2214.73848929597,2340.94327947849,15,13,1,1
"912345841",32,2246.41788399764,2405.71569249515,19,13,1,1
"912345842",38,2506.67974477636,2491.71993967651,14,24,1,1
"912345843",49,2806.53820206172,2624.62502504328,26,23,1,1
"912345844",60,2538.71556839104,2735.5526890818,30,30,1,1
"912345846",50,2902.58638987876,2635.48551585152,26,24,1,1
"912345847",41,2688.90249299743,2530.72175773865,23,18,1,1
"912345848",24,2200.27524302951,2268.33468283819,10,14,1,1
"912345849",78,3421.8648014929,2886.25582696583,43,35,1,1
"912345850",64,3401.05692614133,2771.87783482774,35,29,1,1
"912345851",57,2980.87897814221,2707.02236739438,29,28,1,1
"912345852",75,2634.87172021182,2863.21031780169,39,36,1,1
"912345853",74,2587.5872778682,2855.36548874306,31,43,1,1
"912345854",69,2928.00083671468,2814.82611826518,35,34,1,1
"912345855",91,2860.686374705,2978.64386243803,48,43,1,1
"912345856",74,3036.0285352633,2855.36548874306,33,41,1,1
"912345857",59,3116.15448377385,2726.17127719361,28,31,1,1
"912345858",78,3356.56414967396,2886.25582696583,45,33,1,1
"912345859",87,3617.72993293908,2951.40156710974,53,34,1,1
"912345860",95,3529.09796376602,3004.94950458202,46,49,1,1
"912345861",68,3412.35480525786,2806.43931339586,33,35,1,1
"912345862",62,4123.91596156203,2753.94837323248,28,34,1,1
"912345863",67,3382.9193989894,2797.95380131742,38,29,1,1
"912345864",51,3232.20029115948,2646.17454577679,26,25,1,1
"912345865",101,4487.74688221492,3042.80202352452,53,48,1,1
"912345866",64,3666.84720965171,2771.87783482774,34,30,1,1
"912345867",58,3628.45109424432,2716.66249357165,33,25,1,1
"912345868",70,3169.25882574685,2823.11677003184,35,35,1,1
"912345869",64,3175.07343384047,2771.87783482774,30,34,1,1
"912345872",54,3122.61939431169,2677.2712016452,30,24,1,1
"912345873",52,3364.36654454703,2656.6981055205,23,29,1,1
"912345874",88,3630.6954835945,2958.30409156145,43,45,1,1
"912345875",79,3596.00380616303,2893.78092561085,38,41,1,1
"912345877",64,3641.24480515971,2771.87783482774,29,35,1,1
"912345878",61,3367.54928668118,2744.81051624266,32,29,1,1
"912345879",66,3533.18860983213,2789.3669207067,35,31,1,1
"912345880",37,2803.3152104415,2478.17471526668,25,12,1,1
"912345881",55,3328.87733601953,2687.33120998132,30,25,1,1
"912345882",45,2988.419935382,2579.33597919865,22,23,1,1
"912345883",85,3876.48417259831,2937.40494579778,44,41,1,1
"912345884",45,3078.44275096758,2579.33597919865,23,22,1,1
"912345885",46,3210.71706830383,2590.94954296761,27,19,1,1
"912345886",98,3540.18889050268,3024.10627920296,48,50,1,1
"912345887",74,4158.38893381428,2855.36548874306,35,39,1,1
"912345888",48,3284.89652642371,2613.58673801098,25,23,1,1
"912345889",77,3441.71669652147,2878.65357631343,38,39,1,1
"912345890",73,3307.25978924561,2847.4358582506,37,36,1,1
"912345891",87,3615.30120372461,2951.40156710974,45,42,1,1
"912345892",43,2808.2022922922,2555.47878346624,22,21,1,1
"912345893",62,2862.60102390425,2753.94837323248,35,27,1,1
"912345894",49,3077.13026128097,2624.62502504328,32,17,1,1
"912345896",40,2484.28243407528,2517.98110851286,23,17,1,1
"912345897",61,3350.48843066609,2744.81051624266,32,29,1,1
"912345898",66,2887.33398027829,2789.3669207067,32,34,1,1
"912345899",55,2940.85548437995,2687.33120998132,26,29,1,1
"912345900",62,3241.93017142649,2753.94837323248,34,28,1,1
"912345901",76,3465.58614498372,2870.97236507783,44,32,1,1
"912345902",61,3234.84221182566,2744.81051624266,35,26,1,1
"912345904",72,3079.1305171131,2839.4193288992,34,38,1,1
"912345905",78,3726.70807139186,2886.25582696583,39,39,1,1
"912345906",56,2970.97008073734,2697.24673169728,32,24,1,1
"912345907",70,3282.00591049408,2823.11677003184,36,34,1,1
"912345908",48,2678.90620434197,2613.58673801098,29,19,1,1
"912345909",53,2720.44535643745,2667.061866114,30,23,1,1
"912345910",42,2678.03819107405,2543.21752514954,25,17,1,1
"912345911",46,2654.58070225417,2590.94954296761,27,19,1,1
"912345912",14,1991.28361489428,2031.70713799962,6,8,1,1
"912345913",16,2140.03693380771,2087.92318348224,8,8,1,1
"912345914",32,2740.42353376715,2405.71569249515,17,15,1,1
"912345915",26,2567.92097148595,2305.75108410937,14,12,1,1
"912345916",33,2688.48282617502,2420.89448855093,17,16,1,1
"912345917",34,2869.2981343754,2435.71163614839,16,18,1,1
"912345918",34,2803.4928899497,2435.71163614839,18,16,1,1
"912345919",39,2736.72342950834,2504.98447234734,19,20,1,1
"912345957",62,3265.16952246791,2753.94837323248,33,29,1,1
"912345958",105,3879.26567735382,3067.05425459434,55,50,1,1
"912345962",48,2862.48970321122,2613.58673801098,23,25,1,1
"912345963",56,3146.78192643364,2697.24673169728,26,30,1,1
"912345964",44,2577.66358129935,2567.51523707907,27,17,1,1
"912345965",33,2609.5003078946,2420.89448855093,19,14,1,1
"912345966",50,3054.47681556274,2635.48551585152,22,28,1,1
"912345967",42,3109.2544101795,2543.21752514954,18,24,1,1
"912345968",26,2523.05152562926,2305.75108410937,10,16,1,1
"912345969",42,2757.65049488194,2543.21752514954,23,19,1,1
"912345970",42,3059.39288703839,2543.21752514954,16,26,1,1
"912345971",47,3592.26190862683,2602.36394728806,18,29,1,1
"912345972",56,3549.0754354766,2697.24673169728,24,32,1,1
"912345974",91,4073.25884519282,2978.64386243803,40,51,1,1
"912345976",74,4304.39488927677,2855.36548874306,34,40,1,1
"912345977",71,3765.82153058176,2831.31372136695,37,34,1,1
"912345978",63,3227.48839108968,2762.96971264875,32,31,1,1
"912345979",29,2357.27598465702,2357.79423966008,17,12,1,1
"912345981",56,3185.31454429895,2697.24673169728,28,28,1,1
"912345982",22,2486.88979569431,2228.3491786518,11,11,1,1
"912345984",65,3551.11960070499,2780.67589681985,28,37,1,1
"912345985",66,3347.26456143854,2789.3669207067,35,31,1,1
"912345986",66,3193.01493632396,2789.3669207067,34,32,1,1
"912345987",81,3335.32159144322,2908.60658576875,42,39,1,1
"912345988",51,3252.14463374494,2646.17454577679,25,26,1,1
"912345989",41,2662.84442433751,2530.72175773865,22,19,1,1
"912345991",75,2859.38465611068,2863.21031780169,34,41,1,1
"912345992",77,3461.15166554494,2878.65357631343,40,37,1,1
"912345993",83,3434.42327722287,2923.1438046077,35,48,1,1
"912345994",52,2936.97059929068,2656.6981055205,30,22,1,1
"912345995",59,3129.88584410511,2726.17127719361,33,26,1,1
"912345996",28,2279.30873060209,2340.94327947849,17,11,1,1
"912345998",21,2319.75464558339,2207.26116887512,12,9,1,1
"912345999",19,2144.51994447507,2162.56636020013,10,9,1,1
"912346000",66,3201.86227744683,2789.3669207067,31,35,1,1
"912346001",42,2704.75461181453,2543.21752514954,27,15,1,1
"912346002",44,2655.35139018656,2567.51523707907,24,20,1,1
"912346003",64,2969.74502822994,2771.87783482774,26,38,1,1
"912346004",54,2832.92927152942,2677.2712016452,28,26,1,1
"912346005",51,2806.83293235044,2646.17454577679,27,24,1,1
"912346007",62,3682.34647205179,2753.94837323248,31,31,1,1
"912346008",59,3313.13942571751,2726.17127719361,27,32,1,1
"912346009",41,2575.16974872673,2530.72175773865,15,26,1,1
"912346010",39,2805.74769181016,2504.98447234734,17,22,1,1
"912346011",48,3160.13431617786,2613.58673801098,20,28,1,1
"912346012",58,3655.47678604048,2716.66249357165,28,30,1,1
"912346013",70,3935.26209890632,2823.11677003184,33,37,1,1
"912346014",75,3661.45290678999,2863.21031780169,34,41,1,1
"912346015",87,3476.13521092306,2951.40156710974,43,44,1,1
"912346016",65,3456.26140346081,2780.67589681985,29,36,1,1
"912346017",59,3428.41416749703,2726.17127719361,34,25,1,1
"912346018",66,3329.43655203293,2789.3669207067,28,38,1,1
"912346019",90,3399.24071007285,2971.92401064611,44,46,1,1
"912346020",28,2235.55294690241,2340.94327947849,12,16,1,1
"912346023",84,3071.37083418786,2930.30814451558,41,43,1,1
"912346024",70,3189.02598684518,2823.11677003184,36,34,1,1
"912346025",86,3415.07729860394,2944.43562859908,40,46,1,1
"912346026",31,2591.24339213594,2390.15469389133,20,11,1,1
"912346027",58,3566.24404401718,2716.66249357165,28,30,1,1
"912346028",26,2351.16028976013,2305.75108410937,14,12,1,1
"912346029",39,2410.2956693171,2504.98447234734,18,21,1,1
"912346030",23,2283.27134973234,2248.68783741607,13,10,1,1
"912346031",17,2051.75622415702,2113.95669457394,7,10,1,1
"912346032",68,3784.33658068001,2806.43931339586,33,35,1,1
"912346033",67,3460.53241834094,2797.95380131742,34,33,1,1
"912346034",80,3742.27432777573,2901.2306171403,36,44,1,1
"912346035",46,3006.08647108945,2590.94954296761,22,24,1,1
"912346036",35,2592.3163846257,2450.1860183293,16,19,1,1
"912346037",72,3430.29848734695,2839.4193288992,35,37,1,1
"912346038",43,2797.21336200913,2555.47878346624,16,27,1,1
"912346039",59,3659.09668526884,2726.17127719361,30,29,1,1
"912346040",51,3526.24568478194,2646.17454577679,24,27,1,1
"912346041",52,3083.86332483482,2656.6981055205,29,23,1,1
"912346042",44,3069.13872944897,2567.51523707907,24,20,1,1
"912346043",32,2551.07055999144,2405.71569249515,17,15,1,1
"912346044",57,3498.9924181387,2707.02236739438,25,32,1,1
"912346045",51,2940.46300156188,2646.17454577679,22,29,1,1
"912346046",34,2359.31164528013,2435.71163614839,15,19,1,1
"912346048",62,3028.0775316563,2753.94837323248,32,30,1,1
"912346112",32,2189.81119395761,2405.71569249515,10,22,1,1
"912346113",45,2208.11487794564,2579.33597919865,18,27,1,1
"912346315",28,2314.7741217727,2340.94327947849,18,10,1,1
"912346316",29,2505.84333150005,2357.79423966008,19,10,1,1
"912346317",45,2724.09415933326,2579.33597919865,27,18,1,1
"912346318",41,2709.32915880561,2530.72175773865,19,22,1,1
"912346319",52,3198.04431482023,2656.6981055205,36,16,1,1
"912346320",59,2880.03214694841,2726.17127719361,37,22,1,1
"912346321",39,2626.91745968925,2504.98447234734,21,18,1,1
"912346322",47,2990.12314216574,2602.36394728806,22,25,1,1
"912346323",26,2451.51468601922,2305.75108410937,12,14,1,1
"912346324",26,2667.53805659908,2305.75108410937,15,11,1,1
"912346325",38,2705.88238757159,2491.71993967651,21,17,1,1
"912346326",40,2769.21191817655,2517.98110851286,21,19,1,1
"912346327",60,3222.3649640305,2735.5526890818,35,25,1,1
"912346328",44,2837.5569892807,2567.51523707907,25,19,1,1
"912346329",45,2879.78766770696,2579.33597919865,19,26,1,1
"912346330",54,3400.49212567998,2677.2712016452,19,35,1,1
"912346331",33,2914.22483731871,2420.89448855093,17,16,1,1
"912346332",36,3118.20924917535,2464.33502634194,21,15,1,1
"912346333",34,2477.84218742366,2435.71163614839,18,16,1,1
"912346334",52,3109.84663178248,2656.6981055205,29,23,1,1
"912346335",50,3106.51318909075,2635.48551585152,22,28,1,1
"912346336",46,2897.52635587742,2590.94954296761,28,18,1,1
"912346337",35,2621.34421648076,2450.1860183293,18,17,1,1
"912346338",30,2532.75316446171,2374.18906024059,16,14,1,1
"912346339",33,2591.47653774513,2420.89448855093,13,20,1,1
"912346340",39,2813.25985180271,2504.98447234734,23,16,1,1
"912346341",28,2503.18621612957,2340.94327947849,15,13,1,1
"912346342",42,2949.34742545107,2543.21752514954,22,20,1,1
"912346343",45,2847.63689893672,2579.33597919865,24,21,1,1
"912346344",41,2605.97749329169,2530.72175773865,24,17,1,1
"912346345",41,2740.54866908868,2530.72175773865,25,16,1,1
"912346346",37,2645.62745072879,2478.17471526668,20,17,1,1
"912346347",47,2833.34122938985,2602.36394728806,28,19,1,1
"912346348",41,2508.51013067669,2530.72175773865,23,18,1,1
"912346349",46,2861.12612001545,2590.94954296761,26,20,1,1
"912346350",60,2947.73634879117,2735.5526890818,36,24,1,1
"912346355",51,2699.32577727999,2646.17454577679,30,21,1,1
"912346356",45,2862.77180632959,2579.33597919865,27,18,1,1
"912346360",24,2306.18337953397,2268.33468283819,14,10,1,1
"912346361",24,2367.14602269146,2268.33468283819,13,11,1,1
"912346362",23,2307.47727913333,2248.68783741607,11,12,1,1
"912346366",25,2566.48359810197,2287.34065519221,15,10,1,1
"912346367",40,2651.80660381123,2517.98110851286,19,21,1,1
"912346368",39,2846.07081887204,2504.98447234734,21,18,1,1
"912346369",34,2569.34745352812,2435.71163614839,21,13,1,1
"912346370",37,2978.5522616679,2478.17471526668,21,16,1,1
"912346371",47,2606.54314219722,2602.36394728806,22,25,1,1
"912346372",25,2606.11617756051,2287.34065519221,15,10,1,1
"912346373",45,2781.73829212979,2579.33597919865,26,19,1,1
"912346527",55,3043.12320887647,2687.33120998132,23,32,1,1
"912346528",52,2995.52246724746,2656.6981055205,24,28,1,1
"912346542",37,2629.6856093344,2478.17471526668,16,21,1,1
"912346551",47,2969.4968402372,2602.36394728806,21,26,1,1
"912346641",45,2819.07957143817,2579.33597919865,28,17,1,1
"912346642",37,2611.56821530804,2478.17471526668,24,13,1,1
"912346643",40,3249.57542262955,2517.98110851286,22,18,1,1
"912346644",39,2782.6236758716,2504.98447234734,23,16,1,1
"912346645",54,3683.43281301053,2677.2712016452,27,27,1,1
"912346646",48,3305.67410198077,2613.58673801098,28,20,1,1
"912346647",28,2285.68769362822,2340.94327947849,17,11,1,1
"912346648",37,2801.0767532602,2478.17471526668,19,18,1,1
"912346649",35,2898.86165426179,2450.1860183293,17,18,1,1
"912346650",29,2583.12558919178,2357.79423966008,19,10,1,1
"912346651",41,2903.38019403872,2530.72175773865,20,21,1,1
"912346652",40,2864.40308880643,2517.98110851286,19,21,1,1
"912346653",36,2881.70558353573,2464.33502634194,20,16,1,1
"912346654",34,2830.30027416142,2435.71163614839,17,17,1,1
"912346655",33,2987.2993072643,2420.89448855093,16,17,1,1
"912346656",42,3015.8714961161,2543.21752514954,19,23,1,1
"912346657",33,2688.66125602783,2420.89448855093,17,16,1,1
"912346658",35,2934.06118920289,2450.1860183293,22,13,1,1
"912346659",40,3029.35226680014,2517.98110851286,20,20,1,1
"912346660",36,3064.46376904125,2464.33502634194,17,19,1,1
"912346661",23,2540.4560773444,2248.68783741607,10,13,1,1
"912346662",44,2655.86124910815,2567.51523707907,20,24,1,1
"912346663",36,2895.38316778317,2464.33502634194,20,16,1,1
"912346664",33,2869.65272403951,2420.89448855093,16,17,1,1
"912346665",24,2462.51368095222,2268.33468283819,12,12,1,1
"912346666",20,2163.55049264806,2185.35845629437,11,9,1,1
"912346667",32,2594.35119240653,2405.71569249515,18,14,1,1
"912346668",25,2519.55996447987,2287.34065519221,12,13,1,1
"912346669",70,3168.37649055302,2823.11677003184,34,36,1,1
"912346670",56,3130.16619643945,2697.24673169728,33,23,1,1
"912346671",54,3135.84715763797,2677.2712016452,27,27,1,1
"912346672",44,2603.30693808463,2567.51523707907,24,20,1,1
"912346673",40,2592.16132914135,2517.98110851286,22,18,1,1
"912346674",44,3189.11406294567,2567.51523707907,24,20,1,1
"912346675",28,2500.67535612921,2340.94327947849,17,11,1,1
"912346676",42,2947.43997704241,2543.21752514954,24,18,1,1
"912346677",46,3150.43081929331,2590.94954296761,23,23,1,1
"912346678",37,2405.83483448209,2478.17471526668,15,22,1,1
"912346679",39,3181.73232375357,2504.98447234734,20,19,1,1
"912346680",34,2669.87933435913,2435.71163614839,13,21,1,1
"912346681",49,3312.32753456645,2624.62502504328,29,20,1,1
"912346682",33,2449.55462992463,2420.89448855093,19,14,1,1
"912346683",31,2370.94103561153,2390.15469389133,15,16,1,1
"912346684",36,3037.20040878759,2464.33502634194,18,18,1,1
"912346685",30,2219.27072306339,2374.18906024059,13,17,1,1
"912346686",53,3567.39077308896,2667.061866114,32,21,1,1
"912346687",41,2943.29893881311,2530.72175773865,24,17,1,1
"912346688",50,3241.05887285886,2635.48551585152,23,27,1,1
"912346689",53,3609.78160311353,2667.061866114,29,24,1,1
"912346690",42,2704.29616030053,2543.21752514954,19,23,1,1
"912346691",51,3174.98089165677,2646.17454577679,26,25,1,1
"912346692",37,2464.38004184886,2478.17471526668,19,18,1,1
"912346693",30,2637.95681629763,2374.18906024059,17,13,1,1
"912346694",31,2683.96596029147,2390.15469389133,13,18,1,1
"912346695",30,2605.08248007326,2374.18906024059,16,14,1,1
"912346696",36,2793.59991477103,2464.33502634194,19,17,1,1
"912346697",26,2531.34652200113,2305.75108410937,13,13,1,1
"912346698",42,3253.70676774851,2543.21752514954,20,22,1,1
"912346699",32,2952.45038923564,2405.71569249515,16,16,1,1
"912346700",22,2273.49618858331,2228.3491786518,9,13,1,1
"912346701",45,2670.61991984332,2579.33597919865,21,24,1,1
"912346702",38,2596.14784758235,2491.71993967651,18,20,1,1
"912346703",32,2651.10990455063,2405.71569249515,21,11,1,1
"912346704",31,2775.10873731422,2390.15469389133,18,13,1,1
"912346705",25,2373.09506301073,2287.34065519221,13,12,1,1
"912346706",23,2188.211071647,2248.68783741607,9,14,1,1
"912346707",11,1930.43704777077,1933.98659929558,2,9,1,1
"912346708",31,2745.00314922716,2390.15469389133,16,15,1,1
"912346709",34,2778.45852213385,2435.71163614839,23,11,1,1
"912346710",26,2512.04455011603,2305.75108410937,14,12,1,1
"912346711",48,3042.16794260461,2613.58673801098,24,24,1,1
"912346712",30,2563.03965445533,2374.18906024059,16,14,1,1
"912346713",36,2556.41874574666,2464.33502634194,19,17,1,1
"912346714",33,2636.6277736174,2420.89448855093,19,14,1,1
"912346715",27,2460.51206350124,2323.60649590586,13,14,1,1
"912346716",25,2264.13607749065,2287.34065519221,12,13,1,1
"912346719",36,2660.176160674,2464.33502634194,17,19,1,1
"912346720",29,2708.91833998449,2357.79423966008,16,13,1,1
"912346721",25,2492.63398465306,2287.34065519221,14,11,1,1
"912346722",30,2459.01433085042,2374.18906024059,14,16,1,1
"912346723",22,2310.24805815691,2228.3491786518,12,10,1,1
"912346724",33,2622.37104726551,2420.89448855093,18,15,1,1
"912346725",30,2516.49019028456,2374.18906024059,15,15,1,1
"912346726",32,2554.81817867533,2405.71569249515,17,15,1,1
"912346727",28,2338.71170871019,2340.94327947849,17,11,1,1
"912346728",28,2459.08373794484,2340.94327947849,18,10,1,1
"912346729",25,2409.58412200069,2287.34065519221,14,11,1,1
"912346730",32,2807.4848582164,2405.71569249515,14,18,1,1
"912346731",26,2513.75561762498,2305.75108410937,13,13,1,1
"912346732",34,2656.94059783984,2435.71163614839,18,16,1,1
"912346733",35,2459.3972103595,2450.1860183293,19,16,1,1
"912346734",30,2562.22851189255,2374.18906024059,17,13,1,1
"912346735",27,2587.86455476075,2323.60649590586,12,15,1,1
"912346736",39,2623.32885505015,2504.98447234734,22,17,1,1
"912346737",30,2553.01135289842,2374.18906024059,15,15,1,1
"912346738",28,2432.03182652857,2340.94327947849,15,13,1,1
"912346739",36,2452.82487005605,2464.33502634194,17,19,1,1
"912346740",29,2472.5850102889,2357.79423966008,15,14,1,1
"912346741",27,2350.58558861477,2323.60649590586,15,12,1,1
"912346742",28,2519.96738743378,2340.94327947849,13,15,1,1
"912346743",34,2591.62011083915,2435.71163614839,17,17,1,1
"912346744",24,2510.1005807948,2268.33468283819,12,12,1,1
"912346745",24,2420.29277657872,2268.33468283819,14,10,1,1
"912346746",27,2316.30791152073,2323.60649590586,14,13,1,1
"912346747",36,2533.69849570598,2464.33502634194,15,21,1,1
"912346748",36,2521.05970870779,2464.33502634194,18,18,1,1
"912346749",26,2509.42582068106,2305.75108410937,14,12,1,1
"912346759",43,3004.10147562104,2555.47878346624,24,19,1,1
"912346761",39,2479.27543192537,2504.98447234734,21,18,1,1
"912346762",33,2557.29835395665,2420.89448855093,17,16,1,1
"912346763",46,3015.50648057137,2590.94954296761,27,19,1,1
"912346764",57,3222.54254025568,2707.02236739438,35,22,1,1
"912346765",39,2853.00044905279,2504.98447234734,27,12,1,1
"912346767",57,3119.47024705136,2707.02236739438,30,27,1,1
"912346768",60,3228.19547198792,2735.5526890818,24,36,1,1
"912346769",59,3186.03540269728,2726.17127719361,31,28,1,1
"912346770",51,2983.12943172074,2646.17454577679,26,25,1,1
"912346771",59,3122.00091262822,2726.17127719361,29,30,1,1
"912346772",54,2891.04137615829,2677.2712016452,22,32,1,1
"912346773",49,2835.88151349404,2624.62502504328,22,27,1,1
"912346774",60,3055.01859875157,2735.5526890818,26,34,1,1
"912346775",44,3002.17542503627,2567.51523707907,27,17,1,1
"912346776",60,3255.11446540916,2735.5526890818,34,26,1,1
"912346777",32,2613.9508684457,2405.71569249515,13,19,1,1
"912346778",28,2493.71339089265,2340.94327947849,15,13,1,1
"912346780",60,3250.79024610012,2735.5526890818,27,33,1,1
"912346781",68,3297.85341529333,2806.43931339586,32,36,1,1
"912346782",51,2850.84854610859,2646.17454577679,22,29,1,1
"912346783",53,2950.63873380147,2667.061866114,28,25,1,1
"912346785",43,3000.33806915832,2555.47878346624,24,19,1,1
"912346786",44,2651.92608103931,2567.51523707907,23,21,1,1
"912346787",36,2823.04465796418,2464.33502634194,21,15,1,1
"912346788",43,2846.98798304221,2555.47878346624,23,20,1,1
"912346789",49,3020.66941905599,2624.62502504328,25,24,1,1
"912346790",41,2746.09535880956,2530.72175773865,19,22,1,1
"912346791",31,2660.23406690032,2390.15469389133,19,12,1,1
"912346792",46,2755.70489697014,2590.94954296761,25,21,1,1
"912346793",41,2774.77627224647,2530.72175773865,22,19,1,1
"912346794",43,3047.5097510157,2555.47878346624,21,22,1,1
"912346795",37,3018.91608318381,2478.17471526668,18,19,1,1
"912346796",52,2921.69070564308,2656.6981055205,32,20,1,1
"912346799",60,3383.20812039379,2735.5526890818,32,28,1,1
"912346800",58,3652.5997006654,2716.66249357165,26,32,1,1
"912346801",57,3124.62681781063,2707.02236739438,33,24,1,1
"912346802",55,3630.58378440348,2687.33120998132,33,22,1,1
"912346803",38,2961.21292445587,2491.71993967651,19,19,1,1
"912346804",50,2823.700470652,2635.48551585152,26,24,1,1
"912346805",66,3217.33648849653,2789.3669207067,30,36,1,1
"912346806",69,3374.41405754356,2814.82611826518,41,28,1,1
"912346807",73,3463.51194437038,2847.4358582506,46,27,1,1
"912346808",61,3184.8795945046,2744.81051624266,37,24,1,1
"912346809",101,3505.89926473412,3042.80202352452,52,49,1,1
"912346810",51,3040.46289559447,2646.17454577679,27,24,1,1
"912346811",43,2717.32227818957,2555.47878346624,26,17,1,1
"912346812",41,2852.16591828829,2530.72175773865,25,16,1,1
"912346813",33,2823.48679444689,2420.89448855093,19,14,1,1
"912346814",43,3251.36149453137,2555.47878346624,23,20,1,1
"912346815",46,3274.01898872568,2590.94954296761,27,19,1,1
"912346817",77,3790.37217510346,2878.65357631343,46,31,1,1
"912346818",59,3551.9176663801,2726.17127719361,31,28,1,1
"912346819",65,3544.80153964726,2780.67589681985,36,29,1,1
"912346820",48,3215.51077689225,2613.58673801098,29,19,1,1
"912346821",59,3342.78066203813,2726.17127719361,32,27,1,1
"912346822",58,3554.16870462112,2716.66249357165,32,26,1,1
"912346823",63,3113.69477508438,2762.96971264875,33,30,1,1
"912346824",49,3275.626695058,2624.62502504328,23,26,1,1
"912346825",58,3406.79291354732,2716.66249357165,24,34,1,1
"912346826",48,3130.69426190438,2613.58673801098,29,19,1,1
"912346827",44,2891.60786040051,2567.51523707907,25,19,1,1
"912346828",58,3158.64645576005,2716.66249357165,33,25,1,1
"912346829",45,2869.10218518404,2579.33597919865,23,22,1,1
"912346830",64,3802.00058175221,2771.87783482774,36,28,1,1
"912346831",62,3616.66977594731,2753.94837323248,36,26,1,1
"912346832",46,3040.23621222555,2590.94954296761,24,22,1,1
"912346833",49,3149.91359692621,2624.62502504328,26,23,1,1
"912346834",61,3341.58305751665,2744.81051624266,31,30,1,1
"912346835",58,3620.69174791369,2716.66249357165,29,29,1,1
"912346836",80,3685.23188365045,2901.2306171403,41,39,1,1
"912346837",55,2857.52972310103,2687.33120998132,27,28,1,1
"912346838",79,4335.14092732949,2893.78092561085,44,35,1,1
"912346839",70,3850.03553246767,2823.11677003184,41,29,1,1
"912346840",57,3357.7708038796,2707.02236739438,30,27,1,1
"912346841",55,3766.86591501997,2687.33120998132,31,24,1,1
"912346842",86,2988.37928942096,2944.43562859908,46,40,1,1
"912346844",15,1928.23131906004,2060.56118614118,9,6,1,1
"912346845",46,2778.0476636814,2590.94954296761,24,22,1,1
"912346846",71,3436.67283486977,2831.31372136695,38,33,1,1
"912346847",72,3314.35720533536,2839.4193288992,32,40,1,1
"912346848",62,2880.12111301376,2753.94837323248,32,30,1,1
"912346849",77,3751.36801798027,2878.65357631343,37,40,1,1
"912346850",60,3175.6201368167,2735.5526890818,32,28,1,1
"912346851",83,2989.50146672412,2923.1438046077,40,43,1,1
"912346852",62,3983.19808365838,2753.94837323248,35,27,1,1
"912346853",66,3858.99749030038,2789.3669207067,35,31,1,1
"912346854",58,3886.80471586445,2716.66249357165,30,28,1,1
"912346855",58,3471.88515116394,2716.66249357165,28,30,1,1
"912346857",77,4281.41878577828,2878.65357631343,44,33,1,1
"912346858",60,3642.9092481628,2735.5526890818,36,24,1,1
"912346859",29,2680.89240513631,2357.79423966008,13,16,1,1
"912346860",54,3422.73225933839,2677.2712016452,29,25,1,1
"912346864",36,2518.26593123931,2464.33502634194,20,16,1,1
"912346865",59,3472.83437564706,2726.17127719361,30,29,1,1
"912346866",58,2802.39132904769,2716.66249357165,29,29,1,1
"912346867",46,2841.28016702248,2590.94954296761,24,22,1,1
"912346869",50,3070.35755191626,2635.48551585152,32,18,1,1
"912346870",53,2759.46194522881,2667.061866114,27,26,1,1
"912346871",41,2586.98402005809,2530.72175773865,21,20,1,1
"912346872",27,2437.81765905874,2323.60649590586,16,11,1,1
"912347043",52,3507.12817613418,2656.6981055205,27,25,1,1
"912347044",51,3154.33077185482,2646.17454577679,19,32,1,1
"912347045",32,2812.87516956168,2405.71569249515,19,13,1,1
"912347046",41,2920.64199060674,2530.72175773865,23,18,1,1
"912347047",38,2863.13981200989,2491.71993967651,21,17,1,1
"912347048",43,3123.20480658477,2555.47878346624,19,24,1,1
"912347049",47,3232.12089326758,2602.36394728806,20,27,1,1
"912347050",42,3113.28039051096,2543.21752514954,20,22,1,1
"912347051",35,2801.55587169299,2450.1860183293,16,19,1,1
"912347052",45,2729.73261362635,2579.33597919865,22,23,1,1
"912347053",43,2928.43292918867,2555.47878346624,21,22,1,1
"912347054",40,3108.89162489273,2517.98110851286,21,19,1,1
"912347055",51,3045.5604556472,2646.17454577679,27,24,1,1
"912347056",44,3071.95534753386,2567.51523707907,20,24,1,1
"912347057",30,2635.51041591296,2374.18906024059,15,15,1,1
"912347058",32,2558.89614764542,2405.71569249515,12,20,1,1
"912347059",43,3115.3451701315,2555.47878346624,21,22,1,1
"912347060",36,2962.57541963204,2464.33502634194,17,19,1,1
"912347061",35,2939.30469798044,2450.1860183293,17,18,1,1
"912347062",26,2450.21980212369,2305.75108410937,15,11,1,1
"912347063",50,2920.30179104022,2635.48551585152,23,27,1,1
"912347064",38,3145.18278317457,2491.71993967651,20,18,1,1
"912347065",36,3110.36982994353,2464.33502634194,16,20,1,1
"912347066",29,2822.07805331459,2357.79423966008,11,18,1,1
"912347067",40,3077.04422564616,2517.98110851286,18,22,1,1
"912347068",31,2885.09271983466,2390.15469389133,14,17,1,1
"912347069",40,3037.34883017775,2517.98110851286,16,24,1,1
"912347070",49,3597.12562338195,2624.62502504328,22,27,1,1
"912347071",42,3410.40522089415,2543.21752514954,25,17,1,1
"912347072",45,3330.22270741692,2579.33597919865,26,19,1,1
"912347073",44,3085.13622352521,2567.51523707907,25,19,1,1
"912347074",45,3252.94806727373,2579.33597919865,23,22,1,1
"912347075",36,2935.6734280135,2464.33502634194,19,17,1,1
"912347076",39,3004.65250843639,2504.98447234734,22,17,1,1
"912347077",28,2619.44931240399,2340.94327947849,16,12,1,1
"912347078",41,2951.51927025253,2530.72175773865,26,15,1,1
"912347079",42,2712.2253277526,2543.21752514954,20,22,1,1
"912347080",42,2947.13530692087,2543.21752514954,25,17,1,1
"912347081",38,2922.58786025903,2491.71993967651,20,18,1,1
"912347082",42,2946.38851554332,2543.21752514954,22,20,1,1
"912347083",51,2944.4544427883,2646.17454577679,28,23,1,1
"912347084",34,2893.45440903808,2435.71163614839,22,12,1,1
"912347085",58,3279.33521103122,2716.66249357165,36,22,1,1
"912347086",58,3499.8487299169,2716.66249357165,33,25,1,1
"912347087",45,2769.43518985354,2579.33597919865,25,20,1,1
"912347088",37,2979.17275074691,2478.17471526668,19,18,1,1
"912347089",44,3500.57040321487,2567.51523707907,21,23,1,1
"912347090",36,2988.43201596033,2464.33502634194,17,19,1,1
"912347091",41,2635.67509544334,2530.72175773865,21,20,1,1
"912347092",47,2665.25446279206,2602.36394728806,27,20,1,1
"912347093",40,2666.53895465499,2517.98110851286,21,19,1,1
"912347094",38,2654.58667787086,2491.71993967651,18,20,1,1
"912347095",40,2584.78224609005,2517.98110851286,21,19,1,1
"912347096",30,2560.08348480457,2374.18906024059,16,14,1,1
"912347097",43,2858.88602807266,2555.47878346624,25,18,1,1
"912347098",35,2567.47927571228,2450.1860183293,17,18,1,1
"912347099",43,3375.70932153812,2555.47878346624,24,19,1,1
"912347100",37,3276.91777289139,2478.17471526668,17,20,1,1
"912347101",37,2823.56266934071,2478.17471526668,18,19,1,1
"912347102",43,2961.98021745393,2555.47878346624,21,22,1,1
"912347103",17,2231.05343476105,2113.95669457394,8,9,1,1
"912347104",16,2148.5821471003,2087.92318348224,7,9,1,1
"912347105",38,2756.40778265457,2491.71993967651,18,20,1,1
"912347106",42,2874.71623871199,2543.21752514954,21,21,1,1
"912347107",58,3499.10901164409,2716.66249357165,28,30,1,1
"912347108",57,2879.8513348901,2707.02236739438,28,29,1,1
"912347109",53,2814.72261944645,2667.061866114,27,26,1,1
"912347110",44,3159.71324295694,2567.51523707907,21,23,1,1
"912347111",41,2998.87354541759,2530.72175773865,20,21,1,1
"912347112",37,2446.56119337119,2478.17471526668,23,14,1,1
"912347113",63,3297.96381532497,2762.96971264875,29,34,1,1
"912347114",42,3169.52661710758,2543.21752514954,26,16,1,1
"912347115",45,2976.59130296108,2579.33597919865,26,19,1,1
"912347116",59,2883.82465275608,2726.17127719361,25,34,1,1
"912347117",55,3370.46117195101,2687.33120998132,29,26,1,1
"912347118",50,3064.16994216852,2635.48551585152,28,22,1,1
"912347119",62,3243.48365571894,2753.94837323248,31,31,1,1
"912347120",26,2468.79361252656,2305.75108410937,14,12,1,1
"912347121",41,2577.32664036306,2530.72175773865,26,15,1,1
"912347122",53,3268.94764594697,2667.061866114,29,24,1,1
"912347123",44,3043.18316427411,2567.51523707907,22,22,1,1
"912347124",49,3459.71008016869,2624.62502504328,25,24,1,1
"912347125",37,2821.95571244232,2478.17471526668,17,20,1,1
"912347126",49,3312.06969700135,2624.62502504328,18,31,1,1
"912347127",46,3122.7259350284,2590.94954296761,26,20,1,1
"912347128",63,3405.10804639801,2762.96971264875,34,29,1,1
"912347129",42,3097.82652510793,2543.21752514954,25,17,1,1
"912347130",40,2592.09642327888,2517.98110851286,22,18,1,1
"912347131",41,2812.43397587135,2530.72175773865,26,15,1,1
"912347132",41,2915.33715379869,2530.72175773865,19,22,1,1
"912347133",49,2739.35735397346,2624.62502504328,26,23,1,1
"912347135",55,3443.37677432593,2687.33120998132,34,21,1,1
"912347136",75,3900.0438687563,2863.21031780169,44,31,1,1
"912347390",60,3233.71255865105,2735.5526890818,32,28,1,1
"912347391",52,3471.46272118762,2656.6981055205,30,22,1,1
"912347392",83,3845.13688588533,2923.1438046077,48,35,1,1
"912347393",60,3334.66754342582,2735.5526890818,28,32,1,1
"912347394",77,3529.99584575384,2878.65357631343,42,35,1,1
"912347395",70,3669.84131790437,2823.11677003184,37,33,1,1
"912347396",56,3303.48908314608,2697.24673169728,35,21,1,1
"912347397",61,3399.20345469414,2744.81051624266,36,25,1,1
"912347398",60,3285.14919642119,2735.5526890818,34,26,1,1
"912347399",57,3221.35357514095,2707.02236739438,28,29,1,1
"912347400",28,2755.25630374167,2340.94327947849,20,8,1,1
"912347401",45,3102.11008814478,2579.33597919865,27,18,1,1
"912347402",87,3558.49717836126,2951.40156710974,47,40,1,1
"912347403",54,3295.46807201858,2677.2712016452,28,26,1,1
"912347404",62,3391.16840552112,2753.94837323248,37,25,1,1
"912347405",54,3403.02073380824,2677.2712016452,28,26,1,1
"912347407",61,3298.67100164351,2744.81051624266,35,26,1,1
"912347408",49,2573.73101030769,2624.62502504328,29,20,1,1
"912347409",49,2944.10324546895,2624.62502504328,28,21,1,1
"912347410",88,2954.58505391353,2958.30409156145,47,41,1,1
"912347412",86,3689.49453991015,2944.43562859908,50,36,1,1
"912347413",63,2890.66632450255,2762.96971264875,36,27,1,1
"912347414",67,3341.30635235108,2797.95380131742,42,25,1,1
"912347415",70,3484.96415524264,2823.11677003184,36,34,1,1
"912347416",50,3085.98937765676,2635.48551585152,30,20,1,1
"912347417",41,3195.66900524866,2530.72175773865,22,19,1,1
"912347418",50,3018.90906986424,2635.48551585152,22,28,1,1
"912347419",65,3441.04471414474,2780.67589681985,34,31,1,1
"912347420",49,3322.23973532823,2624.62502504328,27,22,1,1
"912347421",71,3919.13716400154,2831.31372136695,30,41,1,1
"912347422",58,3082.41592502948,2716.66249357165,31,27,1,1
"912347423",52,3325.51635203826,2656.6981055205,25,27,1,1
"912347424",39,2808.18942560581,2504.98447234734,24,15,1,1
"912347425",41,2647.55601537183,2530.72175773865,24,17,1,1
"912347426",54,3165.3816969827,2677.2712016452,31,23,1,1
"912347427",51,2491.87357349905,2646.17454577679,31,20,1,1
"912347428",52,3010.50241703245,2656.6981055205,27,25,1,1
"912347429",31,2511.44050052575,2390.15469389133,22,9,1,1
"912347430",69,3632.33778367134,2814.82611826518,37,32,1,1
"912347431",66,3230.57745357942,2789.3669207067,33,33,1,1
"912347432",71,3317.50551207713,2831.31372136695,36,35,1,1
"912347433",53,3300.4411020921,2667.061866114,28,25,1,1
"912347434",73,3580.01151563822,2847.4358582506,40,33,1,1
"912347435",65,3247.40478389526,2780.67589681985,34,31,1,1
"912347436",63,3071.69904155936,2762.96971264875,35,28,1,1
"912347437",68,3233.09590705271,2806.43931339586,37,31,1,1
"912347438",73,3571.4676108621,2847.4358582506,35,38,1,1
"912347439",69,3456.90223585135,2814.82611826518,36,33,1,1
"912347442",51,2975.03143855019,2646.17454577679,30,21,1,1
"912347443",38,2836.20606365396,2491.71993967651,22,16,1,1
"912347444",69,3320.2313707237,2814.82611826518,37,32,1,1
"912347446",51,3386.05334118579,2646.17454577679,28,23,1,1
"912347447",65,3623.5482930962,2780.67589681985,35,30,1,1
"912347448",63,3521.5726679646,2762.96971264875,37,26,1,1
"912347449",55,2999.19409667038,2687.33120998132,33,22,1,1
"912347450",43,2818.25757798938,2555.47878346624,27,16,1,1
"912347451",40,2660.69657037488,2517.98110851286,26,14,1,1
"912347452",75,3340.72602358238,2863.21031780169,42,33,1,1
"912347453",61,3277.08066547967,2744.81051624266,31,30,1,1
"912347454",60,3226.54482569795,2735.5526890818,30,30,1,1
"912347455",71,3897.55849256265,2831.31372136695,43,28,1,1
"912347456",81,3536.80116159997,2908.60658576875,41,40,1,1
"912347457",80,3855.80081066789,2901.2306171403,43,37,1,1
"912347458",55,2926.81136944935,2687.33120998132,29,26,1,1
"912347459",82,3670.39344170953,2915.91045786314,47,35,1,1
"912347460",78,3510.39733912124,2886.25582696583,43,35,1,1
"912347461",44,2752.66254556762,2567.51523707907,21,23,1,1
"912347462",52,3109.73567464937,2656.6981055205,31,21,1,1
"912347463",55,3055.62663105295,2687.33120998132,30,25,1,1
"912347464",59,3193.37640486991,2726.17127719361,33,26,1,1
"912347465",54,2679.51734470574,2677.2712016452,34,20,1,1
"912347466",64,2879.33242390831,2771.87783482774,38,26,1,1
"912347467",67,3506.77946432643,2797.95380131742,38,29,1,1
"912347468",68,3426.8200300547,2806.43931339586,37,31,1,1
"912347469",31,2443.27572244582,2390.15469389133,14,17,1,1
"912347470",27,2300.87803528326,2323.60649590586,14,13,1,1
"912347471",32,2710.26011351646,2405.71569249515,13,19,1,1
"912347472",24,2381.49928107504,2268.33468283819,14,10,1,1
"912347473",54,3063.25082388775,2677.2712016452,26,28,1,1
"912347474",55,2963.51120412659,2687.33120998132,28,27,1,1
"912347475",68,3555.0340885782,2806.43931339586,43,25,1,1
"912347476",67,3132.80125193069,2797.95380131742,38,29,1,1
"912347477",38,3017.80839278976,2491.71993967651,23,15,1,1
"912347478",51,2905.82738649866,2646.17454577679,31,20,1,1
"912347479",31,2484.41300893862,2390.15469389133,19,12,1,1
"912347480",28,2241.07010074777,2340.94327947849,20,8,1,1
"912347481",58,2872.41745671453,2716.66249357165,27,31,1,1
"912347482",59,3245.45289818684,2726.17127719361,37,22,1,1
"912347483",60,3101.33855960722,2735.5526890818,35,25,1,1
"912347485",66,3109.80329358861,2789.3669207067,39,27,1,1
"912347486",68,3552.9941618329,2806.43931339586,36,32,1,1
"912347487",43,3045.1123131382,2555.47878346624,26,17,1,1
"912347488",68,3540.14424848466,2806.43931339586,35,33,1,1
"912347489",54,3178.94650571842,2677.2712016452,30,24,1,1
"912347490",37,2689.81756116619,2478.17471526668,21,16,1,1
"912347491",51,2630.38180448268,2646.17454577679,31,20,1,1
"912347497",48,2501.90339641087,2613.58673801098,25,23,1,1
"912347498",36,2467.51250257378,2464.33502634194,20,16,1,1
"912347499",44,2718.60297324691,2567.51523707907,25,19,1,1
"912347500",39,2522.17576517571,2504.98447234734,23,16,1,1
"912347501",38,2471.27260899737,2491.71993967651,22,16,1,1
"912347502",18,2145.5743495367,2138.79896507223,11,7,1,1
"912347503",32,2410.1420678079,2405.71569249515,19,13,1,1
"912347504",39,2718.77760467875,2504.98447234734,24,15,1,1
"912347505",32,2458.92983054621,2405.71569249515,15,17,1,1
"912347506",88,4186.45993048372,2958.30409156145,46,42,1,1
"912347507",72,3261.62680525632,2839.4193288992,38,34,1,1
"912347508",63,3612.28720774667,2762.96971264875,34,29,1,1
"912347510",52,3206.9401720132,2656.6981055205,28,24,1,1
"912347511",61,3681.45272140059,2744.81051624266,30,31,1,1
"912347512",63,3602.00641135158,2762.96971264875,31,32,1,1
"912347513",44,2380.21845082589,2567.51523707907,26,18,1,1
"912347514",44,2499.91584913693,2567.51523707907,28,16,1,1
"912347515",39,2632.17398052073,2504.98447234734,25,14,1,1
"912347516",36,2693.65186248666,2464.33502634194,25,11,1,1
"912347517",28,2273.26240346696,2340.94327947849,16,12,1,1
"912347518",34,2385.23908092713,2435.71163614839,20,14,1,1
"912347519",54,3127.36469851434,2677.2712016452,33,21,1,1
"912347520",49,2735.66200043941,2624.62502504328,30,19,1,1
"912347521",48,2605.12460090855,2613.58673801098,28,20,1,1
"912347522",86,4052.44311826378,2944.43562859908,50,36,1,1
"912347523",88,3824.78412375041,2958.30409156145,51,37,1,1
"912347524",67,3357.03514557435,2797.95380131742,34,33,1,1
"912347525",62,3204.76579315571,2753.94837323248,34,28,1,1
"912347526",64,3055.2907375373,2771.87783482774,37,27,1,1
"912347527",88,3698.9998792354,2958.30409156145,58,30,1,1
"912347528",86,3128.62108464292,2944.43562859908,50,36,1,1
"912347529",74,3143.88529430959,2855.36548874306,44,30,1,1
"912347530",35,2641.64235098812,2450.1860183293,24,11,1,1
"912347531",64,3087.00041397734,2771.87783482774,38,26,1,1
"912347532",54,3124.69083846902,2677.2712016452,33,21,1,1
"912347533",85,3439.7052086138,2937.40494579778,45,40,1,1
"912347534",59,2928.11163813912,2726.17127719361,34,25,1,1
"912347535",46,2671.09319149749,2590.94954296761,24,22,1,1
"912347536",50,2686.35283387831,2635.48551585152,29,21,1,1
"912347537",63,3553.43923747055,2762.96971264875,37,26,1,1
"912347538",59,2790.28966306445,2726.17127719361,36,23,1,1
"912347539",61,2921.77072873723,2744.81051624266,33,28,1,1
"912347540",47,2745.91837085172,2602.36394728806,30,17,1,1
"912347541",43,2875.10793762539,2555.47878346624,25,18,1,1
"912347542",57,3194.33172225425,2707.02236739438,33,24,1,1
"912347543",76,3215.56058218818,2870.97236507783,34,42,1,1
"912347544",61,2937.60339899269,2744.81051624266,34,27,1,1
"912347545",65,3265.04685986081,2780.67589681985,38,27,1,1
"912347546",79,3431.26658727592,2893.78092561085,45,34,1,1
"912347547",64,3129.24745646193,2771.87783482774,36,28,1,1
"912347549",47,2842.5558575608,2602.36394728806,29,18,1,1
"912347550",62,2676.03581869007,2753.94837323248,29,33,1,1
"912347551",37,2610.53051349128,2478.17471526668,19,18,1,1
"912347552",34,2615.46271123375,2435.71163614839,21,13,1,1
"912347553",34,2667.81607712195,2435.71163614839,20,14,1,1
"912347554",34,2856.10675649701,2435.71163614839,17,17,1,1
"912347555",34,2564.06349321991,2435.71163614839,21,13,1,1
"912347556",38,2503.84866105581,2491.71993967651,23,15,1,1
"912347557",44,2544.47317398659,2567.51523707907,32,12,1,1
"912347558",42,2601.99539587146,2543.21752514954,28,14,1,1
"912347559",57,3525.28958455438,2707.02236739438,38,19,1,1
"912347560",50,3118.22058646309,2635.48551585152,31,19,1,1
"912347561",49,2918.43971453495,2624.62502504328,25,24,1,1
"912347562",55,3401.505870557,2687.33120998132,33,22,1,1
"912347563",74,3726.30948678603,2855.36548874306,37,37,1,1
"912347564",76,3720.66797670016,2870.97236507783,39,37,1,1
"912347565",45,2996.53398643282,2579.33597919865,26,19,1,1
"912347566",53,3027.3846116933,2667.061866114,30,23,1,1
"912347567",59,3843.1902746145,2726.17127719361,33,26,1,1
"912347568",51,3433.34383452931,2646.17454577679,31,20,1,1
"912347569",45,2296.99463606389,2579.33597919865,27,18,1,1
"912347570",38,2446.94121509625,2491.71993967651,22,16,1,1
"912347571",78,3678.94367266223,2886.25582696583,45,33,1,1
"912347572",73,3735.43868060984,2847.4358582506,38,35,1,1
"912347573",75,3598.92889142971,2863.21031780169,41,34,1,1
"912347574",69,3480.6201181837,2814.82611826518,40,29,1,1
"912347575",45,2616.23641488109,2579.33597919865,26,19,1,1
"912347576",45,2553.67484292804,2579.33597919865,21,24,1,1
"912347577",42,2863.12654865683,2543.21752514954,26,16,1,1
"912347578",44,2969.01456558448,2567.51523707907,29,15,1,1
"912347579",31,2349.61576245522,2390.15469389133,18,13,1,1
"912347580",44,2579.04552292601,2567.51523707907,22,22,1,1
"912347581",39,2434.92526288421,2504.98447234734,21,18,1,1
"912347582",67,3035.14030839955,2797.95380131742,37,30,1,1
"912347583",36,2729.30549971706,2464.33502634194,20,16,1,1
"912347584",44,2717.10705709879,2567.51523707907,21,23,1,1
"912347585",47,3116.47053338345,2602.36394728806,22,25,1,1
"912347586",45,2935.83216864277,2579.33597919865,21,24,1,1
"912347587",36,2956.60205013264,2464.33502634194,19,17,1,1
"912347588",64,3250.59711791488,2771.87783482774,31,33,1,1
"912347589",65,3713.75965789951,2780.67589681985,34,31,1,1
"912347624",53,3199.2196054262,2667.061866114,29,24,1,1
"912347625",55,3222.87731306379,2687.33120998132,31,24,1,1
"912347627",66,3533.89286736382,2789.3669207067,30,36,1,1
"912347628",50,2834.13811795255,2635.48551585152,24,26,1,1
"912347629",67,3390.68292973191,2797.95380131742,35,32,1,1
"912347630",45,2791.26468259563,2579.33597919865,25,20,1,1
"912347631",45,3233.38959185722,2579.33597919865,18,27,1,1
"912347632",52,3045.10183051893,2656.6981055205,23,29,1,1
"912347633",54,2731.01179426509,2677.2712016452,26,28,1,1
"912347634",57,2944.67329663125,2707.02236739438,30,27,1,1
"912347635",68,3230.8168844,2806.43931339586,32,36,1,1
"912347637",65,3491.05278224705,2780.67589681985,28,37,1,1
"912347638",55,3273.96011450461,2687.33120998132,28,27,1,1
"912347639",47,2763.94681312514,2602.36394728806,23,24,1,1
"912347640",59,2862.67145156196,2726.17127719361,27,32,1,1
"912347641",61,3171.66285489086,2744.81051624266,25,36,1,1
"912347642",57,3622.97934393774,2707.02236739438,27,30,1,1
"912347643",57,2827.72625168998,2707.02236739438,31,26,1,1
"912347644",48,2723.20002951881,2613.58673801098,25,23,1,1
"912347645",73,3076.14965732488,2847.4358582506,32,41,1,1
"912347646",72,3670.07077367126,2839.4193288992,29,43,1,1
"912347647",56,2932.85962450865,2697.24673169728,27,29,1,1
"912347648",72,3633.19723810653,2839.4193288992,29,43,1,1
"912347649",60,3374.73810835436,2735.5526890818,31,29,1,1
"912347650",70,3743.17126447221,2823.11677003184,31,39,1,1
"912347651",74,2976.80440468968,2855.36548874306,37,37,1,1
"912347652",68,3311.2789559849,2806.43931339586,38,30,1,1
"912347653",78,4171.35905607256,2886.25582696583,39,39,1,1
"912347654",44,3017.86787944337,2567.51523707907,26,18,1,1
"912347655",53,3462.53494492004,2667.061866114,24,29,1,1
"912347656",61,3598.1619082292,2744.81051624266,38,23,1,1
"912347657",59,3376.66831578023,2726.17127719361,32,27,1,1
"912347658",49,2881.11189688366,2624.62502504328,17,32,1,1
"912347659",48,3242.13326970446,2613.58673801098,24,24,1,1
"912347660",38,2622.91612361788,2491.71993967651,16,22,1,1
"912347661",38,2406.47175554352,2491.71993967651,18,20,1,1
"912347662",43,2849.25900795957,2555.47878346624,20,23,1,1
"912347663",52,3552.37671083969,2656.6981055205,24,28,1,1
"912347664",60,3377.90287912948,2735.5526890818,30,30,1,1
"912347665",58,3150.39445601343,2716.66249357165,25,33,1,1
"912347666",33,2953.17976738802,2420.89448855093,14,19,1,1
"912347667",63,3410.9902910118,2762.96971264875,32,31,1,1
"912347668",50,3193.51548153206,2635.48551585152,22,28,1,1
"912347669",34,2600.75510368143,2435.71163614839,16,18,1,1
"912347670",53,3013.44868019584,2667.061866114,26,27,1,1
"912347671",53,3063.25564048428,2667.061866114,24,29,1,1
"912347672",53,2704.89243713852,2667.061866114,27,26,1,1
"912347673",40,3003.63040665485,2517.98110851286,19,21,1,1
"912347674",52,2579.32769873174,2656.6981055205,26,26,1,1
"912347675",66,3739.12922827866,2789.3669207067,32,34,1,1
"912347676",65,3293.36802012656,2780.67589681985,28,37,1,1
"912347677",52,3262.38487394759,2656.6981055205,25,27,1,1
"912347678",64,3258.91909195387,2771.87783482774,29,35,1,1
"912347679",49,3505.83661106637,2624.62502504328,25,24,1,1
"912347680",41,2728.17185390323,2530.72175773865,19,22,1,1
"912347681",59,2738.99197799289,2726.17127719361,32,27,1,1
"912347682",62,3133.58706719112,2753.94837323248,38,24,1,1
"912347683",68,4108.77641510922,2806.43931339586,34,34,1,1
"912347684",44,3052.46205522031,2567.51523707907,25,19,1,1
"912347685",64,3232.16615565023,2771.87783482774,34,30,1,1
"912347686",62,2978.97971299874,2753.94837323248,34,28,1,1
"912347687",63,2974.67602931902,2762.96971264875,31,32,1,1
"912347688",46,2581.25046428932,2590.94954296761,25,21,1,1
"912347689",52,3131.86099823683,2656.6981055205,26,26,1,1
"912347690",40,2783.87745756331,2517.98110851286,19,21,1,1
"912347692",56,3207.29578213757,2697.24673169728,29,27,1,1
"912347693",35,2602.74199853901,2450.1860183293,22,13,1,1
"912347694",52,2616.57204080769,2656.6981055205,32,20,1,1
"912347695",37,2601.8497518145,2478.17471526668,24,13,1,1
"912347696",30,2662.54655824644,2374.18906024059,20,10,1,1
"912347697",47,2536.54437752075,2602.36394728806,22,25,1,1
"912347698",46,3027.9490229958,2590.94954296761,26,20,1,1
"912347699",52,3141.74286584093,2656.6981055205,25,27,1,1
"912347700",39,2973.05328326789,2504.98447234734,15,24,1,1
"912347701",56,2655.28612158092,2697.24673169728,29,27,1,1
"912347702",37,2713.86978398311,2478.17471526668,22,15,1,1
"912347703",52,2742.44638123598,2656.6981055205,31,21,1,1
"912347704",44,2868.05393975607,2567.51523707907,24,20,1,1
"912347705",39,2830.10454114927,2504.98447234734,18,21,1,1
"912347706",48,2830.99218544185,2613.58673801098,28,20,1,1
"912347707",57,2904.83708364199,2707.02236739438,29,28,1,1
"912347708",49,2668.2360920761,2624.62502504328,23,26,1,1
"912347709",45,2778.18441132314,2579.33597919865,20,25,1,1
"912347710",26,2370.05877608757,2305.75108410937,13,13,1,1
"912347711",24,2398.36558161943,2268.33468283819,10,14,1,1
"912347712",58,3211.27252142099,2716.66249357165,32,26,1,1
"912347713",35,2710.99014264436,2450.1860183293,17,18,1,1
"912347714",59,2813.82475417936,2726.17127719361,34,25,1,1
"912347715",52,3098.58193033378,2656.6981055205,28,24,1,1
"912347716",43,3163.86067849258,2555.47878346624,24,19,1,1
"912347717",30,2743.33846432885,2374.18906024059,17,13,1,1
"912347718",30,2730.77834001118,2374.18906024059,13,17,1,1
"912347719",42,3082.26160009447,2543.21752514954,23,19,1,1
"912347720",33,2793.44654268053,2420.89448855093,20,13,1,1
"912347721",47,2743.97419833259,2602.36394728806,27,20,1,1
"912347724",50,3160.38944571151,2635.48551585152,24,26,1,1
"912347725",46,3416.55148043858,2590.94954296761,26,20,1,1
"912347726",41,2957.16928466972,2530.72175773865,20,21,1,1
"912347727",48,3086.54076672643,2613.58673801098,28,20,1,1
"912347728",39,2624.42360634809,2504.98447234734,19,20,1,1
"912347729",39,2806.33251824117,2504.98447234734,20,19,1,1
"912347730",32,2858.81944944559,2405.71569249515,17,15,1,1
"912347731",51,3139.07108553278,2646.17454577679,26,25,1,1
"912347732",50,3346.19935315148,2635.48551585152,26,24,1,1
"912347733",48,2976.11384744028,2613.58673801098,23,25,1,1
"912347734",58,3407.78203604696,2716.66249357165,30,28,1,1
"912347735",63,3598.31144028807,2762.96971264875,29,34,1,1
"912347736",63,3298.13772090258,2762.96971264875,30,33,1,1
"912347737",49,3235.90057966527,2624.62502504328,28,21,1,1
"912347738",43,2853.56687175743,2555.47878346624,20,23,1,1
"912347739",55,3128.53529911498,2687.33120998132,24,31,1,1
"912347740",52,3313.88254530962,2656.6981055205,25,27,1,1
"912347741",46,2988.51034972552,2590.94954296761,17,29,1,1
"912347742",56,2937.15502722951,2697.24673169728,26,30,1,1
"912347743",51,3067.44456878972,2646.17454577679,24,27,1,1
"912347744",34,2551.30328977618,2435.71163614839,16,18,1,1
"912347745",52,2938.06342502768,2656.6981055205,22,30,1,1
"912347746",53,3510.53470869952,2667.061866114,27,26,1,1
"912347747",58,3221.78045809292,2716.66249357165,29,29,1,1
"912347749",53,3442.59310486259,2667.061866114,23,30,1,1
"912347750",45,3083.75769729885,2579.33597919865,24,21,1,1
"912347751",52,3212.70699459952,2656.6981055205,26,26,1,1
"912347752",48,2968.98382493663,2613.58673801098,25,23,1,1
"912347753",71,3248.27849870879,2831.31372136695,37,34,1,1
"912347754",66,3276.34268895708,2789.3669207067,33,33,1,1
"912347755",70,3559.60018394728,2823.11677003184,43,27,1,1
"912347756",45,3241.07721972167,2579.33597919865,23,22,1,1
"912347757",48,2744.62084981679,2613.58673801098,21,27,1,1
"912347758",76,3448.478641657,2870.97236507783,42,34,1,1
"912347759",85,3889.13107096766,2937.40494579778,48,37,1,1
"912347760",86,4265.69933974193,2944.43562859908,46,40,1,1
"912347761",78,3551.84725428978,2886.25582696583,48,30,1,1
"912347762",52,2825.37190195047,2656.6981055205,30,22,1,1
"912347763",53,3223.60880265237,2667.061866114,34,19,1,1
"912347764",47,2755.69432536305,2602.36394728806,28,19,1,1
"912347765",47,2993.48074206915,2602.36394728806,24,23,1,1
"912347766",52,3224.87072547416,2656.6981055205,28,24,1,1
"912347767",53,3091.84102186573,2667.061866114,31,22,1,1
"912347768",46,2891.84757881155,2590.94954296761,26,20,1,1
"912347769",54,2798.21580097426,2677.2712016452,32,22,1,1
"912347770",49,3130.32811519819,2624.62502504328,29,20,1,1
"912347771",53,2957.52791460704,2667.061866114,32,21,1,1
"912347772",60,3392.01645907159,2735.5526890818,38,22,1,1
"912347773",60,3026.52268205938,2735.5526890818,38,22,1,1
"912347774",43,2794.0042118516,2555.47878346624,30,13,1,1
"912347775",56,3203.95510676908,2697.24673169728,34,22,1,1
"912347776",57,3015.81501054922,2707.02236739438,33,24,1,1
"912347781",45,2665.6865973316,2579.33597919865,28,17,1,1
"912347782",56,2667.2102155136,2697.24673169728,29,27,1,1
"912347783",45,2620.30640874896,2579.33597919865,26,19,1,1
"912347784",45,2728.6845083626,2579.33597919865,25,20,1,1
"912347786",38,2518.44106756613,2491.71993967651,26,12,1,1
"912347787",38,2534.80828634828,2491.71993967651,24,14,1,1
"912347788",63,2758.41271247604,2762.96971264875,34,29,1,1
"912347789",54,3046.54709206202,2677.2712016452,30,24,1,1
"912347790",69,3064.23208128349,2814.82611826518,41,28,1,1
"912347791",76,3515.19191682172,2870.97236507783,45,31,1,1
"912347792",55,3161.49894973363,2687.33120998132,35,20,1,1
"912347793",80,3600.43073724975,2901.2306171403,45,35,1,1
"912347794",63,3111.80861892924,2762.96971264875,39,24,1,1
"912347795",30,2344.99947022562,2374.18906024059,19,11,1,1
"912347796",23,2246.38289237947,2248.68783741607,12,11,1,1
"912347797",22,2242.63172329079,2228.3491786518,14,8,1,1
"912347798",12,1982.29859582917,1968.69006049611,7,5,1,1
"912347799",13,1970.08494044034,2001.16379457045,7,6,1,1
"912347802",59,2819.33448056965,2726.17127719361,25,34,1,1
"912347803",47,2621.4965291469,2602.36394728806,19,28,1,1
"912347808",55,3018.70743640219,2687.33120998132,26,29,1,1
"912347809",37,2793.28570385591,2478.17471526668,17,20,1,1
"912347816",32,2675.37866456986,2405.71569249515,12,20,1,1
"912347817",41,2818.23282801805,2530.72175773865,21,20,1,1
"912347822",60,2502.4886964898,2735.5526890818,26,34,1,1
"912347823",67,2812.8734947269,2797.95380131742,36,31,1,1
"912349252",7,1736.13374417005,1763.32076508842,1,6,1,1
"912349253",7,1800.37089199842,1763.32076508842,0,7,1,1
"912349254",9,1828.88724938397,1856.26587460569,1,8,1,1
"912349255",5,1679.50104732665,1646.12614877363,1,4,1,1
"912349256",6,1756.31576273589,1708.62817714657,0,6,1,1
"912349257",13,1781.35814924813,2001.16379457045,2,11,1,1
"912349258",7,1791.50190253212,1763.32076508842,1,6,1,1
"912349259",7,1754.94842010142,1763.32076508842,2,5,1,1
"912349260",8,1824.17955680403,1812.11073017574,1,7,1,1
"912349261",7,1765.32606916313,1763.32076508842,0,7,1,1
"912349262",6,1768.7396495308,1708.62817714657,0,6,1,1
"912349263",6,1718.51255047346,1708.62817714657,0,6,1,1
"912349264",9,1788.16252299677,1856.26587460569,1,8,1,1
"912349265",10,1822.52516160943,1896.67490607898,1,9,1,1
"912349266",10,1843.09271115119,1896.67490607898,2,8,1,1
"912349267",10,1734.05858434899,1896.67490607898,1,9,1,1
"912349268",9,1848.68133679814,1856.26587460569,1,8,1,1
"912349269",10,1767.99683782689,1896.67490607898,2,8,1,1
"912349270",10,1817.77056899608,1896.67490607898,1,9,1,1
"912349271",6,1720.82851818857,1708.62817714657,0,6,1,1
"912349272",6,1711.62683872933,1708.62817714657,0,6,1,1
"912349273",8,1756.43083513334,1812.11073017574,2,6,1,1
"912349274",5,1689.76450035473,1646.12614877363,0,5,1,1
"912349275",11,1799.65539806336,1933.98659929558,2,9,1,1
"912349276",9,1777.91327213067,1856.26587460569,1,8,1,1
"912349277",9,1823.51470283836,1856.26587460569,1,8,1,1
"912349278",12,1792.09777334353,1968.69006049611,3,9,1,1
"912349279",6,1685.71356394216,1708.62817714657,1,5,1,1
"912349280",8,1680.08218140183,1812.11073017574,2,6,1,1
"912349281",7,1748.05232374569,1763.32076508842,0,7,1,1
"912349282",10,1744.96918760682,1896.67490607898,1,9,1,1
"912349283",11,1755.81228564419,1933.98659929558,2,9,1,1
"912349285",6,1711.62683872933,1708.62817714657,0,6,1,1
"912349286",7,1747.23067888069,1763.32076508842,1,6,1,1
"912349287",7,1747.23067888069,1763.32076508842,1,6,1,1
"912349288",9,1832.35120885396,1856.26587460569,2,7,1,1
"912349289",9,1777.86755591402,1856.26587460569,2,7,1,1
"912349290",5,1684.74990748949,1646.12614877363,0,5,1,1
"912349291",5,1684.74990748949,1646.12614877363,0,5,1,1
"912349292",3,1520.15924598997,1482.92019466158,0,3,1,1
"912349293",6,1751.80004777052,1708.62817714657,0,6,1,1
"912349616",34,2890.21440628083,2435.71163614839,20,14,1,1
"912349617",45,2815.96342961602,2579.33597919865,25,20,1,1
"912349618",41,2713.54200603054,2530.72175773865,23,18,1,1
"912349619",34,2722.47120639472,2435.71163614839,17,17,1,1
"912349620",29,2500.48661531211,2357.79423966008,15,14,1,1
"912349621",39,2804.3878349372,2504.98447234734,18,21,1,1
"912349622",48,3418.0670911897,2613.58673801098,20,28,1,1
"912349623",38,2179.27328895324,2491.71993967651,16,22,1,1
"912349624",37,2909.5164147442,2478.17471526668,20,17,1,1
"912349625",37,2885.97074509154,2478.17471526668,19,18,1,1
"912349626",47,3114.09287506857,2602.36394728806,22,25,1,1
"912349627",26,2200.66151368315,2305.75108410937,12,14,1,1
"912349628",38,2695.35400520642,2491.71993967651,20,18,1,1
"912349630",51,3134.97172622907,2646.17454577679,28,23,1,1
"912349632",26,2519.19816164528,2305.75108410937,14,12,1,1
"912349633",32,2464.32124049372,2405.71569249515,17,15,1,1
"912349634",32,2434.66004437023,2405.71569249515,18,14,1,1
"912349635",38,2748.64271663441,2491.71993967651,18,20,1,1
"912349636",46,3124.92968779554,2590.94954296761,22,24,1,1
"912349637",36,2817.50910240194,2464.33502634194,21,15,1,1
"912349639",59,3332.35862903733,2726.17127719361,31,28,1,1
"912349640",26,2247.70687547562,2305.75108410937,14,12,1,1
"912349641",42,2965.29388721331,2543.21752514954,20,22,1,1
"912349642",54,3146.40394283102,2677.2712016452,25,29,1,1
"912349643",56,3369.49167963272,2697.24673169728,27,29,1,1
"912349644",15,2121.66623032468,2060.56118614118,8,7,1,1
"912349645",31,2227.44338002815,2390.15469389133,16,15,1,1
"912349646",43,2751.70638705111,2555.47878346624,24,19,1,1
"912349647",36,2646.40460893926,2464.33502634194,20,16,1,1
"912349648",49,3216.13472481843,2624.62502504328,30,19,1,1
"912349649",42,3217.04741775784,2543.21752514954,22,20,1,1
"912349650",35,2686.28162719774,2450.1860183293,20,15,1,1
"912349651",61,3730.24160869367,2744.81051624266,33,28,1,1
"912349652",50,3271.15762501259,2635.48551585152,26,24,1,1
"912349653",29,2608.01304329551,2357.79423966008,18,11,1,1
"912349654",31,2473.17973847154,2390.15469389133,17,14,1,1
"912349655",32,2759.33989114989,2405.71569249515,16,16,1,1
"912349656",54,2834.82829809797,2677.2712016452,30,24,1,1
"912349657",44,2831.8783863173,2567.51523707907,22,22,1,1
"912349658",61,3549.95259038227,2744.81051624266,33,28,1,1
"912349659",23,2141.19260383595,2248.68783741607,13,10,1,1
"912349660",42,2805.53136064283,2543.21752514954,25,17,1,1
"912349661",48,2962.66051880667,2613.58673801098,28,20,1,1
"912349662",34,2674.54754382154,2435.71163614839,18,16,1,1
"912349663",49,2826.41605072694,2624.62502504328,27,22,1,1
"912349664",29,2488.67285369235,2357.79423966008,16,13,1,1
"912349665",41,3194.9411404229,2530.72175773865,20,21,1,1
"912349666",31,2830.27083027913,2390.15469389133,18,13,1,1
"912349667",44,3019.22140514693,2567.51523707907,21,23,1,1
"912349668",42,3153.16988467149,2543.21752514954,24,18,1,1
"912349669",36,3129.56679905513,2464.33502634194,21,15,1,1
"912349670",45,2988.39259562735,2579.33597919865,25,20,1,1
"912349671",43,2379.83783116417,2555.47878346624,23,20,1,1
"912349672",60,3410.53128766392,2735.5526890818,32,28,1,1
"912349673",53,3196.1377049219,2667.061866114,27,26,1,1
"912349674",45,2715.57945501817,2579.33597919865,19,26,1,1
"912349675",47,2903.37995426388,2602.36394728806,24,23,1,1
"912349676",38,2729.27164390527,2491.71993967651,22,16,1,1
"912349677",41,3261.40263632232,2530.72175773865,21,20,1,1
"912349678",40,3032.8425742556,2517.98110851286,18,22,1,1
"912349679",45,2825.78521788861,2579.33597919865,22,23,1,1
"912349680",29,2558.03653922607,2357.79423966008,13,16,1,1
"912349681",38,2811.87717133921,2491.71993967651,19,19,1,1
"912349682",31,2592.57137411921,2390.15469389133,15,16,1,1
"912349683",41,2953.80222372333,2530.72175773865,22,19,1,1
"912349684",37,2447.645421898,2478.17471526668,15,22,1,1
"912349685",43,2928.92089895161,2555.47878346624,24,19,1,1
"912349686",45,3097.94709598157,2579.33597919865,24,21,1,1
"912349687",41,2794.98182487392,2530.72175773865,22,19,1,1
"912349688",39,2501.32265907816,2504.98447234734,22,17,1,1
"912349711",54,3135.84715763797,2677.2712016452,27,27,1,1
"912349712",44,2603.30693808463,2567.51523707907,24,20,1,1
"912349713",32,2651.10990455063,2405.71569249515,21,11,1,1
"912350196",92,3848.92885057396,2985.30521778333,39,53,1,1
"912350198",39,2659.69622847595,2504.98447234734,22,17,1,1
"912350199",24,2372.45102170557,2268.33468283819,12,12,1,1
"912350200",16,2092.25621353931,2087.92318348224,8,8,1,1
"912350201",13,2065.76470863251,2001.16379457045,7,6,1,1
"912350202",34,2719.71659297802,2435.71163614839,20,14,1,1
"912350203",27,2522.5820672412,2323.60649590586,16,11,1,1
"912350204",44,2940.12101620071,2567.51523707907,25,19,1,1
"912350205",29,2743.93654865364,2357.79423966008,16,13,1,1
"912350206",38,2634.68381478136,2491.71993967651,21,17,1,1
"912350207",31,2539.40378112797,2390.15469389133,18,13,1,1
"912350208",20,2380.67833323796,2185.35845629437,10,10,1,1
"912350209",29,2559.43414958936,2357.79423966008,15,14,1,1
"912350211",22,2291.79884535948,2228.3491786518,14,8,1,1
"912350212",41,2889.18560652244,2530.72175773865,19,22,1,1
"912350213",40,2833.52631017822,2517.98110851286,21,19,1,1
"912350214",27,2385.65209732991,2323.60649590586,18,9,1,1
"912350216",33,2592.41836836751,2420.89448855093,16,17,1,1
"912350217",23,2290.88657236639,2248.68783741607,12,11,1,1
"912350218",26,2377.69371104384,2305.75108410937,14,12,1,1
"912350219",24,2506.16775297983,2268.33468283819,12,12,1,1
"912350220",35,2524.23754420443,2450.1860183293,19,16,1,1
"912350221",28,2431.52409407272,2340.94327947849,18,10,1,1
"912350222",33,2224.77814025385,2420.89448855093,21,12,1,1
"912350223",16,2025.37231669744,2087.92318348224,10,6,1,1
"912350224",31,2605.99584323074,2390.15469389133,18,13,1,1
"912350225",27,2471.96920129093,2323.60649590586,15,12,1,1
"912350226",27,2660.51412018471,2323.60649590586,14,13,1,1
"912350227",29,2831.65190927041,2357.79423966008,15,14,1,1
"912350228",17,2218.05377911496,2113.95669457394,14,3,1,1
"912350229",29,2512.10068469097,2357.79423966008,16,13,1,1
"912350230",45,3279.58622739831,2579.33597919865,26,19,1,1
"912350231",37,2963.6405408416,2478.17471526668,23,14,1,1
"912350232",40,2783.65564797653,2517.98110851286,22,18,1,1
"912350233",35,2543.36220447773,2450.1860183293,23,12,1,1
"912350234",33,2497.0873102838,2420.89448855093,15,18,1,1
"912350235",36,2949.36973580838,2464.33502634194,19,17,1,1
"912350236",39,2918.71338216277,2504.98447234734,21,18,1,1
"912350237",40,3149.46473320211,2517.98110851286,22,18,1,1
"912350238",28,2444.92991127153,2340.94327947849,16,12,1,1
"912350239",35,2527.63291287576,2450.1860183293,19,16,1,1
"912350240",30,2510.01999343888,2374.18906024059,18,12,1,1
"912350241",39,2550.42253420924,2504.98447234734,20,19,1,1
"912350243",28,2486.80787919094,2340.94327947849,15,13,1,1
"912350244",20,2177.39624003217,2185.35845629437,9,11,1,1
"912350245",28,2095.0584982065,2340.94327947849,15,13,1,1
"912350246",36,2602.23426377684,2464.33502634194,20,16,1,1
"912350247",13,2002.38349349647,2001.16379457045,5,8,1,1
"912350248",22,2248.54370375175,2228.3491786518,10,12,1,1
"912350250",17,2138.89110563294,2113.95669457394,7,10,1,1
"912350252",9,1735.76583786105,1856.26587460569,3,6,1,1
"912350253",49,2726.68416381562,2624.62502504328,28,21,1,1
"912350254",49,2935.41172919103,2624.62502504328,31,18,1,1
"912350255",49,2866.97755426702,2624.62502504328,29,20,1,1
"912350256",54,2878.26099777982,2677.2712016452,26,28,1,1
"912350257",20,2202.90983361132,2185.35845629437,11,9,1,1
"912350258",18,2131.31148907826,2138.79896507223,11,7,1,1
"912350259",12,1903.35275340232,1968.69006049611,4,8,1,1
"912350260",10,1833.49464878237,1896.67490607898,6,4,1,1
"912350261",33,2378.15596191143,2420.89448855093,15,18,1,1
"912350262",27,2458.24000331875,2323.60649590586,12,15,1,1
"912350263",24,2131.38301657704,2268.33468283819,12,12,1,1
"912350264",24,2137.89733624455,2268.33468283819,14,10,1,1
"912350265",19,1995.89108039589,2162.56636020013,9,10,1,1
"912350266",12,1835.52205282642,1968.69006049611,5,7,1,1
"912350267",18,2013.55719487192,2138.79896507223,6,12,1,1
"912350268",19,1995.8104327476,2162.56636020013,8,11,1,1
"912350273",43,2658.11147637945,2555.47878346624,24,19,1,1
"912350274",26,2240.03625382891,2305.75108410937,16,10,1,1
"912350276",24,2475.667546102,2268.33468283819,14,10,1,1
"912350277",22,2390.64546603438,2228.3491786518,11,11,1,1
"912350280",34,2571.56505165899,2435.71163614839,19,15,1,1
"912350281",25,2341.17195465891,2287.34065519221,13,12,1,1
"912350282",46,2838.73543389087,2590.94954296761,26,20,1,1
"912350283",18,1987.58433357185,2138.79896507223,10,8,1,1
"912350284",40,2622.72930685716,2517.98110851286,25,15,1,1
"912350285",30,2234.34050479675,2374.18906024059,17,13,1,1
"912350286",35,2488.01475159335,2450.1860183293,20,15,1,1
"912350287",14,1954.80192755601,2031.70713799962,8,6,1,1
"912350288",57,3116.69221337902,2707.02236739438,33,24,1,1
"912350294",65,3183.54028085803,2780.67589681985,32,33,1,1
"912350295",57,2808.61916350558,2707.02236739438,30,27,1,1
"912350296",85,3571.65953706008,2937.40494579778,37,48,1,1
"912350297",92,3548.50932945318,2985.30521778333,42,50,1,1
"912350298",70,3621.90563168967,2823.11677003184,31,39,1,1
"912350299",93,3558.95419094147,2991.90921350397,46,47,1,1
"912350300",56,3452.52340935586,2697.24673169728,24,32,1,1
"912350301",46,2842.11412130475,2590.94954296761,23,23,1,1
"912350302",84,3718.65905866235,2930.30814451558,40,44,1,1
"912350303",77,3618.34745260885,2878.65357631343,36,41,1,1
"912350304",67,3321.90433456853,2797.95380131742,32,35,1,1
"912350305",67,2971.37043970485,2797.95380131742,32,35,1,1
"912350306",87,3575.47032004538,2951.40156710974,38,49,1,1
"912350307",71,3804.74804507985,2831.31372136695,36,35,1,1
"912350308",74,3502.35829595172,2855.36548874306,36,38,1,1
"912350309",79,3687.25337671069,2893.78092561085,36,43,1,1
"912350310",65,4032.34050447832,2780.67589681985,33,32,1,1
"912350311",61,3274.91480905576,2744.81051624266,31,30,1,1
"912350312",65,3261.09125015737,2780.67589681985,36,29,1,1
"912350313",30,2733.67857424708,2374.18906024059,14,16,1,1
"912350314",41,2787.79942742146,2530.72175773865,12,29,1,1
"912350315",41,2916.26639087024,2530.72175773865,18,23,1,1
"912350316",50,3280.11875656614,2635.48551585152,23,27,1,1
"912350317",65,3487.61306767951,2780.67589681985,34,31,1,1
"912350318",86,3310.80291677401,2944.43562859908,43,43,1,1
"912350319",78,2758.30174358662,2886.25582696583,33,45,1,1
"912350320",63,3093.74587082548,2762.96971264875,24,39,1,1
"912350321",63,2983.62542890354,2762.96971264875,26,37,1,1
"912350322",72,3466.6726004442,2839.4193288992,35,37,1,1
"912350323",74,3259.33137725592,2855.36548874306,36,38,1,1
"912350324",59,3037.70078315742,2726.17127719361,27,32,1,1
"912350325",59,3302.70086656655,2726.17127719361,30,29,1,1
"912350326",61,3299.8730508267,2744.81051624266,27,34,1,1
"912350327",75,2664.92506842294,2863.21031780169,31,44,1,1
"912350328",100,3367.83228232436,3036.61979185145,43,57,1,1
"912350329",65,3346.36991142048,2780.67589681985,32,33,1,1
"912350330",54,3181.39582644905,2677.2712016452,27,27,1,1
"912350331",77,3108.54339616302,2878.65357631343,39,38,1,1
"912350332",66,3046.84661558384,2789.3669207067,32,34,1,1
"912350334",32,2648.33511670196,2405.71569249515,13,19,1,1
"912350335",80,3496.95359889275,2901.2306171403,36,44,1,1
"912350336",55,2903.93503856645,2687.33120998132,24,31,1,1
"912350337",42,2709.03085321698,2543.21752514954,19,23,1,1
"912350338",26,2436.15004156123,2305.75108410937,11,15,1,1
"912350339",66,2844.88471337187,2789.3669207067,25,41,1,1
"912350340",53,2842.80561184431,2667.061866114,25,28,1,1
"912350341",96,4004.64463095049,3011.38790884243,38,58,1,1
"912350342",68,3440.43941147349,2806.43931339586,30,38,1,1
"912350343",59,3249.32190068991,2726.17127719361,30,29,1,1
"912350344",50,3088.03663473911,2635.48551585152,25,25,1,1
"912350345",72,3169.43873551029,2839.4193288992,35,37,1,1
"912350346",80,3955.10094192491,2901.2306171403,34,46,1,1
"912350347",83,3568.96199919463,2923.1438046077,37,46,1,1
"912350348",86,3689.28879644666,2944.43562859908,43,43,1,1
"912350349",65,3818.05707179953,2780.67589681985,27,38,1,1
"912350350",56,3771.32473016296,2697.24673169728,21,35,1,1
"912350351",88,3874.45987226606,2958.30409156145,39,49,1,1
"912350352",74,3167.85737629371,2855.36548874306,39,35,1,1
"912350353",52,2990.74174916183,2656.6981055205,21,31,1,1
"912350354",59,3245.12026815442,2726.17127719361,25,34,1,1
"912350355",79,3349.58516684929,2893.78092561085,38,41,1,1
"912350686",100,4105.50239186771,3036.61979185145,45,55,1,1
"912350687",59,3114.5714160206,2726.17127719361,27,32,1,1
"912350688",42,2936.47352922373,2543.21752514954,19,23,1,1
"912350806",27,1911.23940739159,2323.60649590586,15,12,1,1
"912350836",40,2708.97211567976,2517.98110851286,23,17,1,1
"912350837",45,2855.21173229334,2579.33597919865,22,23,1,1
"912350838",25,1958.37749191237,2287.34065519221,8,17,1,1
"912350851",21,2000.20742904483,2207.26116887512,7,14,1,1
"912350859",29,2616.76849611374,2357.79423966008,13,16,1,1
"912350860",21,2300.18530133912,2207.26116887512,9,12,1,1
"912350861",20,2249.51760768727,2185.35845629437,9,11,1,1
"912350862",26,2345.96895930324,2305.75108410937,11,15,1,1
"912350863",19,2135.69343849861,2162.56636020013,9,10,1,1
"912350864",21,2353.53204574094,2207.26116887512,10,11,1,1
"912350865",22,2276.23213552459,2228.3491786518,12,10,1,1
"912350866",26,2385.03503415258,2305.75108410937,13,13,1,1
"912350867",25,2310.96288922831,2287.34065519221,10,15,1,1
"912350868",24,2364.50084872513,2268.33468283819,13,11,1,1
"912350869",28,2649.50976170271,2340.94327947849,13,15,1,1
"912350870",33,2602.0080241803,2420.89448855093,14,19,1,1
"912350871",19,2177.44451030455,2162.56636020013,7,12,1,1
"912350872",21,2242.39596843999,2207.26116887512,9,12,1,1
"912350873",23,2018.2452741271,2248.68783741607,11,12,1,1
"912350874",30,2325.43815873991,2374.18906024059,14,16,1,1
"912350875",16,2024.3841119872,2087.92318348224,5,11,1,1
"912350876",15,2019.48655710952,2060.56118614118,4,11,1,1
"912350878",25,2127.55833226571,2287.34065519221,12,13,1,1
"912350879",22,2345.12567680709,2228.3491786518,12,10,1,1
"912350880",26,2409.47405575579,2305.75108410937,12,14,1,1
"912350881",24,2267.05161073628,2268.33468283819,10,14,1,1
"912351273",10,1920.67985312388,1896.67490607898,4,6,1,1
"912351274",3,1527.60869315728,1482.92019466158,2,1,1,1
"912351275",16,2175.9305903476,2087.92318348224,8,8,1,1
"912351276",9,1939.11374696457,1856.26587460569,2,7,1,1
"912351287",13,1849.29454787436,2001.16379457045,3,10,1,1
"912351288",15,1738.92428784802,2060.56118614118,2,13,1,1
"912351289",19,1871.03217658292,2162.56636020013,6,13,1,1
"912351316",76,4167.3629634955,2870.97236507783,44,32,1,1
"912351317",73,3698.89973359782,2847.4358582506,46,27,1,1
"912351318",62,3083.72972990552,2753.94837323248,32,30,1,1
"912351319",47,2859.57676532178,2602.36394728806,23,24,1,1
"912351320",39,2863.87859665712,2504.98447234734,20,19,1,1
"912351321",28,2486.2609815947,2340.94327947849,14,14,1,1
"912351322",8,1891.48492232284,1812.11073017574,3,5,1,1
"912351323",8,1822.25456260493,1812.11073017574,4,4,1,1
"912351324",9,1835.83364708935,1856.26587460569,5,4,1,1
"912351423",29,2588.59720786625,2357.79423966008,15,14,1,1
"912351424",27,2569.32103265225,2323.60649590586,21,6,1,1
"912351425",35,2787.30348687126,2450.1860183293,23,12,1,1
"912351426",30,2591.54452258819,2374.18906024059,18,12,1,1
"912351427",36,2845.64564856996,2464.33502634194,23,13,1,1
"912351428",32,2534.70849994531,2405.71569249515,22,10,1,1
"912351429",32,2521.95064570093,2405.71569249515,20,12,1,1
"912351430",32,2707.35700631034,2405.71569249515,21,11,1,1
"912351431",16,1999.10676026748,2087.92318348224,7,9,1,1
"912351432",30,2331.92521507469,2374.18906024059,18,12,1,1
"912351448",20,2140.31359952744,2185.35845629437,10,10,1,1
"912351449",15,1983.40855880371,2060.56118614118,8,7,1,1
"912351450",19,2046.6237708689,2162.56636020013,9,10,1,1
"912351451",21,2095.34659278627,2207.26116887512,10,11,1,1
"912351452",17,2061.46316000291,2113.95669457394,8,9,1,1
"912351453",24,2217.01968852552,2268.33468283819,12,12,1,1
"912351454",24,2164.76213902432,2268.33468283819,12,12,1,1
"912351455",22,2005.15521029789,2228.3491786518,9,13,1,1
"912351731",25,2627.16271244051,2287.34065519221,15,10,1,1
"912351732",21,2389.23542447203,2207.26116887512,11,10,1,1
"912351733",13,2213.94409143616,2001.16379457045,5,8,1,1
"912351734",32,2708.17459712259,2405.71569249515,17,15,1,1
"912351735",59,3134.54112429244,2726.17127719361,32,27,1,1
"912351736",43,2795.22288637997,2555.47878346624,21,22,1,1
"912351737",45,2850.52324625304,2579.33597919865,23,22,1,1
"912351738",21,2098.88508743747,2207.26116887512,9,12,1,1
"912351739",17,1997.45540210241,2113.95669457394,6,11,1,1
"912351740",17,2023.36449498748,2113.95669457394,11,6,1,1
"912351741",16,2100.87227776482,2087.92318348224,10,6,1,1
"912351742",26,2341.82372585636,2305.75108410937,13,13,1,1
"912351743",29,2227.84268717108,2357.79423966008,16,13,1,1
"912351744",40,2610.07167715785,2517.98110851286,19,21,1,1
"912351745",50,2621.7186835728,2635.48551585152,27,23,1,1
"912351746",31,2620.36940143753,2390.15469389133,18,13,1,1
"912351747",50,2898.12464644908,2635.48551585152,30,20,1,1
"912351748",48,2615.78246533221,2613.58673801098,26,22,1,1
"912351749",34,2914.71408628384,2435.71163614839,15,19,1,1
"912351750",39,2990.06489854405,2504.98447234734,17,22,1,1
"912351751",27,2485.24341863463,2323.60649590586,14,13,1,1
"912351752",27,2556.86919768705,2323.60649590586,13,14,1,1
"912351753",41,2715.35294853222,2530.72175773865,22,19,1,1
"912351754",42,2796.36030403668,2543.21752514954,19,23,1,1
"912351755",48,3144.6612877215,2613.58673801098,22,26,1,1
"912351756",52,3228.069602576,2656.6981055205,26,26,1,1
"912351757",47,3264.12284699288,2602.36394728806,21,26,1,1
"912351758",47,3351.40864361213,2602.36394728806,21,26,1,1
"912351759",39,2900.09318539547,2504.98447234734,22,17,1,1
"912351760",32,2757.60082890882,2405.71569249515,16,16,1,1
"912351761",50,2659.33462423134,2635.48551585152,28,22,1,1
"912351762",49,2924.48145291058,2624.62502504328,31,18,1,1
"912351764",25,2339.61925614609,2287.34065519221,15,10,1,1
"912351766",21,2233.29447269113,2207.26116887512,13,8,1,1
"912351767",33,2457.98805492549,2420.89448855093,20,13,1,1
"912351768",25,2366.12117572981,2287.34065519221,16,9,1,1
"912351769",34,2482.96907270189,2435.71163614839,20,14,1,1
"912351770",42,2685.86812304719,2543.21752514954,31,11,1,1
"912351771",58,2797.79339878431,2716.66249357165,37,21,1,1
"912351772",49,3065.5702344363,2624.62502504328,24,25,1,1
"912351773",31,2768.01508540362,2390.15469389133,14,17,1,1
"912351774",39,2941.71276428771,2504.98447234734,18,21,1,1
"912351775",45,3029.14928829801,2579.33597919865,17,28,1,1
"912351776",48,3193.44368912409,2613.58673801098,21,27,1,1
"912351777",45,3331.43011033703,2579.33597919865,23,22,1,1
"912351778",36,2723.1787790374,2464.33502634194,18,18,1,1
"912351779",47,3161.96043435416,2602.36394728806,22,25,1,1
"912351780",42,2694.62902646339,2543.21752514954,19,23,1,1
"912351781",64,4119.14260195687,2771.87783482774,28,36,1,1
"912351782",56,3465.92756370917,2697.24673169728,30,26,1,1
"912351783",42,2993.84594614145,2543.21752514954,23,19,1,1
"912351784",62,3357.2644948561,2753.94837323248,30,32,1,1
"912351785",49,3100.03817827657,2624.62502504328,22,27,1,1
"912351786",35,2611.39457724822,2450.1860183293,22,13,1,1
"912351787",30,2528.65631590387,2374.18906024059,19,11,1,1
"912351788",41,2523.85204746167,2530.72175773865,22,19,1,1
"912351789",39,2531.20797561501,2504.98447234734,23,16,1,1
"912351790",51,3074.75248581816,2646.17454577679,29,22,1,1
"912351791",52,2740.03809026907,2656.6981055205,28,24,1,1
"912351792",39,2939.29391828593,2504.98447234734,15,24,1,1
"912351793",46,2966.82259601176,2590.94954296761,20,26,1,1
"912351794",54,3449.7966836469,2677.2712016452,23,31,1,1
"912351795",54,3372.73850608171,2677.2712016452,27,27,1,1
"912351796",40,2728.13421660215,2517.98110851286,20,20,1,1
"912351797",35,2774.52984723809,2450.1860183293,18,17,1,1
"912351798",44,3295.42463746077,2567.51523707907,18,26,1,1
"912351799",31,2513.38825213466,2390.15469389133,14,17,1,1
"912351801",37,2434.22118478181,2478.17471526668,18,19,1,1
"912351802",42,2415.15765005588,2543.21752514954,25,17,1,1
"912351804",21,2290.87543448604,2207.26116887512,11,10,1,1
"912351805",17,2072.61530612618,2113.95669457394,8,9,1,1
"912351806",26,2381.16672728408,2305.75108410937,16,10,1,1
"912351807",22,2231.80066729096,2228.3491786518,13,9,1,1
"912351808",30,2230.33606900068,2374.18906024059,14,16,1,1
"912351809",45,2495.77597902432,2579.33597919865,30,15,1,1
"912351810",43,2543.67452537964,2555.47878346624,25,18,1,1
"912351811",43,2746.47007185091,2555.47878346624,30,13,1,1
"912351812",28,2817.9515168125,2340.94327947849,14,14,1,1
"912351813",39,2644.34121102376,2504.98447234734,15,24,1,1
"912351814",41,2986.28660899135,2530.72175773865,22,19,1,1
"912351815",38,2968.27779612219,2491.71993967651,14,24,1,1
"912351816",42,2978.68103351956,2543.21752514954,15,27,1,1
"912351817",47,3284.59432240234,2602.36394728806,23,24,1,1
"912351818",53,3230.01755361453,2667.061866114,26,27,1,1
"912351819",65,3300.32573620285,2780.67589681985,36,29,1,1
"912351820",48,2868.40050775576,2613.58673801098,24,24,1,1
"912351821",45,3086.30825481114,2579.33597919865,25,20,1,1
"912351822",51,3367.755874004,2646.17454577679,25,26,1,1
"912351823",37,2404.85891812503,2478.17471526668,24,13,1,1
"912351824",37,2410.17521977475,2478.17471526668,26,11,1,1
"912351825",51,2552.43115019264,2646.17454577679,35,16,1,1
"912351826",39,2612.07000460543,2504.98447234734,26,13,1,1
"912351827",40,2601.85222335931,2517.98110851286,24,16,1,1
"912351828",41,2739.52304273294,2530.72175773865,25,16,1,1
"912351829",44,2775.03406781464,2567.51523707907,28,16,1,1
"912351830",32,2484.50798418589,2405.71569249515,20,12,1,1
"912351831",54,2689.55100014973,2677.2712016452,28,26,1,1
"912351832",55,2566.73621957101,2687.33120998132,32,23,1,1
"912351833",30,2214.84399032386,2374.18906024059,18,12,1,1
"912351834",36,2314.78038936095,2464.33502634194,22,14,1,1
"912351835",43,2816.23732332352,2555.47878346624,24,19,1,1
"912351836",37,2491.12066443698,2478.17471526668,22,15,1,1
"912351837",45,2832.9443684933,2579.33597919865,29,16,1,1
"912351838",40,2539.40040306943,2517.98110851286,23,17,1,1
"912351839",38,2613.71554092397,2491.71993967651,22,16,1,1
"912351840",41,2613.15388718182,2530.72175773865,25,16,1,1
"912351841",49,2720.70028662058,2624.62502504328,32,17,1,1
"912351842",53,2700.22069943477,2667.061866114,31,22,1,1
"912351843",43,2608.17343028735,2555.47878346624,26,17,1,1
"912351844",47,2631.62746279267,2602.36394728806,29,18,1,1
"912351845",42,2545.249685827,2543.21752514954,20,22,1,1
"912351846",37,2584.55302175395,2478.17471526668,20,17,1,1
"912351847",33,2469.05682240889,2420.89448855093,20,13,1,1
"912351848",39,2590.37073513485,2504.98447234734,26,13,1,1
"912351849",39,2404.85116626669,2504.98447234734,23,16,1,1
"912351850",31,2477.43281647454,2390.15469389133,19,12,1,1
"912351851",41,2816.8458003827,2530.72175773865,29,12,1,1
"912351852",26,2482.12113538558,2305.75108410937,14,12,1,1
"912351853",31,2302.15271958772,2390.15469389133,17,14,1,1
"912351854",31,2437.7499644714,2390.15469389133,14,17,1,1
"912351855",37,2882.50496552896,2478.17471526668,17,20,1,1
"912351856",34,2785.05561045852,2435.71163614839,14,20,1,1
"912351857",35,2666.46560617448,2450.1860183293,15,20,1,1
"912351858",50,3121.78226363347,2635.48551585152,21,29,1,1
"912351859",28,2626.71099261463,2340.94327947849,14,14,1,1
"912351860",34,2564.94693542054,2435.71163614839,17,17,1,1
"912351861",40,3090.58464466658,2517.98110851286,23,17,1,1
"912351862",34,2974.70759242509,2435.71163614839,16,18,1,1
"912351863",48,2873.34951323197,2613.58673801098,25,23,1,1
"912351864",41,2798.70999525346,2530.72175773865,19,22,1,1
"912351865",38,2748.22078949707,2491.71993967651,19,19,1,1
"912351866",39,2636.94829550209,2504.98447234734,20,19,1,1
"912351867",47,2827.54543005442,2602.36394728806,28,19,1,1
"912351868",43,2871.56808377466,2555.47878346624,27,16,1,1
"912351869",50,2721.10742449388,2635.48551585152,30,20,1,1
"912351870",27,2350.55216378358,2323.60649590586,19,8,1,1
"912351871",33,2580.12690351436,2420.89448855093,17,16,1,1
"912351872",45,3117.72827447576,2579.33597919865,22,23,1,1
"912351873",42,3045.20238154158,2543.21752514954,21,21,1,1
"912351874",36,2854.95480083614,2464.33502634194,19,17,1,1
"912351875",46,3140.89511714497,2590.94954296761,23,23,1,1
"912351876",35,2823.6456885818,2450.1860183293,18,17,1,1
"912351877",74,3812.40681228203,2855.36548874306,29,45,1,1
"912351878",59,3084.997544971,2726.17127719361,24,35,1,1
"912351879",56,2914.1601000534,2697.24673169728,20,36,1,1
"912351880",48,3019.69949585542,2613.58673801098,20,28,1,1
"912351881",46,2914.58988244017,2590.94954296761,21,25,1,1
"912351882",53,3405.06334968704,2667.061866114,25,28,1,1
"912351883",43,3311.21614206441,2555.47878346624,16,27,1,1
"912351884",55,3339.67468503926,2687.33120998132,25,30,1,1
"912351885",61,3333.77575406427,2744.81051624266,26,35,1,1
"912351886",38,2694.92200009015,2491.71993967651,20,18,1,1
"912351887",62,3166.47231448576,2753.94837323248,31,31,1,1
"912351888",43,2987.83076757311,2555.47878346624,17,26,1,1
"912351889",44,2863.54835257567,2567.51523707907,16,28,1,1
"912351890",70,3626.87266504533,2823.11677003184,31,39,1,1
"912351891",62,3450.22200696745,2753.94837323248,28,34,1,1
"912351892",45,2773.59421317018,2579.33597919865,18,27,1,1
"912351893",53,3338.94421047433,2667.061866114,24,29,1,1
"912351894",56,3342.92360461865,2697.24673169728,31,25,1,1
"912351895",65,3228.46768755223,2780.67589681985,28,37,1,1
"912351896",45,3415.67531133176,2579.33597919865,20,25,1,1
"912351897",48,3285.81684680353,2613.58673801098,22,26,1,1
"912351898",51,3156.59392152475,2646.17454577679,14,37,1,1
"912351899",55,3396.80257583665,2687.33120998132,21,34,1,1
"912351900",57,3228.59485503827,2707.02236739438,20,37,1,1
"912351901",54,3205.85186235854,2677.2712016452,21,33,1,1
"912351902",40,2811.56987117076,2517.98110851286,20,20,1,1
"912351903",44,2952.48819178505,2567.51523707907,18,26,1,1
"912351904",39,2606.0886082178,2504.98447234734,19,20,1,1
"912351905",51,3108.1231644973,2646.17454577679,25,26,1,1
"912351906",37,2824.24298050376,2478.17471526668,16,21,1,1
"912351907",36,2695.38173943972,2464.33502634194,15,21,1,1
"912351908",44,3147.00905203991,2567.51523707907,23,21,1,1
"912351909",43,2980.42816655983,2555.47878346624,20,23,1,1
"912351910",46,2942.01428440605,2590.94954296761,19,27,1,1
"912351911",61,3626.2820468857,2744.81051624266,27,34,1,1
"912351912",56,3870.63614966597,2697.24673169728,24,32,1,1
"912351913",42,3097.20556736608,2543.21752514954,21,21,1,1
"912351914",54,3214.58779301198,2677.2712016452,23,31,1,1
"912351915",44,2937.72955550412,2567.51523707907,18,26,1,1
"912351916",34,2603.302915277,2435.71163614839,12,22,1,1
"912351917",52,3169.03818190818,2656.6981055205,20,32,1,1
"912351918",41,2876.87166194745,2530.72175773865,20,21,1,1
"912351919",42,2818.95559371311,2543.21752514954,21,21,1,1
"912351920",46,2868.10916731106,2590.94954296761,21,25,1,1
"912351921",49,3421.20800338114,2624.62502504328,20,29,1,1
"912351922",38,2903.78229505307,2491.71993967651,18,20,1,1
"912351923",49,3529.8195512422,2624.62502504328,22,27,1,1
"912351924",52,3270.62802064704,2656.6981055205,24,28,1,1
"912351925",53,3321.3029863644,2667.061866114,26,27,1,1
"912351926",42,2767.22609914129,2543.21752514954,18,24,1,1
"912351927",52,3292.31610070246,2656.6981055205,24,28,1,1
"912351928",29,2688.57118364817,2357.79423966008,11,18,1,1
"912351929",38,2995.90355368094,2491.71993967651,16,22,1,1
"912351930",51,3294.34066327529,2646.17454577679,24,27,1,1
"912351931",56,3344.49048102508,2697.24673169728,23,33,1,1
"912351932",66,3146.66262771384,2789.3669207067,24,42,1,1
"912351933",57,3045.08698512932,2707.02236739438,19,38,1,1
"912351934",53,3043.16747685268,2667.061866114,20,33,1,1
"912351935",46,2964.73081062308,2590.94954296761,16,30,1,1
"912351936",52,3156.3175660736,2656.6981055205,20,32,1,1
"912351937",59,3374.29642282128,2726.17127719361,24,35,1,1
"912351938",59,3301.28683704453,2726.17127719361,24,35,1,1
"912351939",49,2898.19889678093,2624.62502504328,16,33,1,1
"912351940",47,2954.8406774471,2602.36394728806,19,28,1,1
"912351941",38,2920.42946822346,2491.71993967651,16,22,1,1
"912351942",30,2416.61737352666,2374.18906024059,14,16,1,1
"912351943",53,3178.49845121527,2667.061866114,24,29,1,1
"912351944",42,2960.75680980724,2543.21752514954,17,25,1,1
"912351945",49,3158.71714914119,2624.62502504328,21,28,1,1
"912351946",41,2861.46913298535,2530.72175773865,18,23,1,1
"912351947",61,3351.30106852389,2744.81051624266,30,31,1,1
"912351948",39,3031.37643236704,2504.98447234734,18,21,1,1
"912351949",59,3074.12796318111,2726.17127719361,23,36,1,1
"912351950",54,3264.8731785915,2677.2712016452,22,32,1,1
"912351951",56,3110.59943926194,2697.24673169728,26,30,1,1
"912351952",45,2689.21484046759,2579.33597919865,16,29,1,1
"912351953",65,3663.61586477668,2780.67589681985,27,38,1,1
"912351954",61,3307.12068582529,2744.81051624266,27,34,1,1
"912351955",61,3413.40780495919,2744.81051624266,25,36,1,1
"912351956",52,3761.87765968913,2656.6981055205,21,31,1,1
"912351957",41,2739.82816221318,2530.72175773865,19,22,1,1
"912351958",42,2921.26485009246,2543.21752514954,17,25,1,1
"912351959",60,3263.59035065492,2735.5526890818,21,39,1,1
"912351960",37,2957.06378425732,2478.17471526668,16,21,1,1
"912351961",38,2555.10538115111,2491.71993967651,15,23,1,1
"912351962",41,2677.34845627495,2530.72175773865,20,21,1,1
"912351963",47,2824.88024827031,2602.36394728806,18,29,1,1
"912351964",35,2736.63755524603,2450.1860183293,17,18,1,1
"912351965",71,3486.59840945975,2831.31372136695,28,43,1,1
"912351966",59,3161.40064868733,2726.17127719361,23,36,1,1
"912351967",40,2829.7902982459,2517.98110851286,17,23,1,1
"912351968",27,2508.85756374349,2323.60649590586,12,15,1,1
"912351969",37,2835.4739169259,2478.17471526668,17,20,1,1
"912351970",34,2865.07795721368,2435.71163614839,16,18,1,1
"912351971",68,3098.15836139707,2806.43931339586,23,45,1,1
"912351972",59,3183.65092364199,2726.17127719361,19,40,1,1
"912351973",50,3217.71009055248,2635.48551585152,22,28,1,1
"912351974",44,3016.57578521624,2567.51523707907,21,23,1,1
"912351975",62,3336.62182959684,2753.94837323248,28,34,1,1
"912351976",50,3175.95286515929,2635.48551585152,23,27,1,1
"912351977",27,2265.78294826705,2323.60649590586,14,13,1,1
"912351978",21,2224.33925584285,2207.26116887512,12,9,1,1
"912351979",23,2097.49179412153,2248.68783741607,11,12,1,1
"912351980",28,2253.6401248702,2340.94327947849,14,14,1,1
"912351981",19,2235.22735565931,2162.56636020013,9,10,1,1
"912351982",18,2217.1917538374,2138.79896507223,10,8,1,1
"912351983",23,2380.47113577975,2248.68783741607,10,13,1,1
"912351984",30,2349.46104582368,2374.18906024059,15,15,1,1
"912351985",28,2246.76433995126,2340.94327947849,12,16,1,1
"912351986",30,2692.2403384134,2374.18906024059,13,17,1,1
"912351987",29,2736.74444375267,2357.79423966008,17,12,1,1
"912351988",76,3842.17115447411,2870.97236507783,34,42,1,1
"912351989",66,3506.78489833679,2789.3669207067,31,35,1,1
"912351990",23,2281.9578633675,2248.68783741607,12,11,1,1
"912351991",23,2275.10856304214,2248.68783741607,11,12,1,1
"912351992",23,2122.30503079809,2248.68783741607,11,12,1,1
"912351993",26,2244.42839621319,2305.75108410937,11,15,1,1
"912351994",55,3450.87275616724,2687.33120998132,26,29,1,1
"912351995",53,3065.75139121593,2667.061866114,22,31,1,1
"912351996",43,2790.26108347348,2555.47878346624,20,23,1,1
"912351997",51,2855.75654595729,2646.17454577679,23,28,1,1
"912351998",46,3134.59512620833,2590.94954296761,22,24,1,1
"912351999",49,3208.59678305941,2624.62502504328,22,27,1,1
"912352000",48,3321.80613685753,2613.58673801098,17,31,1,1
"912352001",47,3214.01206104835,2602.36394728806,21,26,1,1
"912352002",37,2972.19751581113,2478.17471526668,20,17,1,1
"912352003",40,2878.22252236201,2517.98110851286,16,24,1,1
"912352004",57,2826.04152299507,2707.02236739438,29,28,1,1
"912352005",76,3168.93843922565,2870.97236507783,34,42,1,1
"912352006",69,3663.98036191954,2814.82611826518,24,45,1,1
"912352007",66,4108.34950429605,2789.3669207067,25,41,1,1
"912352008",54,3363.56338998803,2677.2712016452,19,35,1,1
"912352009",61,3200.73282956623,2744.81051624266,22,39,1,1
"912352010",59,3648.49451002549,2726.17127719361,19,40,1,1
"912352011",48,3447.11497840824,2613.58673801098,19,29,1,1
"912352012",64,2848.95739037456,2771.87783482774,30,34,1,1
"912352013",63,2606.88142646347,2762.96971264875,28,35,1,1
"912352014",66,2922.66475302283,2789.3669207067,23,43,1,1
"912352015",47,2860.53788449942,2602.36394728806,23,24,1,1
"912352016",33,2737.73714512839,2420.89448855093,16,17,1,1
"912352017",23,2334.47517226017,2248.68783741607,13,10,1,1
"912352018",60,3362.18816336489,2735.5526890818,28,32,1,1
"912352019",44,2784.4274006592,2567.51523707907,23,21,1,1
"912352020",57,3065.65921329726,2707.02236739438,25,32,1,1
"912352021",52,3736.11948688899,2656.6981055205,24,28,1,1
"912352022",57,3001.15887583651,2707.02236739438,28,29,1,1
"912352023",41,2768.24102327901,2530.72175773865,21,20,1,1
"912352024",72,2951.6995749603,2839.4193288992,34,38,1,1
"912352025",67,3516.87304561857,2797.95380131742,27,40,1,1
"912352026",68,3680.32025056371,2806.43931339586,27,41,1,1
"912352027",47,2927.6513718605,2602.36394728806,15,32,1,1
"912352028",48,3033.26973076209,2613.58673801098,24,24,1,1
"912352029",57,3515.59964853018,2707.02236739438,21,36,1,1
"912352030",55,2579.90838528912,2687.33120998132,27,28,1,1
"912352031",62,2721.77389674577,2753.94837323248,30,32,1,1
"912352032",62,2837.88548524858,2753.94837323248,31,31,1,1
"912352033",56,2500.29466302459,2697.24673169728,22,34,1,1
"912352034",60,2975.79205502789,2735.5526890818,27,33,1,1
"912352035",67,3052.80668913558,2797.95380131742,36,31,1,1
"912352036",55,3704.09615778105,2687.33120998132,25,30,1,1
"912352037",46,3162.96438283333,2590.94954296761,25,21,1,1
"912352038",32,2791.47081869346,2405.71569249515,10,22,1,1
"912352039",53,3560.30660158575,2667.061866114,25,28,1,1
"912352040",47,3064.7927774335,2602.36394728806,21,26,1,1
"912352041",55,3291.34205800621,2687.33120998132,25,30,1,1
"912352042",66,3471.83034691702,2789.3669207067,29,37,1,1
"912352043",84,3295.2281839631,2930.30814451558,40,44,1,1
"912352044",55,3365.62457359961,2687.33120998132,21,34,1,1
"912352045",49,3264.25870325077,2624.62502504328,23,26,1,1
"912352046",32,2474.81301051482,2405.71569249515,15,17,1,1
"912352047",39,2718.43891552676,2504.98447234734,21,18,1,1
"912352048",27,2337.68710516183,2323.60649590586,11,16,1,1
"912352049",36,2466.28781345667,2464.33502634194,16,20,1,1
"912352050",27,2437.41600268358,2323.60649590586,12,15,1,1
"912352051",36,2646.13237088838,2464.33502634194,11,25,1,1
"912352052",14,1850.36285471523,2031.70713799962,5,9,1,1
"912352053",30,2378.74777104067,2374.18906024059,13,17,1,1
"912352054",53,3038.93858035594,2667.061866114,21,32,1,1
"912352055",45,3226.65416658507,2579.33597919865,24,21,1,1
"912352056",59,3182.77241772089,2726.17127719361,27,32,1,1
"912352057",63,2890.0555234696,2762.96971264875,26,37,1,1
"912352058",37,2610.24931376911,2478.17471526668,18,19,1,1
"912352059",39,2629.80356617974,2504.98447234734,21,18,1,1
"912352060",46,3179.54167325479,2590.94954296761,23,23,1,1
"912352061",47,2873.50106162023,2602.36394728806,23,24,1,1
"912352062",2,1373.38353544474,1364.97646362037,1,1,1,1
"912352063",62,2870.35809422718,2753.94837323248,29,33,1,1
"912352064",46,2840.08317531274,2590.94954296761,19,27,1,1
"912352065",33,2411.65754754354,2420.89448855093,19,14,1,1
"912352066",45,2499.76570536201,2579.33597919865,24,21,1,1
"912352067",25,2191.56846568885,2287.34065519221,13,12,1,1
"912352068",22,2189.67562971348,2228.3491786518,12,10,1,1
"912352069",29,2263.48870951199,2357.79423966008,16,13,1,1
"912352070",39,2424.5052431409,2504.98447234734,22,17,1,1
"912352071",40,2478.86340221709,2517.98110851286,21,19,1,1
"912352072",30,2375.72194578934,2374.18906024059,16,14,1,1
"912352073",50,3256.59275693844,2635.48551585152,18,32,1,1
"912352074",40,2766.07622162998,2517.98110851286,17,23,1,1
"912352075",62,4167.30423393399,2753.94837323248,27,35,1,1
"912352076",32,2799.3853253238,2405.71569249515,16,16,1,1
"912352077",40,2902.98965746816,2517.98110851286,17,23,1,1
"912352078",35,2573.71429236187,2450.1860183293,17,18,1,1
"912352079",40,2695.42564795475,2517.98110851286,14,26,1,1
"912352080",33,2531.15567008049,2420.89448855093,15,18,1,1
"912352081",49,3182.0795875619,2624.62502504328,18,31,1,1
"912352082",39,3090.96527031237,2504.98447234734,17,22,1,1
"912352083",48,2904.22456972056,2613.58673801098,25,23,1,1
"912352084",52,2893.31287456737,2656.6981055205,30,22,1,1
"912352085",69,3256.49283343051,2814.82611826518,36,33,1,1
"912352086",19,2321.24533461259,2162.56636020013,11,8,1,1
"912352087",50,2949.03040219149,2635.48551585152,28,22,1,1
"912352088",41,2829.67759188083,2530.72175773865,22,19,1,1
"912352089",75,2959.50342477938,2863.21031780169,37,38,1,1
"912352090",65,3014.61232459363,2780.67589681985,30,35,1,1
"912352091",70,3180.34849064804,2823.11677003184,38,32,1,1
"912352092",49,3106.05110954774,2624.62502504328,25,24,1,1
"912352094",62,3032.77082015161,2753.94837323248,27,35,1,1
"912352095",49,3133.49450544858,2624.62502504328,25,24,1,1
"912352096",36,2921.84833383297,2464.33502634194,16,20,1,1
"912352097",62,3307.77507631905,2753.94837323248,28,34,1,1
"912352098",72,3513.9060692873,2839.4193288992,32,40,1,1
"912352099",30,2329.59021253518,2374.18906024059,14,16,1,1
"912352100",79,3198.31250889047,2893.78092561085,37,42,1,1
"912352101",47,3095.15231629958,2602.36394728806,18,29,1,1
"912352103",29,2457.67259934699,2357.79423966008,15,14,1,1
"912352104",32,2625.31938187855,2405.71569249515,14,18,1,1
"912352105",51,3439.86727345451,2646.17454577679,19,32,1,1
"912352106",42,3114.04866955385,2543.21752514954,17,25,1,1
"912352107",59,3360.80057640782,2726.17127719361,24,35,1,1
"912352108",45,3014.89128786288,2579.33597919865,21,24,1,1
"912352109",38,2723.78878680802,2491.71993967651,16,22,1,1
"912352110",38,2476.69746507355,2491.71993967651,16,22,1,1
"912352111",49,3149.25000487021,2624.62502504328,20,29,1,1
"912352112",58,3058.59631947103,2716.66249357165,23,35,1,1
"912352113",64,3449.60255967851,2771.87783482774,28,36,1,1
"912352114",45,2693.49517178431,2579.33597919865,22,23,1,1
"912352115",49,2724.09865903042,2624.62502504328,19,30,1,1
"912352116",73,3515.02257497989,2847.4358582506,37,36,1,1
"912352117",38,2808.66747405061,2491.71993967651,18,20,1,1
"912352118",61,2549.86921150387,2744.81051624266,29,32,1,1
"912352119",39,2794.01018222204,2504.98447234734,20,19,1,1
"912352120",56,2741.63906300535,2697.24673169728,26,30,1,1
"912352121",71,3205.17156682362,2831.31372136695,32,39,1,1
"912352122",64,3003.94994547489,2771.87783482774,34,30,1,1
"912352123",54,2866.0627014964,2677.2712016452,30,24,1,1
"912352124",62,3151.01272370619,2753.94837323248,27,35,1,1
"912352125",61,3507.98886966092,2744.81051624266,27,34,1,1
"912352126",73,3316.22716600348,2847.4358582506,28,45,1,1
"912352127",54,3113.88778880109,2677.2712016452,24,30,1,1
"912352128",40,2712.35620385383,2517.98110851286,15,25,1,1
"912352129",63,3548.40265087376,2762.96971264875,25,38,1,1
"912352130",53,3128.75279586765,2667.061866114,24,29,1,1
"912352131",42,3112.73504627689,2543.21752514954,19,23,1,1
"912352132",75,3466.98198427525,2863.21031780169,31,44,1,1
"912352133",88,3900.71580527254,2958.30409156145,35,53,1,1
"912352134",41,3009.70781012944,2530.72175773865,20,21,1,1
"912352187",8,1822.25456260493,1812.11073017574,4,4,1,1
"912352188",9,1835.83364708935,1856.26587460569,5,4,1,1
"912352274",57,2809.960867021,2707.02236739438,29,28,1,1
"912352275",51,3044.95437886247,2646.17454577679,28,23,1,1
"912352280",49,3016.40436067953,2624.62502504328,26,23,1,1
"912352286",55,2985.50063354519,2687.33120998132,25,30,1,1
"912352287",55,3143.73234261484,2687.33120998132,26,29,1,1
"912352290",54,2908.95516054389,2677.2712016452,25,29,1,1
"912352291",52,2549.91333615635,2656.6981055205,28,24,1,1
"912352292",28,1976.08580071398,2340.94327947849,13,15,1,1
"912352294",40,2837.01436075395,2517.98110851286,15,25,1,1
"912352527",38,2600.4305649905,2491.71993967651,23,15,1,1
"912352528",33,2496.0947865523,2420.89448855093,19,14,1,1
"912352529",53,2664.37418883357,2667.061866114,29,24,1,1
"912352531",36,2471.89417824186,2464.33502634194,18,18,1,1
"912352532",28,2457.97784724697,2340.94327947849,13,15,1,1
"912352533",20,1998.10498003687,2185.35845629437,10,10,1,1
"912352534",26,2318.65440016423,2305.75108410937,12,14,1,1
"912352633",58,3554.2723622853,2716.66249357165,31,27,1,1
"912352634",34,2667.89322169256,2435.71163614839,15,19,1,1
"912352635",46,2929.97544156279,2590.94954296761,23,23,1,1
"912352636",36,2645.88848511665,2464.33502634194,19,17,1,1
"912352637",34,2874.18215244933,2435.71163614839,18,16,1,1
"912352638",22,2311.68716515978,2228.3491786518,11,11,1,1
"912352639",19,2234.25080295833,2162.56636020013,8,11,1,1
"912352640",29,2337.49137913835,2357.79423966008,14,15,1,1
"912352641",6,1723.74491446402,1708.62817714657,2,4,1,1
"912352642",35,2645.20576364551,2450.1860183293,15,20,1,1
"912352643",32,2682.49979795898,2405.71569249515,14,18,1,1
"912352644",41,2774.42847218366,2530.72175773865,18,23,1,1
"912352645",39,2542.35529965103,2504.98447234734,19,20,1,1
"912352646",23,2386.32001875884,2248.68783741607,9,14,1,1
"912352647",30,2476.03659712752,2374.18906024059,18,12,1,1
"912352648",54,3602.0879787111,2677.2712016452,30,24,1,1
"912352649",42,3215.27054488952,2543.21752514954,25,17,1,1
"912352650",24,2446.08691177886,2268.33468283819,14,10,1,1
"912352651",38,2897.46469025349,2491.71993967651,20,18,1,1
"912352652",24,2259.98182084882,2268.33468283819,12,12,1,1
"912352653",40,3049.57433505772,2517.98110851286,23,17,1,1
"912352654",47,2806.36940544455,2602.36394728806,25,22,1,1
"912352655",33,2790.81886462692,2420.89448855093,18,15,1,1
"912352656",23,2609.25797100981,2248.68783741607,11,12,1,1
"912352657",30,2644.72202693113,2374.18906024059,17,13,1,1
"912352658",50,3197.69134879858,2635.48551585152,26,24,1,1
"912352659",62,3405.03368560214,2753.94837323248,27,35,1,1
"912352660",27,2771.90849303191,2323.60649590586,15,12,1,1
"912352661",32,2745.05097539313,2405.71569249515,18,14,1,1
"912352662",27,2377.30993680216,2323.60649590586,10,17,1,1
"912352663",54,3013.42988998,2677.2712016452,26,28,1,1
"912352664",41,3248.80376013743,2530.72175773865,25,16,1,1
"912352665",38,2952.86074098488,2491.71993967651,20,18,1,1
"912352666",45,2677.09642163282,2579.33597919865,24,21,1,1
"912352667",23,2470.67756782688,2248.68783741607,11,12,1,1
"912352668",21,2503.4791327594,2207.26116887512,12,9,1,1
"912352669",21,2668.36588994074,2207.26116887512,14,7,1,1
"912352670",63,3473.47361297711,2762.96971264875,28,35,1,1
"912352671",55,2893.00898257191,2687.33120998132,22,33,1,1
"912352672",25,2522.1430684121,2287.34065519221,15,10,1,1
"912352673",37,2668.44034896989,2478.17471526668,22,15,1,1
"912352674",42,3033.63871729741,2543.21752514954,21,21,1,1
"912352675",21,2306.37342729867,2207.26116887512,12,9,1,1
"912352676",40,2611.65142222178,2517.98110851286,19,21,1,1
"912352677",37,2367.30879105017,2478.17471526668,21,16,1,1
"912352678",30,2594.40806999658,2374.18906024059,17,13,1,1
"912352679",33,2513.81072744303,2420.89448855093,16,17,1,1
"912352680",61,3579.7519453261,2744.81051624266,34,27,1,1
"912352681",51,3044.05781960059,2646.17454577679,29,22,1,1
"912352682",47,3133.84664934955,2602.36394728806,26,21,1,1
"912352683",31,2704.28688281284,2390.15469389133,17,14,1,1
"912352684",31,2167.13197374588,2390.15469389133,13,18,1,1
"912352685",44,3282.23920487582,2567.51523707907,27,17,1,1
"912352686",36,3015.44475597306,2464.33502634194,16,20,1,1
"912352687",37,2962.35312554846,2478.17471526668,22,15,1,1
"912352688",54,2853.85368279274,2677.2712016452,27,27,1,1
"912352689",52,3100.46857898538,2656.6981055205,27,25,1,1
"912352690",32,2731.16821536389,2405.71569249515,18,14,1,1
"912352691",34,2831.39478059787,2435.71163614839,20,14,1,1
"912352692",39,2824.73254989616,2504.98447234734,21,18,1,1
"912352693",32,2763.56499030383,2405.71569249515,15,17,1,1
"912352694",34,2771.91411980775,2435.71163614839,18,16,1,1
"912352695",45,3109.63242707219,2579.33597919865,24,21,1,1
"912352696",35,2770.37239675699,2450.1860183293,17,18,1,1
"912352697",38,2255.8592087607,2491.71993967651,17,21,1,1
"912352698",47,3268.64505886097,2602.36394728806,24,23,1,1
"912352699",32,2783.34247198764,2405.71569249515,12,20,1,1
"912352700",35,2489.29182603312,2450.1860183293,19,16,1,1
"912352701",39,2789.36793765387,2504.98447234734,24,15,1,1
"912352702",26,2793.39173439434,2305.75108410937,15,11,1,1
"912352703",36,2670.3410159891,2464.33502634194,19,17,1,1
"912352704",29,2720.24114514246,2357.79423966008,14,15,1,1
"912352705",36,2852.08753927439,2464.33502634194,18,18,1,1
"912352706",30,2758.7649716926,2374.18906024059,17,13,1,1
"912352707",33,2516.94399828804,2420.89448855093,20,13,1,1
"912352708",45,2730.88828113501,2579.33597919865,22,23,1,1
"912352709",23,2384.50286820381,2248.68783741607,11,12,1,1
"912352710",34,2631.44539195198,2435.71163614839,16,18,1,1
"912352711",41,2646.52278791167,2530.72175773865,24,17,1,1
"912352712",41,2680.81428001191,2530.72175773865,24,17,1,1
"912352713",35,2578.03203556992,2450.1860183293,17,18,1,1
"912353056",27,2553.07455706064,2323.60649590586,14,13,1,1
"912353057",28,2446.64062814974,2340.94327947849,16,12,1,1
"912353058",17,2132.40757992608,2113.95669457394,6,11,1,1
"912353059",13,2075.743023521,2001.16379457045,5,8,1,1
"912353060",10,1923.07017942333,1896.67490607898,7,3,1,1
"912353061",33,2694.45344565,2420.89448855093,14,19,1,1
"912353062",32,2647.20593958201,2405.71569249515,15,17,1,1
"912353063",19,2317.89651537074,2162.56636020013,10,9,1,1
"912353064",20,2281.11062006869,2185.35845629437,9,11,1,1
"912353065",19,2470.95278376184,2162.56636020013,11,8,1,1
"912353066",16,2188.70855120859,2087.92318348224,12,4,1,1
"912353067",28,2494.69570532648,2340.94327947849,16,12,1,1
"912353068",31,2614.5663266821,2390.15469389133,14,17,1,1
"912353295",36,2761.36020781052,2464.33502634194,17,19,1,1
"912353296",30,2380.18983446135,2374.18906024059,13,17,1,1
"912353297",32,2608.87383371654,2405.71569249515,20,12,1,1
"912353298",30,2621.50881447898,2374.18906024059,17,13,1,1
"912353299",33,2809.63481246606,2420.89448855093,17,16,1,1
"912353301",27,2541.67708720855,2323.60649590586,8,19,1,1
"912353302",22,2267.2038896785,2228.3491786518,9,13,1,1
"912353465",41,2565.56024570898,2530.72175773865,24,17,1,1
"912353466",36,2541.08072031886,2464.33502634194,21,15,1,1
"912353467",37,2604.23242135974,2478.17471526668,25,12,1,1
"912353468",44,2471.52834300515,2567.51523707907,24,20,1,1
"912353469",35,2310.07975919761,2450.1860183293,20,15,1,1
"912353470",39,2467.44994877078,2504.98447234734,23,16,1,1
"912353471",19,2092.65931567686,2162.56636020013,10,9,1,1
"912353472",18,2079.45503940829,2138.79896507223,11,7,1,1
"912353473",31,2475.11095089367,2390.15469389133,19,12,1,1
"912353474",35,2478.31368444344,2450.1860183293,15,20,1,1
"912353475",21,2187.19924752085,2207.26116887512,14,7,1,1
"912353476",29,2400.68916286641,2357.79423966008,21,8,1,1
"912353477",24,2164.0829610886,2268.33468283819,13,11,1,1
"912353478",25,2427.92748465252,2287.34065519221,14,11,1,1
"912353479",30,2153.50042588292,2374.18906024059,18,12,1,1
"912353480",23,2359.96215303361,2248.68783741607,13,10,1,1
"912353534",40,2989.15309813264,2517.98110851286,21,19,1,1
"912353535",44,2940.61861409245,2567.51523707907,24,20,1,1
"912353536",40,2634.05310359805,2517.98110851286,23,17,1,1
"912353537",33,2667.20774774937,2420.89448855093,18,15,1,1
"912353538",25,2523.37570247791,2287.34065519221,15,10,1,1
"912353539",30,2544.66852387473,2374.18906024059,19,11,1,1
"912353540",30,2710.75212635061,2374.18906024059,15,15,1,1
"912353541",27,2553.53647036171,2323.60649590586,14,13,1,1
"912353542",45,2772.7339645766,2579.33597919865,23,22,1,1
"912353543",29,2687.71027084339,2357.79423966008,17,12,1,1
"912353544",20,2635.37016583944,2185.35845629437,10,10,1,1
"912353545",20,2460.04300594703,2185.35845629437,9,11,1,1
"912353546",38,2588.00196646122,2491.71993967651,21,17,1,1
"912353547",39,2803.5035291296,2504.98447234734,24,15,1,1
"912353548",31,2690.36277770947,2390.15469389133,14,17,1,1
"912353549",23,2490.12348619503,2248.68783741607,7,16,1,1
"912353550",43,3270.84609911925,2555.47878346624,18,25,1,1
"912353551",37,2791.77387641514,2478.17471526668,18,19,1,1
"912353552",31,2591.15324979262,2390.15469389133,15,16,1,1
"912353553",29,2670.35666347944,2357.79423966008,17,12,1,1
"912353554",46,3056.08573371288,2590.94954296761,21,25,1,1
"912353555",34,2809.99580917513,2435.71163614839,19,15,1,1
"912353556",32,3061.16864904656,2405.71569249515,18,14,1,1
"912353557",31,2791.94520175409,2390.15469389133,16,15,1,1
"912353558",39,2818.48376152127,2504.98447234734,23,16,1,1
"912353559",31,2595.97227056731,2390.15469389133,16,15,1,1
"912353560",30,2531.01651159949,2374.18906024059,14,16,1,1
"912353561",38,2706.46608231034,2491.71993967651,19,19,1,1
"912353562",37,2844.31202120462,2478.17471526668,17,20,1,1
"912353563",39,2809.5301377502,2504.98447234734,17,22,1,1
"912353564",41,2760.2209162486,2530.72175773865,23,18,1,1
"912353565",39,2769.90148933493,2504.98447234734,17,22,1,1
"912353566",42,3090.70987002488,2543.21752514954,19,23,1,1
"912353567",37,2981.82382138912,2478.17471526668,17,20,1,1
"912353568",51,2929.25225770048,2646.17454577679,26,25,1,1
"912353569",45,2825.81735681087,2579.33597919865,25,20,1,1
"912353570",35,2822.20330298936,2450.1860183293,18,17,1,1
"912353571",32,2557.23679118814,2405.71569249515,17,15,1,1
"912353572",33,2735.42417565775,2420.89448855093,19,14,1,1
"912353573",40,2530.74739859798,2517.98110851286,20,20,1,1
"912353574",33,2447.86223722357,2420.89448855093,16,17,1,1
"912353575",39,2701.5710173404,2504.98447234734,17,22,1,1
"912353576",49,2871.91804497553,2624.62502504328,23,26,1,1
"912353577",28,2532.34077668312,2340.94327947849,9,19,1,1
"912353578",31,2673.43395625199,2390.15469389133,13,18,1,1
"912353579",36,3086.31290963786,2464.33502634194,16,20,1,1
"912353580",40,3414.14630972302,2517.98110851286,22,18,1,1
"912353581",45,2950.76710405869,2579.33597919865,19,26,1,1
"912353582",41,3034.40655467636,2530.72175773865,19,22,1,1
"912353583",43,2716.47807912757,2555.47878346624,24,19,1,1
"912353584",51,3141.93855365476,2646.17454577679,30,21,1,1
"912353585",34,2652.30262966471,2435.71163614839,19,15,1,1
"912353586",29,2734.85070297361,2357.79423966008,17,12,1,1
"912353587",30,2374.56229956336,2374.18906024059,19,11,1,1
"912353588",37,2572.87081375078,2478.17471526668,24,13,1,1
"912353589",38,2805.63610308389,2491.71993967651,21,17,1,1
"912353590",38,2604.00110945502,2491.71993967651,20,18,1,1
"912353591",37,2582.29875802282,2478.17471526668,25,12,1,1
"912353592",34,2713.32013012783,2435.71163614839,19,15,1,1
"912353593",41,3100.90902304804,2530.72175773865,22,19,1,1
"912353594",45,3023.87035193888,2579.33597919865,19,26,1,1
"912353595",28,2574.75858915008,2340.94327947849,18,10,1,1
"912353596",45,2909.23823334139,2579.33597919865,27,18,1,1
"912353597",44,2936.90449748399,2567.51523707907,27,17,1,1
"912353598",33,2586.67011921615,2420.89448855093,19,14,1,1
"912353599",39,2911.77700599882,2504.98447234734,22,17,1,1
"912353600",50,3166.73397299179,2635.48551585152,30,20,1,1
"912353601",58,3144.0714302253,2716.66249357165,35,23,1,1
"912353602",52,3063.69885065989,2656.6981055205,30,22,1,1
"912353603",59,3209.61432736383,2726.17127719361,25,34,1,1
"912353604",56,3279.38892093296,2697.24673169728,31,25,1,1
"912353605",48,3388.19300487396,2613.58673801098,24,24,1,1
"912353606",49,2887.67566331454,2624.62502504328,26,23,1,1
"912353608",47,2873.03059198233,2602.36394728806,26,21,1,1
"912353609",44,2554.84236494894,2567.51523707907,23,21,1,1
"912353610",31,2422.31940071543,2390.15469389133,17,14,1,1
"912353611",22,2324.68488126388,2228.3491786518,11,11,1,1
"912353612",21,2188.54407014332,2207.26116887512,12,9,1,1
"912353613",25,2326.09832346594,2287.34065519221,14,11,1,1
"912353614",36,2712.13087811282,2464.33502634194,18,18,1,1
"912353615",19,2047.6170909551,2162.56636020013,11,8,1,1
"912353616",22,2083.14614813101,2228.3491786518,12,10,1,1
"912353617",10,1875.40643662926,1896.67490607898,6,4,1,1
"912353618",8,1724.85474711551,1812.11073017574,3,5,1,1
"912353619",29,2318.99246881442,2357.79423966008,14,15,1,1
"912353620",32,2451.19147964047,2405.71569249515,20,12,1,1
"912353621",21,2315.03871582373,2207.26116887512,9,12,1,1
"912353622",8,1739.28601222453,1812.11073017574,5,3,1,1
"912353623",25,2249.57637752386,2287.34065519221,15,10,1,1
"912353624",11,1933.24058900624,1933.98659929558,6,5,1,1
"912354050",33,2688.48282617502,2420.89448855093,17,16,1,1
"912354051",33,2722.65854292734,2420.89448855093,18,15,1,1
"912354052",27,2494.35476667186,2323.60649590586,13,14,1,1
"912354053",31,2670.33281987493,2390.15469389133,16,15,1,1
"912354054",29,2475.25991338044,2357.79423966008,15,14,1,1
"912354055",36,2580.30543367086,2464.33502634194,16,20,1,1
"912354056",33,2644.7524121647,2420.89448855093,17,16,1,1
"912354057",37,2452.47925425749,2478.17471526668,17,20,1,1
"912354058",27,2454.97616156464,2323.60649590586,14,13,1,1
"912354059",32,2598.29819774308,2405.71569249515,16,16,1,1
"912354060",24,2266.66510645054,2268.33468283819,13,11,1,1
"912354061",42,2923.67171855611,2543.21752514954,21,21,1,1
"912354062",33,2657.88148071336,2420.89448855093,17,16,1,1
"912354063",29,2558.03772480928,2357.79423966008,15,14,1,1
"912354064",13,2061.08812729848,2001.16379457045,2,11,1,1
"912354065",36,3056.0375130176,2464.33502634194,20,16,1,1
"912354066",39,2843.66710991068,2504.98447234734,19,20,1,1
"912354067",38,2506.91578371022,2491.71993967651,22,16,1,1
"912354068",36,2803.65749965861,2464.33502634194,21,15,1,1
"912354069",17,2193.99309059069,2113.95669457394,7,10,1,1
"912354070",31,2232.89855851329,2390.15469389133,14,17,1,1
"912354071",8,1664.56662876395,1812.11073017574,0,8,1,1
"912354072",18,2085.99150085713,2138.79896507223,8,10,1,1
"912354073",32,2397.01838118516,2405.71569249515,16,16,1,1
"912354074",36,2535.77099473795,2464.33502634194,17,19,1,1
"912354075",25,2253.40961423327,2287.34065519221,11,14,1,1
"912354076",39,2611.4358180531,2504.98447234734,17,22,1,1
"912354077",23,2204.78443456677,2248.68783741607,10,13,1,1
"912354078",18,2260.50230599714,2138.79896507223,8,10,1,1
"912354079",16,2033.97140666464,2087.92318348224,7,9,1,1
"912354080",23,2115.27437778065,2248.68783741607,12,11,1,1
"912354081",12,2024.88230129549,1968.69006049611,6,6,1,1
"912354082",10,1926.58176802248,1896.67490607898,7,3,1,1
"912354083",13,1903.39238444116,2001.16379457045,7,6,1,1
"912354084",15,1913.5486559648,2060.56118614118,6,9,1,1
"912354085",22,2121.12719725206,2228.3491786518,13,9,1,1
"912354086",21,2319.39611050821,2207.26116887512,11,10,1,1
"912354087",16,2125.31250876802,2087.92318348224,6,10,1,1
"912354088",18,2193.52582800128,2138.79896507223,8,10,1,1
"912354089",11,1994.80138618394,1933.98659929558,5,6,1,1
"912354090",7,1739.84948946234,1763.32076508842,4,3,1,1
"912354091",25,2307.18162863691,2287.34065519221,16,9,1,1
"912354092",23,2183.71360427228,2248.68783741607,12,11,1,1
"912354093",13,2039.60333123529,2001.16379457045,6,7,1,1
"912354094",14,2033.72715850479,2031.70713799962,5,9,1,1
"912354095",11,1982.7696452794,1933.98659929558,5,6,1,1
"912354096",12,1991.11520691029,1968.69006049611,4,8,1,1
"912354097",27,2224.37693752632,2323.60649590586,14,13,1,1
"912354098",16,2009.00950906226,2087.92318348224,9,7,1,1
"912354099",22,2062.41893804078,2228.3491786518,11,11,1,1
"912354100",19,2121.90168595463,2162.56636020013,7,12,1,1
"912354101",11,1916.19357233582,1933.98659929558,7,4,1,1
"912354102",13,2022.71960811766,2001.16379457045,8,5,1,1
"912354103",22,1958.00152665469,2228.3491786518,10,12,1,1
"912354104",23,1967.06686387315,2248.68783741607,13,10,1,1
"912354105",20,1828.67681144977,2185.35845629437,11,9,1,1
"912354106",9,1795.58935444758,1856.26587460569,4,5,1,1
"912354107",9,1880.29420368202,1856.26587460569,6,3,1,1
"912354108",14,2025.20632485855,2031.70713799962,6,8,1,1
"912354109",24,2150.4394820915,2268.33468283819,10,14,1,1
"912354110",26,2180.33854227911,2305.75108410937,12,14,1,1
"912354111",30,2457.01201650915,2374.18906024059,18,12,1,1
"912354112",20,2168.5285870177,2185.35845629437,9,11,1,1
"912354113",18,2122.2828392008,2138.79896507223,8,10,1,1
"912354114",16,2149.99040166,2087.92318348224,8,8,1,1
"912354115",28,2372.02204501485,2340.94327947849,18,10,1,1
"912354116",23,2343.53298820632,2248.68783741607,12,11,1,1
"912354117",21,2297.05366209873,2207.26116887512,10,11,1,1
"912354118",32,2647.43835979803,2405.71569249515,18,14,1,1
"912354119",20,2242.14939557781,2185.35845629437,7,13,1,1
"912354120",14,2043.48137663942,2031.70713799962,9,5,1,1
"912354121",18,2254.30091795588,2138.79896507223,9,9,1,1
"912354122",19,2157.07958928581,2162.56636020013,12,7,1,1
"912354123",22,2220.39387579393,2228.3491786518,10,12,1,1
"912354124",12,1967.58414915633,1968.69006049611,7,5,1,1
"912354125",11,1944.241603476,1933.98659929558,6,5,1,1
"912354126",10,2021.68530953731,1896.67490607898,6,4,1,1
"912354127",19,1974.09995802401,2162.56636020013,9,10,1,1
"912354128",15,1899.59168480869,2060.56118614118,5,10,1,1
"912354129",23,2067.80755077078,2248.68783741607,11,12,1,1
"912354130",12,1934.78920274911,1968.69006049611,4,8,1,1
"912354131",31,2740.05449997467,2390.15469389133,15,16,1,1
"912354132",31,2592.93777509637,2390.15469389133,14,17,1,1
"912354133",22,2121.34379755715,2228.3491786518,6,16,1,1
"912354134",32,2604.62990771796,2405.71569249515,13,19,1,1
"912354135",38,2319.24473073967,2491.71993967651,17,21,1,1
"912354136",34,2430.65292267002,2435.71163614839,14,20,1,1
"912354137",35,2406.51547187338,2450.1860183293,11,24,1,1
"912354138",25,2326.74441458811,2287.34065519221,11,14,1,1
"912354139",29,2337.50002790321,2357.79423966008,10,19,1,1
"912354140",25,2456.55737742385,2287.34065519221,11,14,1,1
"912354141",25,2366.24944478443,2287.34065519221,10,15,1,1
"912354142",13,1920.92819808999,2001.16379457045,1,12,1,1
"912354143",29,2311.21639630513,2357.79423966008,11,18,1,1
"912354151",14,2134.88928150128,2031.70713799962,8,6,1,1
"912354152",20,2383.36322105905,2185.35845629437,11,9,1,1
"912354153",16,2164.84063135871,2087.92318348224,10,6,1,1
"912354154",17,2184.01838564613,2113.95669457394,9,8,1,1
"912354155",25,2346.0977680784,2287.34065519221,14,11,1,1
"912354156",21,2101.20083559746,2207.26116887512,11,10,1,1
"912354157",20,2222.01849851746,2185.35845629437,11,9,1,1
"912354178",46,3034.23457635834,2590.94954296761,26,20,1,1
"912354179",36,2895.39299396751,2464.33502634194,18,18,1,1
"912354180",32,2605.39203745927,2405.71569249515,17,15,1,1
"912354181",19,2219.49832069097,2162.56636020013,9,10,1,1
"912354182",47,3256.35070517394,2602.36394728806,28,19,1,1
"912354183",54,3097.39037899322,2677.2712016452,31,23,1,1
"912354184",50,3410.97407953817,2635.48551585152,25,25,1,1
"912354186",57,3240.07850547007,2707.02236739438,30,27,1,1
"912354187",62,3526.70073330784,2753.94837323248,31,31,1,1
"912354188",45,3149.21669333502,2579.33597919865,24,21,1,1
"912354189",46,2862.51017982011,2590.94954296761,22,24,1,1
"912354190",58,3466.06052664842,2716.66249357165,37,21,1,1
"912354191",55,3029.00231771976,2687.33120998132,30,25,1,1
"912354192",19,2173.74597374901,2162.56636020013,7,12,1,1
"912354193",19,2233.50662319034,2162.56636020013,10,9,1,1
"912354194",45,2763.60596291687,2579.33597919865,17,28,1,1
"912354195",36,2692.19171969634,2464.33502634194,19,17,1,1
"912354196",36,2850.98004138667,2464.33502634194,17,19,1,1
"912354197",44,3174.87724748783,2567.51523707907,21,23,1,1
"912354198",37,2746.25596497234,2478.17471526668,21,16,1,1
"912354199",40,2614.66507806267,2517.98110851286,24,16,1,1
"912354200",50,2858.31546561006,2635.48551585152,23,27,1,1
"912354201",51,2823.88098052603,2646.17454577679,21,30,1,1
"912354202",63,3205.88151324521,2762.96971264875,33,30,1,1
"912354203",50,3069.70696829191,2635.48551585152,29,21,1,1
"912354204",42,2804.59517316554,2543.21752514954,22,20,1,1
"912354205",45,2563.0402506137,2579.33597919865,24,21,1,1
"912354206",73,3077.16756930517,2847.4358582506,32,41,1,1
"912354207",78,3400.3054051124,2886.25582696583,39,39,1,1
"912354208",49,2912.87332339129,2624.62502504328,27,22,1,1
"912354209",36,2651.98823415604,2464.33502634194,19,17,1,1
"912354210",60,3331.63556403403,2735.5526890818,33,27,1,1
"912354211",53,3103.68089723996,2667.061866114,28,25,1,1
"912354212",54,3182.65473178264,2677.2712016452,22,32,1,1
"912354213",58,2895.49925008006,2716.66249357165,31,27,1,1
"912354214",63,3108.39758915614,2762.96971264875,34,29,1,1
"912354215",56,3163.3452873918,2697.24673169728,31,25,1,1
"912354216",53,3368.09505585658,2667.061866114,25,28,1,1
"912354217",57,3330.39528913566,2707.02236739438,29,28,1,1
"912354218",74,3800.41361958285,2855.36548874306,42,32,1,1
"912354219",65,3685.64491120961,2780.67589681985,32,33,1,1
"912354220",60,3102.23511492374,2735.5526890818,34,26,1,1
"912354221",70,3440.60551565202,2823.11677003184,40,30,1,1
"912354222",76,3428.79657957012,2870.97236507783,45,31,1,1
"912354223",52,3430.41597036456,2656.6981055205,31,21,1,1
"912354224",39,3159.63789123374,2504.98447234734,20,19,1,1
"912354225",49,3082.88510973078,2624.62502504328,25,24,1,1
"912354226",51,3209.58069409437,2646.17454577679,29,22,1,1
"912354227",57,3522.03372048932,2707.02236739438,31,26,1,1
"912354228",75,2794.44110315436,2863.21031780169,38,37,1,1
"912354229",79,3498.35724511111,2893.78092561085,39,40,1,1
"912354230",40,3111.91618158904,2517.98110851286,18,22,1,1
"912354231",58,3109.13936322476,2716.66249357165,23,35,1,1
"912354232",66,3297.5213984182,2789.3669207067,33,33,1,1
"912354233",49,2979.7016081488,2624.62502504328,25,24,1,1
"912354234",71,3843.21592417165,2831.31372136695,36,35,1,1
"912354236",51,3050.26905248287,2646.17454577679,26,25,1,1
"912354237",49,3297.80489532061,2624.62502504328,28,21,1,1
"912354238",54,3175.54751478474,2677.2712016452,24,30,1,1
"912354239",60,2839.91431263005,2735.5526890818,26,34,1,1
"912354240",53,2798.16789928416,2667.061866114,29,24,1,1
"912354241",61,2930.46008531894,2744.81051624266,32,29,1,1
"912354242",68,3109.29322196651,2806.43931339586,35,33,1,1
"912354243",69,2967.39631359184,2814.82611826518,36,33,1,1
"912354244",72,3636.79965467004,2839.4193288992,39,33,1,1
"912354245",54,2914.57274092984,2677.2712016452,34,20,1,1
"912354246",32,2325.54332603775,2405.71569249515,20,12,1,1
"912354247",24,2289.75465986409,2268.33468283819,17,7,1,1
"912354248",26,2469.10106684754,2305.75108410937,14,12,1,1
"912354249",26,2366.64856842853,2305.75108410937,16,10,1,1
"912354250",46,2789.05473600504,2590.94954296761,24,22,1,1
"912354251",45,2646.86454629066,2579.33597919865,23,22,1,1
"912354252",29,2266.14799064784,2357.79423966008,18,11,1,1
"912354253",31,2375.14979312509,2390.15469389133,17,14,1,1
"912354254",21,2099.86221769591,2207.26116887512,12,9,1,1
"912354255",19,2169.98860669492,2162.56636020013,11,8,1,1
"912354256",22,2289.59886273771,2228.3491786518,14,8,1,1
"912354257",29,2421.04896105541,2357.79423966008,18,11,1,1
"912354258",52,3100.80012442125,2656.6981055205,24,28,1,1
"912354259",50,3365.87519181519,2635.48551585152,26,24,1,1
"912354260",51,3262.77976620414,2646.17454577679,22,29,1,1
"912354261",55,3251.14007846355,2687.33120998132,24,31,1,1
"912354263",56,3403.83726384384,2697.24673169728,29,27,1,1
"912354264",42,2573.80729536057,2543.21752514954,27,15,1,1
"912354265",39,2706.08256454801,2504.98447234734,23,16,1,1
"912354266",37,2710.72531332749,2478.17471526668,21,16,1,1
"912354267",45,2733.26775274648,2579.33597919865,23,22,1,1
"912354268",20,1970.34800676762,2185.35845629437,7,13,1,1
"912354269",13,2064.32238540808,2001.16379457045,5,8,1,1
"912354270",19,2156.23430239505,2162.56636020013,9,10,1,1
"912354271",26,2346.71269186955,2305.75108410937,12,14,1,1
"912354272",18,2235.65222930449,2138.79896507223,8,10,1,1
"912354273",21,2296.6461870351,2207.26116887512,11,10,1,1
"912354274",30,2546.02996827047,2374.18906024059,19,11,1,1
"912354275",59,3092.45640346079,2726.17127719361,30,29,1,1
"912354276",38,2709.82483838908,2491.71993967651,20,18,1,1
"912354277",60,2573.36833474917,2735.5526890818,29,31,1,1
"912354278",41,2843.67774176713,2530.72175773865,22,19,1,1
"912354279",57,3132.21155791838,2707.02236739438,34,23,1,1
"912354280",60,2952.33758158869,2735.5526890818,33,27,1,1
"912354281",40,2643.11793168146,2517.98110851286,20,20,1,1
"912354282",19,2148.62668879568,2162.56636020013,7,12,1,1
"912354283",12,1942.13723421421,1968.69006049611,6,6,1,1
"912354284",29,2708.04981624532,2357.79423966008,14,15,1,1
"912354285",56,3567.96117940805,2697.24673169728,26,30,1,1
"912354286",13,1988.45438119308,2001.16379457045,4,9,1,1
"912354287",10,1826.47057375934,1896.67490607898,5,5,1,1
"912354288",14,2049.55373443616,2031.70713799962,7,7,1,1
"912354289",16,2188.09890087018,2087.92318348224,6,10,1,1
"912354290",74,3469.63217014112,2855.36548874306,41,33,1,1
"912354291",59,3571.10958801495,2726.17127719361,33,26,1,1
"912354292",49,2503.57369874349,2624.62502504328,25,24,1,1
"912354293",47,2798.13281061906,2602.36394728806,23,24,1,1
"912354294",34,2621.43417836042,2435.71163614839,18,16,1,1
"912354295",39,2736.80228853939,2504.98447234734,22,17,1,1
"912354296",28,2307.76341004095,2340.94327947849,16,12,1,1
"912354297",39,2531.97095806867,2504.98447234734,21,18,1,1
"912354298",35,2521.15717978597,2450.1860183293,18,17,1,1
"912354299",36,2499.75623317545,2464.33502634194,20,16,1,1
"912354300",49,3078.1186909763,2624.62502504328,27,22,1,1
"912354301",41,2736.32512154822,2530.72175773865,23,18,1,1
"912354302",42,2691.51391679921,2543.21752514954,24,18,1,1
"912354303",46,2620.48952803145,2590.94954296761,25,21,1,1
"912354304",39,2460.50350562207,2504.98447234734,19,20,1,1
"912354305",52,2989.5356954268,2656.6981055205,26,26,1,1
"912354306",36,2577.58813493812,2464.33502634194,20,16,1,1
"912354307",32,2523.44479698032,2405.71569249515,22,10,1,1
"912354308",32,2532.6040669823,2405.71569249515,19,13,1,1
"912354309",36,2514.31566200697,2464.33502634194,19,17,1,1
"912354310",42,2263.8873539707,2543.21752514954,23,19,1,1
"912354311",41,2524.41710312193,2530.72175773865,22,19,1,1
"912354312",45,2849.17309114973,2579.33597919865,28,17,1,1
"912354313",51,2953.07904609155,2646.17454577679,30,21,1,1
"912354314",48,2908.95795733711,2613.58673801098,24,24,1,1
"912354315",39,2523.01611003304,2504.98447234734,19,20,1,1
"912354316",50,2876.05248602366,2635.48551585152,25,25,1,1
"912354317",50,2911.05611800534,2635.48551585152,25,25,1,1
"912354318",43,2686.5473453288,2555.47878346624,25,18,1,1
"912354319",45,2909.55944333777,2579.33597919865,27,18,1,1
"912354320",51,2972.31287714239,2646.17454577679,29,22,1,1
"912354321",55,3359.35837962344,2687.33120998132,27,28,1,1
"912354322",39,3117.97397921709,2504.98447234734,22,17,1,1
"912354323",67,3494.61739385421,2797.95380131742,33,34,1,1
"912354324",49,3117.19755475077,2624.62502504328,25,24,1,1
"912354325",51,3166.77079000347,2646.17454577679,27,24,1,1
"912354326",47,2768.53758541831,2602.36394728806,28,19,1,1
"912354327",45,3180.39668553658,2579.33597919865,24,21,1,1
"912354328",49,3248.55428528434,2624.62502504328,29,20,1,1
"912354329",42,2903.38941883448,2543.21752514954,20,22,1,1
"912354330",54,3121.5780840107,2677.2712016452,29,25,1,1
"912354331",32,2585.22460607591,2405.71569249515,19,13,1,1
"912354332",25,2415.0518504776,2287.34065519221,15,10,1,1
"912354333",62,3472.47222509046,2753.94837323248,31,31,1,1
"912354334",42,2955.0596311411,2543.21752514954,22,20,1,1
"912354335",44,3116.33589477369,2567.51523707907,26,18,1,1
"912354336",41,3139.20991284342,2530.72175773865,25,16,1,1
"912354337",42,3102.41622858316,2543.21752514954,21,21,1,1
"912354339",45,2919.59810620365,2579.33597919865,26,19,1,1
"912354340",49,2969.27715224604,2624.62502504328,25,24,1,1
"912354341",32,2441.27803732599,2405.71569249515,16,16,1,1
"912354342",25,2470.36035504388,2287.34065519221,17,8,1,1
"912354343",32,2432.71317205602,2405.71569249515,17,15,1,1
"912354344",42,2881.14537317362,2543.21752514954,20,22,1,1
"912354345",51,2928.83665673534,2646.17454577679,29,22,1,1
"912354346",51,3179.38328349841,2646.17454577679,29,22,1,1
"912354347",52,2926.10811385357,2656.6981055205,25,27,1,1
"912354348",36,2775.79133639826,2464.33502634194,19,17,1,1
"912354349",48,2779.04813369996,2613.58673801098,25,23,1,1
"912354350",39,2796.63631490183,2504.98447234734,20,19,1,1
"912354351",46,2862.82740367401,2590.94954296761,24,22,1,1
"912354352",37,2777.60552388349,2478.17471526668,19,18,1,1
"912354353",40,2857.72751068678,2517.98110851286,18,22,1,1
"912354354",43,2915.10167072165,2555.47878346624,20,23,1,1
"912354355",48,2800.8220726588,2613.58673801098,21,27,1,1
"912354356",39,2457.88783429002,2504.98447234734,17,22,1,1
"912354357",46,2980.99844127139,2590.94954296761,23,23,1,1
"912354358",40,2868.5706562944,2517.98110851286,21,19,1,1
"912354359",38,2644.77900959731,2491.71993967651,17,21,1,1
"912354360",37,2685.26355912262,2478.17471526668,19,18,1,1
"912354361",37,2887.73549810689,2478.17471526668,18,19,1,1
"912354362",35,2820.97409103664,2450.1860183293,19,16,1,1
"912354363",43,2964.69549140326,2555.47878346624,21,22,1,1
"912354364",37,2719.74778411133,2478.17471526668,20,17,1,1
"912354365",40,2869.56369203244,2517.98110851286,22,18,1,1
"912354366",43,2848.14795470247,2555.47878346624,24,19,1,1
"912354367",51,3167.90163275724,2646.17454577679,27,24,1,1
"912354368",32,2694.32041786172,2405.71569249515,14,18,1,1
"912354369",50,3463.28630531453,2635.48551585152,27,23,1,1
"912354370",49,2899.08561314299,2624.62502504328,25,24,1,1
"912354371",41,3091.88830647909,2530.72175773865,16,25,1,1
"912354372",41,2885.86774000215,2530.72175773865,17,24,1,1
"912354373",38,2494.74887284207,2491.71993967651,23,15,1,1
"912354374",39,2766.46457044997,2504.98447234734,21,18,1,1
"912354375",27,2348.96816210592,2323.60649590586,18,9,1,1
"912354376",9,1888.65399153079,1856.26587460569,4,5,1,1
"912354377",17,2161.06153819514,2113.95669457394,9,8,1,1
"912354378",22,2136.29067816174,2228.3491786518,12,10,1,1
"912354379",21,2163.54766858666,2207.26116887512,11,10,1,1
"912354380",21,2247.31850440372,2207.26116887512,12,9,1,1
"912354381",31,2475.28704620397,2390.15469389133,18,13,1,1
"912354382",18,2169.07128424424,2138.79896507223,12,6,1,1
"912354383",15,1910.84871614141,2060.56118614118,8,7,1,1
"912354384",63,3373.3223492623,2762.96971264875,39,24,1,1
"912354385",54,3482.97280264897,2677.2712016452,31,23,1,1
"912354386",37,3053.58168208207,2478.17471526668,25,12,1,1
"912354387",18,2012.44752392478,2138.79896507223,10,8,1,1
"912354388",42,2889.01112169961,2543.21752514954,24,18,1,1
"912354389",64,3565.67243942061,2771.87783482774,33,31,1,1
"912354390",17,2123.69817148853,2113.95669457394,9,8,1,1
"912354391",14,1933.44195693524,2031.70713799962,8,6,1,1
"912354392",20,2185.57786032116,2185.35845629437,12,8,1,1
"912354393",49,3089.32104068641,2624.62502504328,32,17,1,1
"912354394",58,3227.60048074642,2716.66249357165,33,25,1,1
"912354395",41,2733.51402479036,2530.72175773865,24,17,1,1
"912354396",46,2855.98069795793,2590.94954296761,27,19,1,1
"912354397",37,2674.15883301348,2478.17471526668,25,12,1,1
"912354398",47,2759.38729952255,2602.36394728806,24,23,1,1
"912354399",32,2440.63148343455,2405.71569249515,18,14,1,1
"912354400",38,2507.40919226382,2491.71993967651,24,14,1,1
"912354401",11,1820.40401388393,1933.98659929558,8,3,1,1
"912354402",14,2053.26179159518,2031.70713799962,8,6,1,1
"912354403",20,2281.05453226088,2185.35845629437,13,7,1,1
"912354404",27,2443.88887559307,2323.60649590586,15,12,1,1
"912354405",20,2043.6181560679,2185.35845629437,10,10,1,1
"912354406",30,2121.19981268498,2374.18906024059,16,14,1,1
"912354407",27,2397.65881865965,2323.60649590586,15,12,1,1
"912354408",34,2606.48612814955,2435.71163614839,19,15,1,1
"912354409",24,2484.81919051835,2268.33468283819,12,12,1,1
"912354410",23,2472.62691111423,2248.68783741607,11,12,1,1
"912354411",35,2597.73656107771,2450.1860183293,15,20,1,1
"912354412",54,3556.54588214258,2677.2712016452,35,19,1,1
"912354413",64,3456.50437488844,2771.87783482774,36,28,1,1
"912354414",37,3003.18432010507,2478.17471526668,22,15,1,1
"912354415",24,2129.22403532827,2268.33468283819,11,13,1,1
"912354416",11,1891.18681587534,1933.98659929558,9,2,1,1
"912354417",23,2341.7959501508,2248.68783741607,11,12,1,1
"912354418",12,1892.29081031564,1968.69006049611,6,6,1,1
"912354419",19,2145.40525526405,2162.56636020013,11,8,1,1
"912354420",16,2017.47729268782,2087.92318348224,7,9,1,1
"912354421",50,3123.30380157996,2635.48551585152,28,22,1,1
"912354422",54,3191.50950154129,2677.2712016452,29,25,1,1
"912354423",46,3355.56978916658,2590.94954296761,23,23,1,1
"912354424",48,3381.28647008356,2613.58673801098,30,18,1,1
"912354425",54,2756.21667989534,2677.2712016452,33,21,1,1
"912354426",44,2874.17652217006,2567.51523707907,27,17,1,1
"912354427",54,2777.67194172507,2677.2712016452,28,26,1,1
"912354428",43,2414.87823530875,2555.47878346624,23,20,1,1
"912354440",52,3064.16678015639,2656.6981055205,31,21,1,1
"912354441",62,3315.31986743804,2753.94837323248,30,32,1,1
"912354442",48,2872.10108786709,2613.58673801098,28,20,1,1
"912354443",51,3132.20568135762,2646.17454577679,29,22,1,1
"912354444",47,3125.25794755138,2602.36394728806,28,19,1,1
"912354445",53,3541.28501703348,2667.061866114,32,21,1,1
"912354446",66,3682.70964644032,2789.3669207067,33,33,1,1
"912354447",61,3680.81885524417,2744.81051624266,31,30,1,1
"912354448",48,3123.96834388396,2613.58673801098,26,22,1,1
"912354449",45,3390.01298529065,2579.33597919865,26,19,1,1
"912354450",37,2824.37148119591,2478.17471526668,16,21,1,1
"912354451",40,3161.87209285561,2517.98110851286,19,21,1,1
"912354452",27,2503.49120295411,2323.60649590586,13,14,1,1
"912354453",34,2705.15271765572,2435.71163614839,18,16,1,1
"912354454",52,2608.21037490904,2656.6981055205,27,25,1,1
"912354455",39,2936.15458729532,2504.98447234734,22,17,1,1
"912354456",49,3155.53105449802,2624.62502504328,23,26,1,1
"912354457",36,2991.66708717874,2464.33502634194,17,19,1,1
"912354458",43,2980.59446012602,2555.47878346624,25,18,1,1
"912354459",42,2981.67026286002,2543.21752514954,20,22,1,1
"912354460",39,2965.96803781936,2504.98447234734,19,20,1,1
"912354461",43,2994.10110274536,2555.47878346624,17,26,1,1
"912354462",44,2905.66014374335,2567.51523707907,21,23,1,1
"912354463",48,2867.6899423809,2613.58673801098,18,30,1,1
"912354464",36,2745.88644841655,2464.33502634194,16,20,1,1
"912354466",34,3125.88447531332,2435.71163614839,16,18,1,1
"912354468",32,2816.43185859428,2405.71569249515,14,18,1,1
"912354469",48,3089.06275246455,2613.58673801098,22,26,1,1
"912354470",41,2993.67590773924,2530.72175773865,17,24,1,1
"912354471",54,3248.06304712353,2677.2712016452,27,27,1,1
"912354472",49,3292.72318186555,2624.62502504328,23,26,1,1
"912354473",40,2972.68394758629,2517.98110851286,17,23,1,1
"912354474",39,2801.46831032554,2504.98447234734,17,22,1,1
"912354475",34,2531.99111682989,2435.71163614839,16,18,1,1
"912354476",28,2446.00762006137,2340.94327947849,18,10,1,1
"912354477",20,2233.53593095581,2185.35845629437,10,10,1,1
"912354478",45,2596.90299170809,2579.33597919865,27,18,1,1
"912354479",32,2377.22968481295,2405.71569249515,21,11,1,1
"912354480",25,2212.48458402156,2287.34065519221,15,10,1,1
"912354481",38,2613.26376363972,2491.71993967651,23,15,1,1
"912354482",46,2769.58321349621,2590.94954296761,28,18,1,1
"912354483",38,2575.54997329899,2491.71993967651,21,17,1,1
"912354485",44,2640.08455765048,2567.51523707907,24,20,1,1
"912354488",27,2140.53188219306,2323.60649590586,14,13,1,1
"912354489",13,1947.30096357835,2001.16379457045,6,7,1,1
"912354490",12,1886.9902682953,1968.69006049611,6,6,1,1
"912354491",23,2350.23385951035,2248.68783741607,16,7,1,1
"912354492",24,2032.82941980251,2268.33468283819,13,11,1,1
"912354493",12,1894.41270178113,1968.69006049611,6,6,1,1
"912354494",15,2010.65203465671,2060.56118614118,9,6,1,1
"912354495",14,2104.1488468378,2031.70713799962,8,6,1,1
"912354496",13,2041.64309270433,2001.16379457045,7,6,1,1
"912354497",11,1861.79472563327,1933.98659929558,4,7,1,1
"912354498",11,1784.24902538101,1933.98659929558,6,5,1,1
"912354499",12,1915.58051052768,1968.69006049611,5,7,1,1
"912354500",12,1864.3080924338,1968.69006049611,7,5,1,1
"912354501",14,1946.3809149053,2031.70713799962,8,6,1,1
"912354502",13,1892.90982813748,2001.16379457045,6,7,1,1
"912354503",18,2058.46959829342,2138.79896507223,8,10,1,1
"912354504",13,1930.94514021278,2001.16379457045,8,5,1,1
"912354505",20,2277.39571486572,2185.35845629437,12,8,1,1
"912354506",8,1804.59587766168,1812.11073017574,4,4,1,1
"912354507",10,1862.73951427685,1896.67490607898,5,5,1,1
"912354508",15,1897.00469290245,2060.56118614118,9,6,1,1
"912354509",6,1690.83247962274,1708.62817714657,4,2,1,1
"912354510",7,1769.78423084357,1763.32076508842,5,2,1,1
"912354511",11,1866.11169948309,1933.98659929558,5,6,1,1
"912354512",15,1927.51753158336,2060.56118614118,8,7,1,1
"912354513",10,1948.07378217973,1896.67490607898,6,4,1,1
"912354514",18,2101.49512706037,2138.79896507223,7,11,1,1
"912354515",12,1839.23295304414,1968.69006049611,5,7,1,1
"912354516",15,1897.55251808811,2060.56118614118,10,5,1,1
"912354517",13,1886.88393562765,2001.16379457045,6,7,1,1
"912354518",18,2035.83856224157,2138.79896507223,9,9,1,1
"912354519",10,1810.75245273961,1896.67490607898,4,6,1,1
"912354593",26,2319.19683463532,2305.75108410937,14,12,1,1
"912354594",18,2145.54418592054,2138.79896507223,4,14,1,1
"912354595",25,2017.00378017245,2287.34065519221,10,15,1,1
"912354596",24,1963.71606852305,2268.33468283819,12,12,1,1
"912354597",31,2158.06397615977,2390.15469389133,12,19,1,1
"912354598",19,2330.2720825977,2162.56636020013,12,7,1,1
"912354599",26,2311.43252234839,2305.75108410937,15,11,1,1
"912354600",19,2051.55601412409,2162.56636020013,8,11,1,1
"912354601",21,2188.17281499618,2207.26116887512,9,12,1,1
"912354602",26,2443.3828728834,2305.75108410937,11,15,1,1
"912354603",12,2034.35520056598,1968.69006049611,5,7,1,1
"912354604",16,2078.41706828446,2087.92318348224,7,9,1,1
"912354605",19,2132.29030455532,2162.56636020013,8,11,1,1
"912354606",26,2361.27763011805,2305.75108410937,11,15,1,1
"912354607",19,2198.2545072592,2162.56636020013,9,10,1,1
"912354608",18,2146.06656184674,2138.79896507223,5,13,1,1
"912354609",21,1923.12366427714,2207.26116887512,4,17,1,1
"912354610",13,1920.0467918055,2001.16379457045,7,6,1,1
"912354611",9,1792.5009467324,1856.26587460569,5,4,1,1
"912354612",26,2314.30769836391,2305.75108410937,13,13,1,1
"912354613",25,2154.27774930787,2287.34065519221,12,13,1,1
"912354614",15,2139.01066738918,2060.56118614118,7,8,1,1
"912354615",21,2078.93515521489,2207.26116887512,13,8,1,1
"912354616",19,2300.69846776271,2162.56636020013,8,11,1,1
"912354617",11,1990.27860568139,1933.98659929558,5,6,1,1
"912354618",23,2327.23207071944,2248.68783741607,10,13,1,1
"912354619",25,2225.27569884165,2287.34065519221,12,13,1,1
"912354620",19,2141.8743268701,2162.56636020013,7,12,1,1
"912354693",29,2700.45738116931,2357.79423966008,16,13,1,1
"912354694",37,2649.1950401018,2478.17471526668,19,18,1,1
"912354695",54,2931.0689864444,2677.2712016452,26,28,1,1
"912354696",48,3568.70541318219,2613.58673801098,25,23,1,1
"912354697",50,3077.89287075898,2635.48551585152,26,24,1,1
"912354698",64,3316.31088466925,2771.87783482774,37,27,1,1
"912354699",58,3147.23375124725,2716.66249357165,30,28,1,1
"912354700",50,3056.80357438108,2635.48551585152,22,28,1,1
"912354701",61,3722.44415340593,2744.81051624266,31,30,1,1
"912354702",65,3134.10939628145,2780.67589681985,40,25,1,1
"912354704",29,2543.23344014446,2357.79423966008,17,12,1,1
"912354706",59,3266.67733464615,2726.17127719361,27,32,1,1
"912354719",31,2168.44569299635,2390.15469389133,12,19,1,1
"912354720",31,2253.78804785223,2390.15469389133,11,20,1,1
"912354721",30,2373.00982336692,2374.18906024059,10,20,1,1
"912354722",30,2467.5601345376,2374.18906024059,13,17,1,1
"912354723",29,2281.26068285795,2357.79423966008,14,15,1,1
"912354724",23,2114.64761782173,2248.68783741607,9,14,1,1
"912354725",20,2047.97209678525,2185.35845629437,6,14,1,1
"912354726",15,1981.51790354496,2060.56118614118,5,10,1,1
"912354727",27,2216.59329355656,2323.60649590586,13,14,1,1
"912354728",22,2192.20940796243,2228.3491786518,11,11,1,1
"912354729",13,1900.67246597187,2001.16379457045,5,8,1,1
"912354730",19,2078.54994271861,2162.56636020013,7,12,1,1
"912354731",36,2312.66873196735,2464.33502634194,17,19,1,1
"912354732",33,2406.0931276178,2420.89448855093,17,16,1,1
"912354733",31,2283.26418614757,2390.15469389133,16,15,1,1
"912354734",32,2314.50601116148,2405.71569249515,15,17,1,1
"912354735",10,1828.51941776689,1896.67490607898,2,8,1,1
"912354736",11,1745.15278819662,1933.98659929558,3,8,1,1
"912354737",9,1753.79328382676,1856.26587460569,3,6,1,1
"912354738",13,1837.29179185207,2001.16379457045,3,10,1,1
"912354739",37,2205.8007727069,2478.17471526668,23,14,1,1
"912354740",29,2260.2788934361,2357.79423966008,15,14,1,1
"912354741",36,2444.81020282175,2464.33502634194,20,16,1,1
"912354742",26,2221.37415110426,2305.75108410937,13,13,1,1
"912354743",40,2641.8178667722,2517.98110851286,21,19,1,1
"912354744",28,2373.80582964896,2340.94327947849,15,13,1,1
"912354745",26,2323.95344080507,2305.75108410937,13,13,1,1
"912354746",41,2391.5490518417,2530.72175773865,23,18,1,1
"912354747",19,1887.36877440555,2162.56636020013,6,13,1,1
"912354748",26,2096.71182894239,2305.75108410937,10,16,1,1
"912354749",36,2555.29519634654,2464.33502634194,17,19,1,1
"912354750",33,2250.59737734404,2420.89448855093,15,18,1,1
"912354751",26,2149.00303441222,2305.75108410937,14,12,1,1
"912354752",19,2130.15781243484,2162.56636020013,8,11,1,1
"912354753",32,2382.18663324989,2405.71569249515,16,16,1,1
"912354754",38,2311.08444720412,2491.71993967651,19,19,1,1
"912354755",38,2308.16962392568,2491.71993967651,19,19,1,1
"912354756",24,2212.64165148418,2268.33468283819,12,12,1,1
"912354757",31,2218.37400036164,2390.15469389133,14,17,1,1
"912354758",20,2013.83621657793,2185.35845629437,7,13,1,1
"912354761",55,2553.85838804477,2687.33120998132,27,28,1,1
"912354762",34,2510.88684407378,2435.71163614839,16,18,1,1
"912354763",58,2587.715138669,2716.66249357165,32,26,1,1
"912354764",53,2896.81972166731,2667.061866114,25,28,1,1
"912354765",50,2652.54500866202,2635.48551585152,26,24,1,1
"912354766",43,2445.08437710335,2555.47878346624,24,19,1,1
"912354767",35,2210.91153283514,2450.1860183293,20,15,1,1
"912354768",59,3068.77740644621,2726.17127719361,28,31,1,1
"912354769",81,3080.90274087015,2908.60658576875,39,42,1,1
"912354770",55,2462.03318283302,2687.33120998132,34,21,1,1
"912354771",37,2392.18525564539,2478.17471526668,17,20,1,1
"912354772",54,2935.21463058232,2677.2712016452,33,21,1,1
"912354773",57,2578.57983894545,2707.02236739438,35,22,1,1
"912354774",49,3151.06163853281,2624.62502504328,26,23,1,1
"912354775",43,2593.3294428846,2555.47878346624,29,14,1,1
"912354777",30,2277.12933699288,2374.18906024059,16,14,1,1
"923400159",25,2037.61464477638,2287.34065519221,11,14,1,1
"923400160",29,2052.30877466215,2357.79423966008,12,17,1,1
"923400168",52,3242.91770777896,2656.6981055205,31,21,1,1
"923400169",45,3167.19763424933,2579.33597919865,24,21,1,1
"923400170",47,3361.05507840559,2602.36394728806,26,21,1,1
"923400171",58,3136.94013745589,2716.66249357165,31,27,1,1
"923400172",49,2969.90773493075,2624.62502504328,28,21,1,1
"923400173",31,2744.43217132782,2390.15469389133,17,14,1,1
"923400174",34,2641.68223572549,2435.71163614839,20,14,1,1
"923400175",30,2846.23156877307,2374.18906024059,20,10,1,1
"923400176",49,3069.22613577219,2624.62502504328,29,20,1,1
"923400177",35,2888.815833045,2450.1860183293,19,16,1,1
"923400178",41,2759.97105116824,2530.72175773865,20,21,1,1
"923400179",38,2876.85841495251,2491.71993967651,25,13,1,1
"923400180",38,3302.40682351877,2491.71993967651,22,16,1,1
"923400181",30,2835.84058526885,2374.18906024059,16,14,1,1
"923400182",30,2577.92241642643,2374.18906024059,13,17,1,1
"923400183",52,3252.25684768779,2656.6981055205,28,24,1,1
"923400184",45,2687.77201455434,2579.33597919865,24,21,1,1
"923400185",39,2725.01121167392,2504.98447234734,19,20,1,1
"923400186",52,3060.86484413505,2656.6981055205,28,24,1,1
"923400187",32,2914.28474732369,2405.71569249515,16,16,1,1
"923400188",35,2880.92294623712,2450.1860183293,16,19,1,1
"923400189",36,2701.32872615445,2464.33502634194,18,18,1,1
"923400190",47,3162.69415153815,2602.36394728806,25,22,1,1
"923400191",61,3141.60616510744,2744.81051624266,35,26,1,1
"923400192",33,2666.78026253004,2420.89448855093,14,19,1,1
"923400193",41,2671.71784940891,2530.72175773865,21,20,1,1
"923400194",33,2472.93344469711,2420.89448855093,16,17,1,1
"923400195",34,2569.88571779256,2435.71163614839,19,15,1,1
"923400196",44,3182.2541147424,2567.51523707907,21,23,1,1
"923400197",35,2825.96397016315,2450.1860183293,21,14,1,1
"923400198",30,2771.72038733902,2374.18906024059,16,14,1,1
"923400199",40,3067.23824070667,2517.98110851286,19,21,1,1
"923400200",37,2929.89450543962,2478.17471526668,20,17,1,1
"923400201",37,2787.27077642206,2478.17471526668,20,17,1,1
"923400202",41,3160.6947028583,2530.72175773865,23,18,1,1
"923400203",45,3220.06996716543,2579.33597919865,23,22,1,1
"923400204",48,2932.96264141411,2613.58673801098,22,26,1,1
"923400205",47,3046.72818615793,2602.36394728806,26,21,1,1
"923400206",33,2579.97028944583,2420.89448855093,17,16,1,1
"923400207",49,2747.09842894232,2624.62502504328,27,22,1,1
"923400208",55,2942.88448673936,2687.33120998132,29,26,1,1
"923400209",43,2840.04913058873,2555.47878346624,25,18,1,1
"923400210",44,3249.95069453755,2567.51523707907,22,22,1,1
"923400211",46,3237.35190472497,2590.94954296761,25,21,1,1
"923400212",47,2849.72915142141,2602.36394728806,26,21,1,1
"923400213",33,2777.11883466232,2420.89448855093,17,16,1,1
"923400214",59,2998.27383038972,2726.17127719361,32,27,1,1
"923400215",39,2820.38148308877,2504.98447234734,19,20,1,1
"923400216",30,2418.26727198166,2374.18906024059,19,11,1,1
"923400217",35,2818.18859355844,2450.1860183293,18,17,1,1
"923400218",31,2367.7119184233,2390.15469389133,16,15,1,1
"923400219",42,2946.4715402099,2543.21752514954,23,19,1,1
"923400220",40,2434.2467767064,2517.98110851286,20,20,1,1
"923400221",35,2800.06795734423,2450.1860183293,16,19,1,1
"923400222",35,2815.17236652587,2450.1860183293,18,17,1,1
"923400223",37,2774.45375550388,2478.17471526668,20,17,1,1
"923400224",47,3058.16083069632,2602.36394728806,27,20,1,1
"923400225",47,2941.87967147161,2602.36394728806,25,22,1,1
"923400226",36,2719.56855767929,2464.33502634194,20,16,1,1
"923400227",21,2460.05286726441,2207.26116887512,8,13,1,1
"923400228",48,3224.49128929339,2613.58673801098,25,23,1,1
"923400229",41,2697.31932166826,2530.72175773865,18,23,1,1
"923400230",54,3579.04865592279,2677.2712016452,33,21,1,1
"923400232",62,3952.92814384083,2753.94837323248,36,26,1,1
"923400233",31,2701.67676609644,2390.15469389133,12,19,1,1
"923400234",34,2704.44287863183,2435.71163614839,16,18,1,1
"923400235",41,2875.83130586348,2530.72175773865,21,20,1,1
"923400421",17,1837.31228604277,2113.95669457394,12,5,1,1
"923400423",20,1825.58566974215,2185.35845629437,9,11,1,1
"923400424",19,1946.88972627613,2162.56636020013,12,7,1,1
"923400427",19,1962.75323077602,2162.56636020013,12,7,1,1
"923400428",13,1569.12987831357,2001.16379457045,7,6,1,1
"923400429",29,2421.85505204495,2357.79423966008,13,16,1,1
"923400430",37,2616.332637794,2478.17471526668,22,15,1,1
"923400431",20,2202.70665990713,2185.35845629437,9,11,1,1
"923400432",30,2425.0749801338,2374.18906024059,13,17,1,1
"923400433",28,2401.30869992883,2340.94327947849,12,16,1,1
"923400434",30,2795.10404542136,2374.18906024059,12,18,1,1
"923400435",51,3091.64799894311,2646.17454577679,28,23,1,1
"923400436",13,1923.89357285235,2001.16379457045,5,8,1,1
"923400437",34,2235.89705103029,2435.71163614839,11,23,1,1
"923400438",53,3116.1557494783,2667.061866114,31,22,1,1
"923400439",40,2889.0179669361,2517.98110851286,20,20,1,1
"923400440",50,2857.48211211394,2635.48551585152,30,20,1,1
"923400441",42,2675.969964562,2543.21752514954,26,16,1,1
"923400442",36,2686.45532052966,2464.33502634194,13,23,1,1
"923400443",22,2381.08425264306,2228.3491786518,12,10,1,1
"923400444",27,2215.51381527076,2323.60649590586,10,17,1,1
"923400445",28,2570.66487923656,2340.94327947849,15,13,1,1
"923400446",25,2455.97240273551,2287.34065519221,13,12,1,1
"923400447",18,2125.89292948525,2138.79896507223,7,11,1,1
"923400448",42,2868.25015246539,2543.21752514954,23,19,1,1
"923400449",28,2339.07610151036,2340.94327947849,11,17,1,1
"923400450",33,2615.63694714092,2420.89448855093,15,18,1,1
"923400451",24,2328.47342161732,2268.33468283819,10,14,1,1
"923400452",39,2634.52509571832,2504.98447234734,23,16,1,1
"923400453",16,2112.59622891591,2087.92318348224,6,10,1,1
"923400454",36,2696.20463283765,2464.33502634194,14,22,1,1
"923400455",33,2517.6741090499,2420.89448855093,16,17,1,1
"923400456",23,2273.84622164035,2248.68783741607,8,15,1,1
"923400457",21,2256.64132997775,2207.26116887512,7,14,1,1
"923400458",21,2113.20928480091,2207.26116887512,8,13,1,1
"923400459",27,2530.13630591754,2323.60649590586,15,12,1,1
"923400460",35,2483.11382909667,2450.1860183293,20,15,1,1
"923400461",6,1699.35819478516,1708.62817714657,2,4,1,1
"923400462",12,2036.60077827494,1968.69006049611,6,6,1,1
"923400463",9,1928.77874281477,1856.26587460569,3,6,1,1
"923400464",45,3119.2626059664,2579.33597919865,26,19,1,1
"923400465",57,3297.00909506429,2707.02236739438,29,28,1,1
"923400466",49,3187.16607375957,2624.62502504328,24,25,1,1
"923400467",34,2842.77280585124,2435.71163614839,15,19,1,1
"923400468",14,1865.59081967603,2031.70713799962,5,9,1,1
"923400469",39,2780.86084752833,2504.98447234734,15,24,1,1
"923400470",34,2530.87755239809,2435.71163614839,14,20,1,1
"923400471",31,2509.38386915434,2390.15469389133,16,15,1,1
"923400472",31,2559.1038211253,2390.15469389133,13,18,1,1
"923400473",45,3058.5676129082,2579.33597919865,30,15,1,1
"923400474",42,2904.64630850717,2543.21752514954,26,16,1,1
"923400475",31,2472.0806388929,2390.15469389133,17,14,1,1
"923400476",33,2781.21607746136,2420.89448855093,21,12,1,1
"923400477",51,3543.57484506213,2646.17454577679,25,26,1,1
"923400478",59,4020.05881805247,2726.17127719361,31,28,1,1
"923400479",38,2919.77498504509,2491.71993967651,21,17,1,1
"923400480",43,2910.57896690779,2555.47878346624,28,15,1,1
"923400481",31,2649.74726784857,2390.15469389133,16,15,1,1
"923400482",20,2355.51896919892,2185.35845629437,12,8,1,1
"923400483",31,2350.54075303707,2390.15469389133,13,18,1,1
"923400484",29,2509.93870936168,2357.79423966008,17,12,1,1
"923400485",46,2757.07821667384,2590.94954296761,26,20,1,1
"923400486",20,2177.94419798928,2185.35845629437,6,14,1,1
"923400487",38,2729.31983189692,2491.71993967651,25,13,1,1
"923400488",26,2427.1588401129,2305.75108410937,11,15,1,1
"923400489",42,2718.27037361405,2543.21752514954,25,17,1,1
"923400490",34,2498.8817647553,2435.71163614839,19,15,1,1
"923400491",48,2826.62695793302,2613.58673801098,25,23,1,1
"923400492",22,2284.59602407067,2228.3491786518,10,12,1,1
"923400493",47,3523.00843493257,2602.36394728806,19,28,1,1
"923400494",35,2817.40257790798,2450.1860183293,20,15,1,1
"923400495",15,2214.62855871185,2060.56118614118,7,8,1,1
"923400496",28,2346.96930746318,2340.94327947849,10,18,1,1
"923400497",46,2885.90389913588,2590.94954296761,19,27,1,1
"923400500",57,3509.63844710877,2707.02236739438,26,31,1,1
"923400501",58,3462.80268799075,2716.66249357165,25,33,1,1
"923400502",40,2828.99010158658,2517.98110851286,14,26,1,1
"923400503",14,2057.67931214464,2031.70713799962,5,9,1,1
"923400504",13,1901.6103305467,2001.16379457045,4,9,1,1
"923400505",17,2102.14466497151,2113.95669457394,5,12,1,1
"923400506",50,3091.42305649642,2635.48551585152,26,24,1,1
"923400507",49,2968.47726353471,2624.62502504328,21,28,1,1
"923400508",41,2420.68403463461,2530.72175773865,19,22,1,1
"923400509",54,2567.47624152475,2677.2712016452,28,26,1,1
"923400510",37,2871.61814699114,2478.17471526668,14,23,1,1
"923400511",28,2417.59375930789,2340.94327947849,13,15,1,1
"923400512",19,2252.42077581552,2162.56636020013,12,7,1,1
"923400513",18,2197.25336915013,2138.79896507223,8,10,1,1
"923400514",12,1955.70975607062,1968.69006049611,4,8,1,1
"923400515",43,3023.17905256076,2555.47878346624,20,23,1,1
"923400516",46,3009.44931538141,2590.94954296761,19,27,1,1
"923400517",37,2821.76354614525,2478.17471526668,18,19,1,1
"923400518",59,3090.46494284919,2726.17127719361,28,31,1,1
"923400519",20,2397.77312111005,2185.35845629437,12,8,1,1
"923400520",13,2011.1037270797,2001.16379457045,4,9,1,1
"923400521",61,3260.58572185808,2744.81051624266,30,31,1,1
"923400522",28,2361.84067624684,2340.94327947849,15,13,1,1
"923400523",12,2090.86514487215,1968.69006049611,4,8,1,1
"923400524",15,2143.00276692474,2060.56118614118,9,6,1,1
"923400525",56,3386.36236252918,2697.24673169728,23,33,1,1
"923400526",44,3129.46850439388,2567.51523707907,19,25,1,1
"923400527",55,3601.94818948005,2687.33120998132,25,30,1,1
"923400528",43,2875.17142704278,2555.47878346624,14,29,1,1
"923400529",34,2878.27106882697,2435.71163614839,13,21,1,1
"923400530",50,3120.76825970534,2635.48551585152,24,26,1,1
"923400531",69,4134.82046386765,2814.82611826518,34,35,1,1
"923400532",22,2146.94992878307,2228.3491786518,8,14,1,1
"923400533",42,2875.28174177977,2543.21752514954,20,22,1,1
"923400534",64,3207.36092856663,2771.87783482774,25,39,1,1
"923400536",26,2485.76151830612,2305.75108410937,14,12,1,1
"923400537",50,3042.45645595112,2635.48551585152,16,34,1,1
"923400538",38,2866.64461574055,2491.71993967651,17,21,1,1
"923400539",44,2862.18361792379,2567.51523707907,18,26,1,1
"923400540",50,3483.63620289329,2635.48551585152,19,31,1,1
"923400541",67,3411.91874929249,2797.95380131742,28,39,1,1
"923400542",62,3118.91756592742,2753.94837323248,29,33,1,1
"923400543",61,2999.62488326042,2744.81051624266,28,33,1,1
"923400544",34,2750.47788170428,2435.71163614839,14,20,1,1
"923400545",19,2267.43166075735,2162.56636020013,9,10,1,1
"923400546",55,3172.21257115104,2687.33120998132,25,30,1,1
"923400547",67,3287.35125518836,2797.95380131742,32,35,1,1
"923400548",21,2167.31309777448,2207.26116887512,9,12,1,1
"923400549",50,3379.23735616324,2635.48551585152,28,22,1,1
"923400550",19,2035.45948600822,2162.56636020013,9,10,1,1
"923400551",27,2482.4812081124,2323.60649590586,11,16,1,1
"923400552",38,3049.43864805935,2491.71993967651,19,19,1,1
"923400553",13,1961.80021892603,2001.16379457045,7,6,1,1
"923400554",67,3644.82164506214,2797.95380131742,33,34,1,1
"923400555",58,3196.2288045002,2716.66249357165,30,28,1,1
"923400556",29,2532.65793347171,2357.79423966008,19,10,1,1
"923400557",61,4232.65802233163,2744.81051624266,29,32,1,1
"923400558",33,2517.49802303009,2420.89448855093,9,24,1,1
"923400559",16,2090.57857795991,2087.92318348224,7,9,1,1
"923400560",58,3359.82937670401,2716.66249357165,24,34,1,1
"923400561",12,1943.43459388167,1968.69006049611,4,8,1,1
"923400562",61,3329.50710299498,2744.81051624266,29,32,1,1
"923400563",69,3679.85961432883,2814.82611826518,33,36,1,1
"923400564",53,3077.59928077513,2667.061866114,22,31,1,1
"923400565",27,2604.01403474863,2323.60649590586,12,15,1,1
"923400566",74,3944.1854235542,2855.36548874306,38,36,1,1
"923400567",41,2976.14891062674,2530.72175773865,17,24,1,1
"923400568",42,3325.71401090479,2543.21752514954,21,21,1,1
"923400569",60,2886.67394889959,2735.5526890818,32,28,1,1
"923400572",35,2504.39877097946,2450.1860183293,17,18,1,1
"923400573",47,3156.93389103321,2602.36394728806,24,23,1,1
"923400574",61,3246.5281028367,2744.81051624266,34,27,1,1
"923400575",16,1933.8287189325,2087.92318348224,6,10,1,1
"923400576",52,3078.6746175436,2656.6981055205,24,28,1,1
"923400577",62,3049.67686030407,2753.94837323248,36,26,1,1
"923400578",43,2860.54373157293,2555.47878346624,16,27,1,1
"923400579",40,2998.52677494991,2517.98110851286,20,20,1,1
"923400580",60,3338.87532660372,2735.5526890818,29,31,1,1
"923400581",69,3082.3257494913,2814.82611826518,32,37,1,1
"923400582",78,4068.76528951468,2886.25582696583,37,41,1,1
"923400583",56,2935.55237006499,2697.24673169728,22,34,1,1
"923400584",30,2363.86056769595,2374.18906024059,13,17,1,1
"923400585",43,2847.51463246752,2555.47878346624,17,26,1,1
"923400586",46,2720.19259287406,2590.94954296761,19,27,1,1
"923400587",7,1751.72528312677,1763.32076508842,4,3,1,1
"923400588",38,2954.79355987589,2491.71993967651,16,22,1,1
"923400589",47,3093.49358632181,2602.36394728806,18,29,1,1
"923400590",50,3206.76692786461,2635.48551585152,20,30,1,1
"923400591",25,2245.05136380311,2287.34065519221,14,11,1,1
"923400592",43,2559.30494650845,2555.47878346624,18,25,1,1
"923400593",37,2572.33219261845,2478.17471526668,14,23,1,1
"923400594",48,3067.64028757709,2613.58673801098,24,24,1,1
"923400595",41,2592.85060832087,2530.72175773865,18,23,1,1
"923400596",54,2819.22307890927,2677.2712016452,24,30,1,1
"923400597",14,2098.24177909355,2031.70713799962,7,7,1,1
"923400598",59,3358.18177763924,2726.17127719361,23,36,1,1
"923400599",53,2838.3105386832,2667.061866114,22,31,1,1
"923400600",35,2887.10523322299,2450.1860183293,11,24,1,1
"923400601",18,2180.16763397902,2138.79896507223,5,13,1,1
"923400602",52,3128.21794744026,2656.6981055205,29,23,1,1
"923400603",65,3431.63409096957,2780.67589681985,41,24,1,1
"923400604",56,2967.96599970033,2697.24673169728,34,22,1,1
"923400605",22,2280.80204062076,2228.3491786518,10,12,1,1
"923400606",54,2822.04910801229,2677.2712016452,33,21,1,1
"923400607",55,3325.21583583462,2687.33120998132,25,30,1,1
"923400608",22,2404.26183607975,2228.3491786518,15,7,1,1
"923400609",62,3386.38686971677,2753.94837323248,36,26,1,1
"923400610",75,3310.51941718417,2863.21031780169,36,39,1,1
"923400611",35,2810.9072550196,2450.1860183293,20,15,1,1
"923400612",65,3046.53496246095,2780.67589681985,33,32,1,1
"923400613",27,2242.19190969195,2323.60649590586,14,13,1,1
"923400614",65,3271.11122548668,2780.67589681985,33,32,1,1
"923400615",28,2376.82406165198,2340.94327947849,15,13,1,1
"923400616",68,2919.19831256847,2806.43931339586,32,36,1,1
"923400617",77,4003.55238617242,2878.65357631343,47,30,1,1
"923400618",34,2511.72851407486,2435.71163614839,21,13,1,1
"923400619",77,3888.00096067237,2878.65357631343,42,35,1,1
"923400620",36,2647.07267176879,2464.33502634194,22,14,1,1
"923400621",44,2950.82628369787,2567.51523707907,23,21,1,1
"923400622",57,3037.19619035486,2707.02236739438,31,26,1,1
"923400623",77,3764.46656397244,2878.65357631343,43,34,1,1
"923400624",51,2987.42273610652,2646.17454577679,29,22,1,1
"923400625",52,3092.09010782786,2656.6981055205,22,30,1,1
"923400626",51,3330.21330756043,2646.17454577679,27,24,1,1
"923400627",21,2175.71346868909,2207.26116887512,9,12,1,1
"923400628",30,2319.19461963385,2374.18906024059,16,14,1,1
"923400629",23,2217.39155221826,2248.68783741607,9,14,1,1
"923400630",69,3323.00116939714,2814.82611826518,38,31,1,1
"923400631",66,3580.22209729521,2789.3669207067,35,31,1,1
"923400632",57,3399.12434172585,2707.02236739438,32,25,1,1
"923400633",69,3720.20085626455,2814.82611826518,33,36,1,1
"923400634",58,2906.93024517146,2716.66249357165,24,34,1,1
"923400635",28,2386.90759317281,2340.94327947849,9,19,1,1
"923400636",34,2477.66087958635,2435.71163614839,15,19,1,1
"923400637",37,2763.4784431154,2478.17471526668,23,14,1,1
"923400638",35,2390.53536700915,2450.1860183293,18,17,1,1
"923400639",34,2667.74515785823,2435.71163614839,20,14,1,1
"923400640",43,2767.16713140373,2555.47878346624,20,23,1,1
"923400641",75,3360.76174732736,2863.21031780169,39,36,1,1
"923400642",53,3068.77885922139,2667.061866114,23,30,1,1
"923400643",68,3307.43399855348,2806.43931339586,41,27,1,1
"923400644",50,3305.35255803122,2635.48551585152,27,23,1,1
"923400645",49,3196.86309734174,2624.62502504328,28,21,1,1
"923400646",47,3194.51239933403,2602.36394728806,26,21,1,1
"923400647",15,2282.35753460296,2060.56118614118,9,6,1,1
"923400648",48,2968.2513082963,2613.58673801098,20,28,1,1
"923400649",39,2812.09856577994,2504.98447234734,16,23,1,1
"923400650",40,2769.93472531472,2517.98110851286,25,15,1,1
"923400651",50,3271.09736130563,2635.48551585152,26,24,1,1
"923400652",43,2761.85732614103,2555.47878346624,21,22,1,1
"923400653",49,2859.56273680145,2624.62502504328,28,21,1,1
"923400654",40,2654.39356850491,2517.98110851286,18,22,1,1
"923400655",56,3521.27508965252,2697.24673169728,25,31,1,1
"923400656",46,2721.93635690611,2590.94954296761,26,20,1,1
"923400657",50,3335.08353438638,2635.48551585152,27,23,1,1
"923400658",56,3593.77894181494,2697.24673169728,28,28,1,1
"923400659",47,3030.94904464606,2602.36394728806,24,23,1,1
"923400660",52,2986.12957270475,2656.6981055205,24,28,1,1
"923400661",51,2979.0730447919,2646.17454577679,26,25,1,1
"923400662",49,3180.0875610038,2624.62502504328,25,24,1,1
"923400663",18,2191.28115645782,2138.79896507223,6,12,1,1
"923400664",38,2774.08473855249,2491.71993967651,22,16,1,1
"923400669",69,3323.25137374485,2814.82611826518,38,31,1,1
"923400670",38,2751.20539413421,2491.71993967651,18,20,1,1
"923400671",44,2940.26186409673,2567.51523707907,19,25,1,1
"923400672",44,3157.98794453181,2567.51523707907,24,20,1,1
"923400673",50,2957.46448198132,2635.48551585152,28,22,1,1
"923400674",50,3015.66394587954,2635.48551585152,27,23,1,1
"923400675",40,2702.03428950783,2517.98110851286,22,18,1,1
"923400676",44,3017.38631181835,2567.51523707907,27,17,1,1
"923400677",63,3182.59834296051,2762.96971264875,32,31,1,1
"923400678",54,2847.48828960706,2677.2712016452,28,26,1,1
"923400679",39,2975.74702214383,2504.98447234734,23,16,1,1
"923400680",23,2524.46390858671,2248.68783741607,14,9,1,1
"923400690",47,2334.94152866731,2602.36394728806,26,21,1,1
"923400709",27,2150.05941968951,2323.60649590586,16,11,1,1
"923400944",79,3133.87497851513,2893.78092561085,44,35,1,1
"923400960",29,2339.37758267245,2357.79423966008,15,14,1,1
"923400961",31,2445.92556118072,2390.15469389133,16,15,1,1
"923400962",32,2505.01619273333,2405.71569249515,15,17,1,1
"923400963",30,2412.61373198022,2374.18906024059,13,17,1,1
"923400964",31,2301.25719566475,2390.15469389133,15,16,1,1
"923400965",34,2297.10260258083,2435.71163614839,18,16,1,1
"923400966",39,2536.49075006613,2504.98447234734,19,20,1,1
"923400967",37,2468.53769739435,2478.17471526668,20,17,1,1
"923400968",38,2497.81195196375,2491.71993967651,20,18,1,1
"923400969",30,2415.1014872918,2374.18906024059,15,15,1,1
"923400970",34,2511.69282667267,2435.71163614839,19,15,1,1
"923400971",22,2177.57161817814,2228.3491786518,15,7,1,1
"923400972",35,2534.6291267195,2450.1860183293,19,16,1,1
"923400973",30,2249.60363772699,2374.18906024059,17,13,1,1
"923400974",26,2219.90867894454,2305.75108410937,13,13,1,1
"923400975",38,2371.85132064375,2491.71993967651,21,17,1,1
"923400976",30,2499.76961813103,2374.18906024059,15,15,1,1
"923400977",29,2411.77853457485,2357.79423966008,14,15,1,1
"923400978",30,2503.17162739617,2374.18906024059,15,15,1,1
"923400979",30,2566.57942880304,2374.18906024059,16,14,1,1
"923400980",29,2397.46352034252,2357.79423966008,13,16,1,1
"923400981",37,2575.215274779,2478.17471526668,17,20,1,1
"923400982",36,2492.34255217963,2464.33502634194,18,18,1,1
"923400983",28,2278.9413825377,2340.94327947849,14,14,1,1
"923400984",28,2439.1754462122,2340.94327947849,15,13,1,1
"923400985",26,2222.07991473808,2305.75108410937,14,12,1,1
"923400986",37,2377.66891918381,2478.17471526668,18,19,1,1
"923400989",31,2554.12785405373,2390.15469389133,14,17,1,1
"923400990",27,2528.80293225803,2323.60649590586,11,16,1,1
"923400991",27,2570.56977696224,2323.60649590586,15,12,1,1
"923400992",39,2608.44518356786,2504.98447234734,19,20,1,1
"923400993",36,2418.35672123844,2464.33502634194,17,19,1,1
"923400994",20,2255.5169181458,2185.35845629437,11,9,1,1
"923400995",39,2581.53227711415,2504.98447234734,15,24,1,1
"923400996",21,2309.01225876122,2207.26116887512,11,10,1,1
"923400997",37,2606.86885816971,2478.17471526668,19,18,1,1
"923400998",30,2749.1250195018,2374.18906024059,14,16,1,1
"923400999",32,2477.28720824086,2405.71569249515,16,16,1,1
"923401000",28,2452.72804992577,2340.94327947849,14,14,1,1
"923401001",26,2460.65473554622,2305.75108410937,13,13,1,1
"923401002",30,2548.14809984662,2374.18906024059,14,16,1,1
"923401003",33,2673.38894681936,2420.89448855093,15,18,1,1
"923401004",27,2519.61465417412,2323.60649590586,13,14,1,1
"923401005",35,2553.48078073549,2450.1860183293,19,16,1,1
"923401006",19,2200.44426920679,2162.56636020013,9,10,1,1
"923401007",36,2743.8785784035,2464.33502634194,21,15,1,1
"923401008",34,2428.85958815501,2435.71163614839,15,19,1,1
"923401009",28,2690.26916281334,2340.94327947849,15,13,1,1
"923401010",36,2579.0660462528,2464.33502634194,14,22,1,1
"923401011",36,2571.79561263594,2464.33502634194,14,22,1,1
"923401012",26,2491.19684707676,2305.75108410937,12,14,1,1
"923401013",28,2402.90340242848,2340.94327947849,15,13,1,1
"923401014",12,1955.2708437838,1968.69006049611,7,5,1,1
"923401015",32,2429.64287114739,2405.71569249515,17,15,1,1
"923401016",40,2577.45913332352,2517.98110851286,20,20,1,1
"923401033",17,2298.02960313195,2113.95669457394,10,7,1,1
"923401034",15,2234.44492866921,2060.56118614118,8,7,1,1
"923401035",19,2234.58236056748,2162.56636020013,14,5,1,1
"923401036",15,2166.37146941568,2060.56118614118,7,8,1,1
"923401245",36,2855.69699522859,2464.33502634194,19,17,1,1
"923401246",49,3045.90551810856,2624.62502504328,25,24,1,1
"923401247",23,2593.47415956299,2248.68783741607,13,10,1,1
"923401248",42,2615.76697641274,2543.21752514954,20,22,1,1
"923401249",39,2912.94423607934,2504.98447234734,24,15,1,1
"923401250",42,3144.46952249187,2543.21752514954,18,24,1,1
"923401251",31,2341.70292752036,2390.15469389133,17,14,1,1
"923401252",20,2128.0182617264,2185.35845629437,6,14,1,1
"923401253",39,2784.0934570331,2504.98447234734,22,17,1,1
"923401254",31,2356.71679137285,2390.15469389133,14,17,1,1
"923401256",26,2317.88471919594,2305.75108410937,14,12,1,1
"923401257",36,2440.03697253537,2464.33502634194,18,18,1,1
"923401258",46,3390.1126940358,2590.94954296761,26,20,1,1
"923401259",35,2641.67054521414,2450.1860183293,21,14,1,1
"923401260",34,2467.19065070659,2435.71163614839,17,17,1,1
"923401261",36,2724.91029103364,2464.33502634194,19,17,1,1
"923401262",41,2866.27721999946,2530.72175773865,22,19,1,1
"923401263",37,2653.45239200667,2478.17471526668,21,16,1,1
"923401264",31,2450.46399054476,2390.15469389133,15,16,1,1
"923401265",46,3061.76298039524,2590.94954296761,24,22,1,1
"923401266",44,2917.34795920237,2567.51523707907,25,19,1,1
"923401267",46,3085.04052455842,2590.94954296761,25,21,1,1
"923401268",43,3206.29456877645,2555.47878346624,26,17,1,1
"923401269",46,2598.51809074124,2590.94954296761,22,24,1,1
"923401270",23,2410.76426476392,2248.68783741607,14,9,1,1
"923401271",35,2451.96615738797,2450.1860183293,14,21,1,1
"923401272",42,3007.54559362539,2543.21752514954,25,17,1,1
"923401273",34,2744.59123352096,2435.71163614839,20,14,1,1
"923401274",39,2673.5871759787,2504.98447234734,22,17,1,1
"923401275",47,3516.26619015568,2602.36394728806,29,18,1,1
"923401276",38,2338.10944432582,2491.71993967651,22,16,1,1
"923401277",35,2797.44560983911,2450.1860183293,24,11,1,1
"923401278",68,3277.99762824381,2806.43931339586,38,30,1,1
"923401279",45,2868.29281143931,2579.33597919865,26,19,1,1
"923401280",53,3141.26157477961,2667.061866114,27,26,1,1
"923401281",43,3071.50841358125,2555.47878346624,24,19,1,1
"923401282",48,3001.68682009658,2613.58673801098,27,21,1,1
"923401283",47,3276.1668032502,2602.36394728806,26,21,1,1
"923401284",50,3221.31939646761,2635.48551585152,27,23,1,1
"923401285",29,2712.77318612109,2357.79423966008,19,10,1,1
"923401286",41,3218.67606866988,2530.72175773865,21,20,1,1
"923401287",47,3110.68122132288,2602.36394728806,25,22,1,1
"923401288",49,3233.83711027166,2624.62502504328,26,23,1,1
"923401289",35,2710.68319395741,2450.1860183293,20,15,1,1
"923401290",32,2976.36864325821,2405.71569249515,21,11,1,1
"923401291",38,2819.11372836257,2491.71993967651,21,17,1,1
"923401292",48,2540.75849769368,2613.58673801098,22,26,1,1
"923401293",28,2300.88236516649,2340.94327947849,18,10,1,1
"923401294",32,2573.18892086225,2405.71569249515,21,11,1,1
"923401295",41,3123.33227290951,2530.72175773865,24,17,1,1
"923401296",48,3089.80291872769,2613.58673801098,25,23,1,1
"923401297",48,3117.39778805284,2613.58673801098,27,21,1,1
"923401298",36,2631.50722280469,2464.33502634194,20,16,1,1
"923401299",34,2905.84859407981,2435.71163614839,20,14,1,1
"923401300",41,2961.20187541997,2530.72175773865,21,20,1,1
"923401301",59,3427.17506761815,2726.17127719361,29,30,1,1
"923401302",48,2930.66684713757,2613.58673801098,24,24,1,1
"923401303",52,3197.06630169691,2656.6981055205,28,24,1,1
"923401305",55,3236.7813731649,2687.33120998132,29,26,1,1
"923401306",33,2734.3600952493,2420.89448855093,19,14,1,1
"923401307",42,2518.29488297948,2543.21752514954,23,19,1,1
"923401308",33,2880.29850274162,2420.89448855093,19,14,1,1
"923401309",35,3280.69954399704,2450.1860183293,15,20,1,1
"923401310",50,2945.78320950093,2635.48551585152,30,20,1,1
"923401312",89,3170.1650264131,2965.14449011489,41,48,1,1
"923401313",74,3872.22322061939,2855.36548874306,42,32,1,1
"923401314",51,2770.14524820592,2646.17454577679,29,22,1,1
"923401315",69,3447.4652824135,2814.82611826518,36,33,1,1
"923401316",37,2698.87315998958,2478.17471526668,20,17,1,1
"923401317",68,3155.35550780593,2806.43931339586,37,31,1,1
"923401318",41,3302.53371247814,2530.72175773865,20,21,1,1
"923401319",59,3573.31542983275,2726.17127719361,30,29,1,1
"923401320",50,2903.91843882083,2635.48551585152,24,26,1,1
"923401426",45,3356.70689134256,2579.33597919865,17,28,1,1
"923401427",36,2521.82660467792,2464.33502634194,23,13,1,1
"923401428",39,2743.72889841813,2504.98447234734,18,21,1,1
"923401429",30,2731.24224516855,2374.18906024059,16,14,1,1
"923401430",34,2695.73009235133,2435.71163614839,18,16,1,1
"923401431",64,2834.31496837418,2771.87783482774,35,29,1,1
"923401432",21,2288.87818054576,2207.26116887512,11,10,1,1
"923401433",40,2934.2649018121,2517.98110851286,21,19,1,1
"923401434",40,2831.20313472216,2517.98110851286,22,18,1,1
"923401435",25,2380.55115351672,2287.34065519221,15,10,1,1
"923401436",38,2732.44448985703,2491.71993967651,18,20,1,1
"923401437",23,2427.58054431766,2248.68783741607,12,11,1,1
"923401439",31,2585.57044992993,2390.15469389133,16,15,1,1
"923401440",57,3374.43665676284,2707.02236739438,29,28,1,1
"923401441",31,2889.38258689073,2390.15469389133,17,14,1,1
"923401442",39,2854.50596533411,2504.98447234734,23,16,1,1
"923401443",31,2848.65650497467,2390.15469389133,12,19,1,1
"923401444",38,3059.28170750067,2491.71993967651,20,18,1,1
"923401445",24,2313.53437327078,2268.33468283819,14,10,1,1
"923401446",43,2704.92659505272,2555.47878346624,16,27,1,1
"923401447",27,2555.39125957239,2323.60649590586,11,16,1,1
"923401449",34,2794.32112037656,2435.71163614839,21,13,1,1
"923401450",42,2964.68512551664,2543.21752514954,22,20,1,1
"923401451",47,2874.96768633877,2602.36394728806,21,26,1,1
"923401452",39,2813.68309784688,2504.98447234734,18,21,1,1
"923401453",54,3209.89047379432,2677.2712016452,25,29,1,1
"923401454",51,3081.40483168618,2646.17454577679,24,27,1,1
"923401455",47,2963.50274460567,2602.36394728806,24,23,1,1
"923401456",41,2759.19808659846,2530.72175773865,19,22,1,1
"923401457",29,2921.76309432578,2357.79423966008,14,15,1,1
"923401458",48,3276.25967973408,2613.58673801098,24,24,1,1
"923401459",34,2745.73590190113,2435.71163614839,17,17,1,1
"923401460",35,2823.12466316497,2450.1860183293,17,18,1,1
"923401461",37,3060.13344570565,2478.17471526668,23,14,1,1
"923401462",37,2749.92003263723,2478.17471526668,18,19,1,1
"923401463",41,2806.01551559032,2530.72175773865,26,15,1,1
"923401464",37,2862.63876308332,2478.17471526668,19,18,1,1
"923401465",59,3273.36734750751,2726.17127719361,31,28,1,1
"923401466",43,2740.27330130879,2555.47878346624,25,18,1,1
"923401467",21,2476.48445829507,2207.26116887512,13,8,1,1
"923401468",32,2742.40698412307,2405.71569249515,16,16,1,1
"923401469",40,2728.24695025279,2517.98110851286,20,20,1,1
"923401470",56,3211.08163383179,2697.24673169728,28,28,1,1
"923401471",36,2627.87408821691,2464.33502634194,22,14,1,1
"923401472",49,3091.88829077389,2624.62502504328,24,25,1,1
"923401473",46,2864.64409407072,2590.94954296761,28,18,1,1
"923401474",31,2868.78097080576,2390.15469389133,17,14,1,1
"923401475",51,3605.34615851477,2646.17454577679,26,25,1,1
"923401476",36,2796.92395737869,2464.33502634194,17,19,1,1
"923401477",37,2491.72067285511,2478.17471526668,18,19,1,1
"923401478",24,2399.56274951028,2268.33468283819,12,12,1,1
"923401479",32,2586.64947181513,2405.71569249515,16,16,1,1
"923401480",44,3174.81325065142,2567.51523707907,21,23,1,1
"923401481",44,2923.88385654237,2567.51523707907,27,17,1,1
"923401482",43,3065.97031917865,2555.47878346624,18,25,1,1
"923401483",44,2784.9874506066,2567.51523707907,19,25,1,1
"923401484",29,2716.32694305401,2357.79423966008,15,14,1,1
"923401485",38,2647.40759608276,2491.71993967651,18,20,1,1
"923401486",35,2710.76595282114,2450.1860183293,15,20,1,1
"923401487",28,2533.65660385707,2340.94327947849,14,14,1,1
"923401488",24,2479.76540307074,2268.33468283819,14,10,1,1
"923401489",35,2547.05362223149,2450.1860183293,22,13,1,1
"923401490",43,2674.35485378308,2555.47878346624,26,17,1,1
"923401491",47,3542.9853456597,2602.36394728806,23,24,1,1
"923401492",24,2463.16799020081,2268.33468283819,10,14,1,1
"923401493",54,3076.06870492199,2677.2712016452,23,31,1,1
"923401494",41,2956.78481943599,2530.72175773865,15,26,1,1
"923401495",34,2786.76559034557,2435.71163614839,17,17,1,1
"923401496",55,3045.90331901975,2687.33120998132,27,28,1,1
"923401497",49,2948.81755868199,2624.62502504328,24,25,1,1
"923401498",40,2728.62882875846,2517.98110851286,20,20,1,1
"923401499",33,2749.43287345032,2420.89448855093,15,18,1,1
"923401500",56,2878.85856277682,2697.24673169728,29,27,1,1
"923401501",37,2565.0918836421,2478.17471526668,16,21,1,1
"923401502",23,2302.18955975888,2248.68783741607,8,15,1,1
"923401503",27,2409.83165269301,2323.60649590586,17,10,1,1
"923401504",34,2740.13213687245,2435.71163614839,14,20,1,1
"923401505",40,3079.45518847697,2517.98110851286,22,18,1,1
"923401506",31,2482.01534457177,2390.15469389133,17,14,1,1
"923401507",48,3144.67378519708,2613.58673801098,20,28,1,1
"923401508",29,2439.92203092644,2357.79423966008,14,15,1,1
"923401509",42,2989.4221118805,2543.21752514954,15,27,1,1
"923401510",32,2740.24478748707,2405.71569249515,12,20,1,1
"923401511",51,2979.53328936786,2646.17454577679,26,25,1,1
"923401512",38,2551.28152861153,2491.71993967651,15,23,1,1
"923401513",26,2547.96022574809,2305.75108410937,11,15,1,1
"923401514",34,2770.67141440714,2435.71163614839,18,16,1,1
"923401515",30,2509.93386793391,2374.18906024059,13,17,1,1
"923401516",48,2965.53050494073,2613.58673801098,31,17,1,1
"923401517",35,2697.92097351215,2450.1860183293,21,14,1,1
"923401518",45,2943.66079175357,2579.33597919865,23,22,1,1
"923401519",42,3103.81503262645,2543.21752514954,23,19,1,1
"923401520",51,3139.58938190579,2646.17454577679,29,22,1,1
"923401521",64,3717.75229708832,2771.87783482774,42,22,1,1
"923401522",40,2862.96837865628,2517.98110851286,18,22,1,1
"923401523",38,2921.348481062,2491.71993967651,22,16,1,1
"923401524",36,2668.32250458836,2464.33502634194,17,19,1,1
"923401525",42,2751.83427474056,2543.21752514954,22,20,1,1
"923401526",49,3075.52180638202,2624.62502504328,24,25,1,1
"923401527",37,2701.31999159461,2478.17471526668,17,20,1,1
"923401528",26,2552.9629338638,2305.75108410937,12,14,1,1
"923401529",26,2283.74060923539,2305.75108410937,15,11,1,1
"923401530",51,3159.76890912181,2646.17454577679,23,28,1,1
"923401531",31,2901.13658367489,2390.15469389133,13,18,1,1
"923401532",26,2563.63411130971,2305.75108410937,11,15,1,1
"923401533",46,3106.24991536208,2590.94954296761,21,25,1,1
"923401534",44,2943.33314989793,2567.51523707907,26,18,1,1
"923401535",34,2978.82835295017,2435.71163614839,14,20,1,1
"923401537",47,2916.58710053381,2602.36394728806,23,24,1,1
"923401538",36,2389.43017163594,2464.33502634194,20,16,1,1
"923401539",36,2622.99477933894,2464.33502634194,23,13,1,1
"923401540",34,2638.31194478768,2435.71163614839,16,18,1,1
"923401541",44,3193.61017059006,2567.51523707907,22,22,1,1
"923401542",68,2994.20044441222,2806.43931339586,42,26,1,1
"923401543",25,2778.03355130862,2287.34065519221,16,9,1,1
"923401544",42,2756.2138966353,2543.21752514954,22,20,1,1
"923401545",42,2970.54778532957,2543.21752514954,22,20,1,1
"923401546",34,2812.96802494042,2435.71163614839,20,14,1,1
"923401547",37,2435.84874947605,2478.17471526668,23,14,1,1
"923401548",32,2670.36326194695,2405.71569249515,13,19,1,1
"923401549",43,2782.10156934756,2555.47878346624,19,24,1,1
"923401550",46,3044.76160445461,2590.94954296761,25,21,1,1
"923401551",41,2557.68749317106,2530.72175773865,21,20,1,1
"923401552",49,3036.3928099913,2624.62502504328,30,19,1,1
"923401553",41,2816.04169999212,2530.72175773865,29,12,1,1
"923401554",30,2646.61378602509,2374.18906024059,20,10,1,1
"923401555",35,2593.31397371565,2450.1860183293,16,19,1,1
"923401556",33,2884.63012864249,2420.89448855093,17,16,1,1
"923401557",48,3096.88260614098,2613.58673801098,22,26,1,1
"923401558",52,3220.41248319312,2656.6981055205,20,32,1,1
"923401559",41,2693.39469610752,2530.72175773865,23,18,1,1
"923401560",33,2863.15012283515,2420.89448855093,17,16,1,1
"923401561",45,2915.55691534427,2579.33597919865,21,24,1,1
"923401562",38,2921.40321241005,2491.71993967651,14,24,1,1
"923401563",58,3193.25768113607,2716.66249357165,26,32,1,1
"923401564",31,2787.26981553789,2390.15469389133,18,13,1,1
"923401565",40,2654.57821128307,2517.98110851286,12,28,1,1
"923401566",41,2791.12501069106,2530.72175773865,17,24,1,1
"923401567",47,3185.07131302777,2602.36394728806,23,24,1,1
"923401569",44,3126.06114945948,2567.51523707907,20,24,1,1
"923401570",42,2535.63721700097,2543.21752514954,24,18,1,1
"923401571",42,2599.18984835122,2543.21752514954,20,22,1,1
"923401572",50,3766.19281552195,2635.48551585152,26,24,1,1
"923401573",31,2748.08790324174,2390.15469389133,11,20,1,1
"923401574",56,3438.12375853424,2697.24673169728,32,24,1,1
"923401575",29,2365.20965486521,2357.79423966008,13,16,1,1
"923401576",39,2922.50199956689,2504.98447234734,18,21,1,1
"923401577",36,2844.74434426657,2464.33502634194,14,22,1,1
"923401578",47,3021.95103273887,2602.36394728806,23,24,1,1
"923401579",59,3292.11626413949,2726.17127719361,34,25,1,1
"923401580",31,2686.87577930661,2390.15469389133,19,12,1,1
"923401581",29,2674.74874720178,2357.79423966008,13,16,1,1
"923401582",44,3295.24379798207,2567.51523707907,25,19,1,1
"923401583",41,3280.03132714232,2530.72175773865,24,17,1,1
"923401584",40,3339.38935325841,2517.98110851286,18,22,1,1
"923401585",30,2451.77796211871,2374.18906024059,13,17,1,1
"923401586",42,2796.58816528725,2543.21752514954,19,23,1,1
"923401587",35,2566.48350686371,2450.1860183293,22,13,1,1
"923401588",14,1941.99848429266,2031.70713799962,7,7,1,1
"923401589",34,2982.8174325562,2435.71163614839,17,17,1,1
"923401590",44,2825.47447474265,2567.51523707907,22,22,1,1
"923401591",42,2958.42413210816,2543.21752514954,17,25,1,1
"923401592",32,2755.42098039849,2405.71569249515,15,17,1,1
"923401593",38,2833.90924770581,2491.71993967651,25,13,1,1
"923401594",41,2888.23967281364,2530.72175773865,17,24,1,1
"923401595",54,3329.66920359115,2677.2712016452,26,28,1,1
"923401596",35,2917.97460437728,2450.1860183293,20,15,1,1
"923401597",42,3282.63543522545,2543.21752514954,21,21,1,1
"923401598",41,2706.77120867005,2530.72175773865,22,19,1,1
"923401599",32,2915.26083807647,2405.71569249515,17,15,1,1
"923401600",54,3026.67792899319,2677.2712016452,29,25,1,1
"923401601",29,2356.25908396199,2357.79423966008,14,15,1,1
"923401602",57,2659.06746673117,2707.02236739438,26,31,1,1
"923401603",25,2510.88578553191,2287.34065519221,13,12,1,1
"923401604",37,2550.21098220597,2478.17471526668,24,13,1,1
"923401606",35,2920.17141691621,2450.1860183293,17,18,1,1
"923401607",41,2897.13281331912,2530.72175773865,19,22,1,1
"923401608",31,2823.27805216753,2390.15469389133,14,17,1,1
"923401609",34,2976.83860145067,2435.71163614839,15,19,1,1
"923401610",31,2769.09278718051,2390.15469389133,15,16,1,1
"923401611",25,2570.1791713303,2287.34065519221,12,13,1,1
"923401612",49,2793.81406025303,2624.62502504328,22,27,1,1
"923401613",42,2829.69942652834,2543.21752514954,24,18,1,1
"923401614",28,2555.5209599021,2340.94327947849,14,14,1,1
"923401615",19,2151.66672682417,2162.56636020013,10,9,1,1
"923401616",31,2573.00454303727,2390.15469389133,19,12,1,1
"923401617",34,2792.22623483544,2435.71163614839,14,20,1,1
"923401618",40,2840.13596408379,2517.98110851286,24,16,1,1
"923401619",36,2664.83269511627,2464.33502634194,19,17,1,1
"923401620",37,2770.15906113109,2478.17471526668,19,18,1,1
"923401621",41,3072.37748347578,2530.72175773865,19,22,1,1
"923401622",48,2857.83459464805,2613.58673801098,30,18,1,1
"923401623",27,2661.78432899638,2323.60649590586,13,14,1,1
"923401624",38,2751.47404101064,2491.71993967651,18,20,1,1
"923401625",42,3116.64391307132,2543.21752514954,21,21,1,1
"923401626",36,2913.6277678185,2464.33502634194,18,18,1,1
"923401627",42,2642.74168870975,2543.21752514954,22,20,1,1
"923401628",36,2497.85970090284,2464.33502634194,18,18,1,1
"923401629",48,3285.53778984998,2613.58673801098,19,29,1,1
"923401730",57,2921.63623644101,2707.02236739438,34,23,1,1
"923401731",42,3003.71959796834,2543.21752514954,26,16,1,1
"923401732",45,3177.85956966438,2579.33597919865,33,12,1,1
"923401733",40,2902.25548252736,2517.98110851286,27,13,1,1
"923401734",37,2814.44950318063,2478.17471526668,24,13,1,1
"923401735",52,2960.78485051046,2656.6981055205,31,21,1,1
"923401736",47,3144.66021208537,2602.36394728806,31,16,1,1
"923401737",46,2640.75026527273,2590.94954296761,32,14,1,1
"923401738",41,2751.09789800665,2530.72175773865,28,13,1,1
"923401739",73,3800.08300909379,2847.4358582506,43,30,1,1
"923401740",44,2804.88915449706,2567.51523707907,29,15,1,1
"923401759",43,2436.16901370111,2555.47878346624,23,20,1,1
"923401760",53,3315.20249589812,2667.061866114,30,23,1,1
"923401761",68,3298.3890938199,2806.43931339586,33,35,1,1
"923401762",65,2985.69152289075,2780.67589681985,33,32,1,1
"923401763",84,3451.60813470752,2930.30814451558,40,44,1,1
"923401764",58,3136.53459362181,2716.66249357165,33,25,1,1
"923401765",81,3656.99266995038,2908.60658576875,40,41,1,1
"923401766",78,3968.57182734882,2886.25582696583,36,42,1,1
"923401767",63,3333.66898590019,2762.96971264875,37,26,1,1
"923401768",65,2943.50270234541,2780.67589681985,29,36,1,1
"923401769",59,3475.666158222,2726.17127719361,39,20,1,1
"923401770",69,3965.37895732984,2814.82611826518,38,31,1,1
"923401771",47,3157.54400113235,2602.36394728806,24,23,1,1
"923401772",65,3123.18418840313,2780.67589681985,32,33,1,1
"923401773",56,3166.29008226574,2697.24673169728,29,27,1,1
"923401774",71,3170.31734458316,2831.31372136695,43,28,1,1
"923401776",40,2632.7899236029,2517.98110851286,17,23,1,1
"923401795",26,2735.80119882114,2305.75108410937,12,14,1,1
"923401796",40,3026.90840825312,2517.98110851286,14,26,1,1
"923401797",32,2622.00912207492,2405.71569249515,10,22,1,1
"923401798",47,3346.11746886531,2602.36394728806,13,34,1,1
"923401799",43,3206.6075559526,2555.47878346624,13,30,1,1
"923401800",45,3016.57807133018,2579.33597919865,13,32,1,1
"923401801",47,2831.28729778601,2602.36394728806,17,30,1,1
"923401802",44,3059.31746777673,2567.51523707907,13,31,1,1
"923401803",37,2831.18336383157,2478.17471526668,16,21,1,1
"923401804",51,3170.3513299169,2646.17454577679,19,32,1,1
"923401805",26,2573.2158850939,2305.75108410937,9,17,1,1
"923401806",28,2570.1948752768,2340.94327947849,10,18,1,1
"923401807",46,2615.78817901009,2590.94954296761,16,30,1,1
"923401808",45,3335.13005602785,2579.33597919865,22,23,1,1
"923401924",46,3007.14384259977,2590.94954296761,24,22,1,1
"923401926",28,2155.19621257289,2340.94327947849,18,10,1,1
"923401927",20,1792.80469646233,2185.35845629437,9,11,1,1
"923402020",33,2562.74886672865,2420.89448855093,19,14,1,1
"923402021",30,2423.75585252429,2374.18906024059,17,13,1,1
"923402022",30,2436.38343519056,2374.18906024059,16,14,1,1
"923402023",35,2382.10722801162,2450.1860183293,20,15,1,1
"923402024",28,2352.47946617086,2340.94327947849,17,11,1,1
"923402025",26,2422.46006563681,2305.75108410937,14,12,1,1
"923402026",31,2226.06230357528,2390.15469389133,19,12,1,1
"923402027",12,1857.28193662807,1968.69006049611,8,4,1,1
"923402028",17,2188.85243262716,2113.95669457394,9,8,1,1
"923402029",27,2699.39942677982,2323.60649590586,15,12,1,1
"923402030",5,1581.7340083554,1646.12614877363,2,3,1,1
"923402031",31,2438.56678391686,2390.15469389133,17,14,1,1
"923402032",24,2330.06730865839,2268.33468283819,13,11,1,1
"923402033",14,1892.67500507505,2031.70713799962,11,3,1,1
"923402034",38,2660.35871626406,2491.71993967651,20,18,1,1
"923402035",6,1700.82493022798,1708.62817714657,3,3,1,1
"923402036",12,1723.749246488,1968.69006049611,6,6,1,1
"923402037",33,2582.40877715696,2420.89448855093,16,17,1,1
"923402038",24,2531.21639576324,2268.33468283819,12,12,1,1
"923402039",30,2678.34123231033,2374.18906024059,16,14,1,1
"923402040",28,2614.44322373342,2340.94327947849,13,15,1,1
"923402041",17,1773.40034906617,2113.95669457394,9,8,1,1
"923402042",9,1801.45648227142,1856.26587460569,7,2,1,1
"923402043",32,2633.16353354882,2405.71569249515,19,13,1,1
"923402044",10,1761.97495314586,1896.67490607898,7,3,1,1
"923402045",8,1741.74006332377,1812.11073017574,4,4,1,1
"923402046",13,1757.80564658252,2001.16379457045,8,5,1,1
"923402047",7,1694.66909728615,1763.32076508842,5,2,1,1
"923402048",31,2695.09959712393,2390.15469389133,16,15,1,1
"923402049",9,1827.89422706563,1856.26587460569,3,6,1,1
"923402050",15,2014.13031219387,2060.56118614118,8,7,1,1
"923402051",28,2394.00598541599,2340.94327947849,16,12,1,1
"923402052",31,2567.75405784997,2390.15469389133,16,15,1,1
"923402053",28,2412.19904499573,2340.94327947849,16,12,1,1
"923402054",36,2600.38447589779,2464.33502634194,21,15,1,1
"923402055",2,1346.37516003337,1364.97646362037,1,1,1,1
"923402056",29,2682.84189384915,2357.79423966008,16,13,1,1
"923402057",32,2637.45677863601,2405.71569249515,17,15,1,1
"923402058",27,2542.59669978355,2323.60649590586,14,13,1,1
"923402059",36,2718.25005779043,2464.33502634194,21,15,1,1
"923402060",17,2207.92884137004,2113.95669457394,10,7,1,1
"923402061",39,2600.9273677623,2504.98447234734,20,19,1,1
"923402062",5,1639.25703112479,1646.12614877363,2,3,1,1
"923402063",6,1714.11951175923,1708.62817714657,3,3,1,1
"923402064",17,2089.13944780838,2113.95669457394,8,9,1,1
"923402065",26,2603.80681422536,2305.75108410937,15,11,1,1
"923402066",4,1535.84795864897,1572.73281143487,1,3,1,1
"923402067",14,1886.36990353279,2031.70713799962,9,5,1,1
"923402068",19,2119.47251813338,2162.56636020013,12,7,1,1
"923402069",28,2469.11562183354,2340.94327947849,16,12,1,1
"923402070",31,2426.3972125649,2390.15469389133,15,16,1,1
"923402071",19,2106.29488041584,2162.56636020013,10,9,1,1
"923402072",18,2067.61796578404,2138.79896507223,10,8,1,1
"923402073",15,2159.75810192268,2060.56118614118,8,7,1,1
"923402074",21,2376.78188766522,2207.26116887512,10,11,1,1
"923402075",10,1960.44011635045,1896.67490607898,6,4,1,1
"923402076",12,2024.14791708859,1968.69006049611,6,6,1,1
"923402077",25,2344.97932063079,2287.34065519221,12,13,1,1
"923402118",21,2132.77431407827,2207.26116887512,13,8,1,1
"923402119",19,2491.37060177708,2162.56636020013,11,8,1,1
"923402120",39,2821.90991285313,2504.98447234734,23,16,1,1
"923402121",39,2946.97114120862,2504.98447234734,18,21,1,1
"923402122",12,1857.40080893938,1968.69006049611,4,8,1,1
"923402123",23,2419.55385983439,2248.68783741607,10,13,1,1
"923402124",23,2408.11093070756,2248.68783741607,12,11,1,1
"923402125",32,2620.26111024835,2405.71569249515,14,18,1,1
"923402126",22,2167.83772557465,2228.3491786518,14,8,1,1
"923402127",29,2472.22079380435,2357.79423966008,16,13,1,1
"923402128",23,2482.23286929419,2248.68783741607,15,8,1,1
"923402129",22,2367.96497797779,2228.3491786518,14,8,1,1
"923402130",35,2771.09025453139,2450.1860183293,18,17,1,1
"923402131",19,2166.44087343447,2162.56636020013,12,7,1,1
"923402132",17,2304.32818119072,2113.95669457394,9,8,1,1
"923402133",27,2068.56461823869,2323.60649590586,9,18,1,1
"923402135",24,2168.2732529689,2268.33468283819,12,12,1,1
"923402136",33,2013.2022632608,2420.89448855093,11,22,1,1
"923402137",47,2510.88622170181,2602.36394728806,26,21,1,1
"923402138",39,2565.05352213383,2504.98447234734,23,16,1,1
"923402139",12,2075.97171618492,1968.69006049611,7,5,1,1
"923402140",21,2112.6947379942,2207.26116887512,13,8,1,1
"923402141",19,2339.29663546698,2162.56636020013,12,7,1,1
"923402142",41,2803.88393565498,2530.72175773865,22,19,1,1
"923402143",34,2899.39488556932,2435.71163614839,19,15,1,1
"923402144",16,2015.35403120362,2087.92318348224,8,8,1,1
"923402145",26,2423.62501399951,2305.75108410937,15,11,1,1
"923402146",20,2398.38929325932,2185.35845629437,11,9,1,1
"923402147",21,2188.49057895802,2207.26116887512,12,9,1,1
"923402148",32,2821.87336838549,2405.71569249515,20,12,1,1
"923402149",13,1967.85420807391,2001.16379457045,6,7,1,1
"923402150",21,2382.07096813388,2207.26116887512,10,11,1,1
"923402151",41,2591.02583362526,2530.72175773865,20,21,1,1
"923402152",17,2271.21162755949,2113.95669457394,11,6,1,1
"923402153",34,2669.00900192518,2435.71163614839,18,16,1,1
"923402155",24,2195.03563979172,2268.33468283819,14,10,1,1
"923402156",24,2332.24520945009,2268.33468283819,12,12,1,1
"923402157",17,2160.81629258408,2113.95669457394,9,8,1,1
"923402158",31,2496.24952970478,2390.15469389133,17,14,1,1
"923402159",24,2609.76602622318,2268.33468283819,12,12,1,1
"923402162",45,2674.8978760466,2579.33597919865,22,23,1,1
"923402163",59,2678.75071091466,2726.17127719361,39,20,1,1
"923402164",41,2547.22337707297,2530.72175773865,27,14,1,1
"923402165",49,2637.82732241184,2624.62502504328,24,25,1,1
"923402166",44,3044.68892767616,2567.51523707907,25,19,1,1
"923402167",58,2513.50249964064,2716.66249357165,36,22,1,1
"923402168",59,3293.8437324871,2726.17127719361,33,26,1,1
"923402169",62,3349.30592744969,2753.94837323248,32,30,1,1
"923402170",51,2651.85782972995,2646.17454577679,28,23,1,1
"923402171",63,2766.43080728565,2762.96971264875,36,27,1,1
"923402173",78,3338.63802664629,2886.25582696583,40,38,1,1
"923402174",38,2253.17972984009,2491.71993967651,21,17,1,1
"923402175",58,3161.96275067207,2716.66249357165,30,28,1,1
"923402919",53,2979.9497224913,2667.061866114,30,23,1,1
"923402920",46,2955.02329063773,2590.94954296761,22,24,1,1
"923402921",50,2602.90887445559,2635.48551585152,29,21,1,1
"923402922",43,2564.9469994517,2555.47878346624,23,20,1,1
"923402923",53,2401.01005545803,2667.061866114,27,26,1,1
"923402924",62,2655.21217349123,2753.94837323248,36,26,1,1
"923402925",38,2488.28185780128,2491.71993967651,20,18,1,1
"923402926",19,2171.56501625864,2162.56636020013,14,5,1,1
"923402927",66,3398.29146460745,2789.3669207067,33,33,1,1
"923402928",51,2805.39002942481,2646.17454577679,31,20,1,1
"923402929",42,2577.88882844506,2543.21752514954,26,16,1,1
"923402930",64,2639.47310941179,2771.87783482774,39,25,1,1
"923402931",45,2567.13482696164,2579.33597919865,27,18,1,1
"923402932",67,2888.58370719751,2797.95380131742,35,32,1,1
"923402933",54,2816.3651814707,2677.2712016452,29,25,1,1
"923402934",72,3250.96291999618,2839.4193288992,36,36,1,1
"923402937",66,3439.53634682391,2789.3669207067,33,33,1,1
"923402938",54,3053.95217738895,2677.2712016452,24,30,1,1
"923403188",39,2713.22722596504,2504.98447234734,23,16,1,1
"923403189",37,2332.20586447415,2478.17471526668,20,17,1,1
"923403190",33,2166.31895119312,2420.89448855093,17,16,1,1
"923403191",30,2545.68217293856,2374.18906024059,16,14,1,1
"923403192",33,2402.19454800958,2420.89448855093,16,17,1,1
"923403193",35,2435.47101164691,2450.1860183293,20,15,1,1
"923403194",33,2601.93284565523,2420.89448855093,18,15,1,1
"923403195",31,2430.68209605414,2390.15469389133,18,13,1,1
"923403196",33,2439.65880794462,2420.89448855093,19,14,1,1
"923403197",24,2216.33602915771,2268.33468283819,13,11,1,1
"923403198",36,2579.3025727641,2464.33502634194,21,15,1,1
"923403199",40,2447.82673450157,2517.98110851286,22,18,1,1
"923403205",29,2506.38812956964,2357.79423966008,19,10,1,1
"923403206",34,2389.91864079258,2435.71163614839,22,12,1,1
"923403207",28,2267.22795850067,2340.94327947849,17,11,1,1
"923403208",35,2549.53144183483,2450.1860183293,18,17,1,1
"923403209",33,2561.3368378494,2420.89448855093,20,13,1,1
"923403210",22,2265.27308475816,2228.3491786518,12,10,1,1
"923403211",35,2466.93018922279,2450.1860183293,19,16,1,1
"923403212",31,2595.5330741692,2390.15469389133,19,12,1,1
"923403213",30,2492.09609273608,2374.18906024059,16,14,1,1
"923403214",28,2532.20224622562,2340.94327947849,13,15,1,1
"923403215",34,2386.58971629672,2435.71163614839,20,14,1,1
"923403216",38,2537.94593001002,2491.71993967651,19,19,1,1
"923403217",32,2306.37903326669,2405.71569249515,21,11,1,1
"923403218",36,2527.50468947786,2464.33502634194,23,13,1,1
"923403219",34,2487.68702483628,2435.71163614839,18,16,1,1
"923403220",24,2316.91974327102,2268.33468283819,17,7,1,1
"923403221",23,2341.37259478519,2248.68783741607,13,10,1,1
"923403222",33,2537.79157738035,2420.89448855093,17,16,1,1
"923403223",29,2443.87100170872,2357.79423966008,17,12,1,1
"923403224",29,2407.74767544826,2357.79423966008,16,13,1,1
"923403225",66,3386.37564141004,2789.3669207067,39,27,1,1
"923403226",47,3022.13629593771,2602.36394728806,26,21,1,1
"923403227",30,2457.61910467678,2374.18906024059,17,13,1,1
"923403228",38,2844.07039652076,2491.71993967651,19,19,1,1
"923403229",23,2246.77956975106,2248.68783741607,16,7,1,1
"923403230",45,2915.59779071132,2579.33597919865,29,16,1,1
"923403231",76,3446.72193160944,2870.97236507783,35,41,1,1
"923403232",44,2916.05672489808,2567.51523707907,19,25,1,1
"923403233",23,2249.53772414701,2248.68783741607,7,16,1,1
"923403234",53,3121.8309858053,2667.061866114,24,29,1,1
"923403235",41,2505.59485211027,2530.72175773865,21,20,1,1
"923403236",52,3125.98698781509,2656.6981055205,32,20,1,1
"923403237",45,2890.29167983725,2579.33597919865,24,21,1,1
"923403238",18,2231.67931529941,2138.79896507223,8,10,1,1
"923403239",40,2914.76575255628,2517.98110851286,22,18,1,1
"923403240",56,3103.71962039098,2697.24673169728,30,26,1,1
"923403241",52,2974.32862564591,2656.6981055205,29,23,1,1
"923403242",45,3286.3402397464,2579.33597919865,27,18,1,1
"923403243",36,2871.48352556481,2464.33502634194,20,16,1,1
"923403244",34,2700.65010825691,2435.71163614839,17,17,1,1
"923403245",44,2802.15487924189,2567.51523707907,19,25,1,1
"923403246",50,3218.47887246559,2635.48551585152,26,24,1,1
"923403247",39,3016.14853224855,2504.98447234734,23,16,1,1
"923403248",20,2209.74015698274,2185.35845629437,9,11,1,1
"923403249",56,3232.89958088061,2697.24673169728,32,24,1,1
"923403250",64,3663.73617644051,2771.87783482774,29,35,1,1
"923403251",42,2566.83662275698,2543.21752514954,26,16,1,1
"923403252",35,2671.75105065741,2450.1860183293,20,15,1,1
"923403253",61,2996.38155432309,2744.81051624266,34,27,1,1
"923403254",33,2379.42047621279,2420.89448855093,19,14,1,1
"923403255",45,2946.38126346138,2579.33597919865,18,27,1,1
"923403256",42,2537.93840988947,2543.21752514954,26,16,1,1
"923403257",63,3204.38341262362,2762.96971264875,30,33,1,1
"923403258",36,2757.18424063159,2464.33502634194,18,18,1,1
"923403259",37,2537.23354132868,2478.17471526668,22,15,1,1
"923403260",64,3161.42867651931,2771.87783482774,28,36,1,1
"923403261",43,2422.06153467724,2555.47878346624,21,22,1,1
"923403262",50,3004.54136323143,2635.48551585152,20,30,1,1
"923403263",43,2698.64898967584,2555.47878346624,30,13,1,1
"923403264",43,3054.06959303553,2555.47878346624,23,20,1,1
"923403265",49,3136.9514452691,2624.62502504328,19,30,1,1
"923403266",46,2930.31705706093,2590.94954296761,26,20,1,1
"923403284",34,2557.35914105722,2435.71163614839,23,11,1,1
"923403285",46,3369.95038076751,2590.94954296761,31,15,1,1
"923403286",32,2784.2176409076,2405.71569249515,20,12,1,1
"923403287",47,3115.46789392389,2602.36394728806,30,17,1,1
"923403288",48,3182.2074762643,2613.58673801098,27,21,1,1
"923403289",36,3001.98272610756,2464.33502634194,23,13,1,1
"923403290",38,3030.52356058846,2491.71993967651,24,14,1,1
"923403291",37,2970.54313876115,2478.17471526668,26,11,1,1
"923403292",59,3548.61188339062,2726.17127719361,31,28,1,1
"923403293",52,3472.03532612186,2656.6981055205,30,22,1,1
"923403294",65,3468.88079080485,2780.67589681985,36,29,1,1
"923403295",46,2937.65483098631,2590.94954296761,31,15,1,1
"923403296",35,2727.39350653882,2450.1860183293,23,12,1,1
"923403297",35,2787.64532208488,2450.1860183293,23,12,1,1
"923403298",53,3181.93546669149,2667.061866114,30,23,1,1
"923403299",17,2264.31183646346,2113.95669457394,5,12,1,1
"923403300",35,2887.3261142104,2450.1860183293,18,17,1,1
"923403301",41,2864.94580779442,2530.72175773865,20,21,1,1
"923403303",19,2219.26410039973,2162.56636020013,9,10,1,1
"923403304",20,2195.37766659753,2185.35845629437,7,13,1,1
"923403305",38,2299.43381212556,2491.71993967651,18,20,1,1
"923403306",31,2250.47879892468,2390.15469389133,14,17,1,1
"923403307",32,2104.2786087617,2405.71569249515,16,16,1,1
"923403308",53,2437.89436784399,2667.061866114,21,32,1,1
"923403309",28,2160.54467200122,2340.94327947849,16,12,1,1
"923403310",23,2317.60020355666,2248.68783741607,9,14,1,1
"923403311",43,2988.2655240386,2555.47878346624,19,24,1,1
"923403312",41,3313.19576947266,2530.72175773865,22,19,1,1
"923403313",16,2060.29470813372,2087.92318348224,6,10,1,1
"923403314",30,2286.39292400329,2374.18906024059,16,14,1,1
"923403315",37,2813.16278979871,2478.17471526668,23,14,1,1
"923403316",46,3123.19322594088,2590.94954296761,24,22,1,1
"923403318",15,2090.12515764274,2060.56118614118,7,8,1,1
"923403319",19,1966.42554208274,2162.56636020013,7,12,1,1
"923403320",33,2100.1051983949,2420.89448855093,16,17,1,1
"923403321",18,1941.54428258427,2138.79896507223,6,12,1,1
"923403322",35,2959.07414056798,2450.1860183293,17,18,1,1
"923403323",37,2377.04122351645,2478.17471526668,17,20,1,1
"923403325",29,2279.07581617038,2357.79423966008,14,15,1,1
"923403326",18,2213.11521147026,2138.79896507223,7,11,1,1
"923403327",46,3219.40697173191,2590.94954296761,26,20,1,1
"923403328",65,2703.22142509173,2780.67589681985,25,40,1,1
"923403329",14,1999.0317721459,2031.70713799962,3,11,1,1
"923403330",42,3084.87425622371,2543.21752514954,23,19,1,1
"923403331",36,3024.15012004579,2464.33502634194,21,15,1,1
"923403332",39,2626.88176452202,2504.98447234734,21,18,1,1
"923403333",15,1977.77612617381,2060.56118614118,8,7,1,1
"923403334",23,2004.98397099138,2248.68783741607,9,14,1,1
"923403335",34,2178.99087539687,2435.71163614839,18,16,1,1
"923403336",33,2912.17534290316,2420.89448855093,18,15,1,1
"923403337",44,2963.0788920149,2567.51523707907,24,20,1,1
"923403338",20,2182.66702946326,2185.35845629437,12,8,1,1
"923403339",19,1960.26301008009,2162.56636020013,6,13,1,1
"923403341",46,3121.6741718909,2590.94954296761,29,17,1,1
"923403342",32,2242.12901161428,2405.71569249515,15,17,1,1
"923403343",42,3003.39906968341,2543.21752514954,21,21,1,1
"923403344",48,3078.84541101979,2613.58673801098,25,23,1,1
"923403345",71,3398.66916861732,2831.31372136695,40,31,1,1
"923403346",50,2992.81119714681,2635.48551585152,29,21,1,1
"923403347",55,2783.11139465916,2687.33120998132,29,26,1,1
"923403348",55,3312.29310984356,2687.33120998132,31,24,1,1
"923403349",65,3479.0410316715,2780.67589681985,33,32,1,1
"923403350",41,2606.90604679172,2530.72175773865,21,20,1,1
"923403351",68,3315.8350008866,2806.43931339586,35,33,1,1
"923403352",49,2985.66065707755,2624.62502504328,27,22,1,1
"923403353",59,3126.72886928333,2726.17127719361,30,29,1,1
"923403354",61,2936.61664752625,2744.81051624266,30,31,1,1
"923403355",50,2748.34566978475,2635.48551585152,32,18,1,1
"923403356",45,3078.10994615541,2579.33597919865,23,22,1,1
"923403357",56,3383.67842098488,2697.24673169728,30,26,1,1
"923403358",59,3451.46737960968,2726.17127719361,32,27,1,1
"923403359",51,2510.68865523525,2646.17454577679,26,25,1,1
"923403360",48,2506.14694535363,2613.58673801098,28,20,1,1
"923403361",50,2919.79540420319,2635.48551585152,26,24,1,1
"923403362",74,4374.32931245581,2855.36548874306,36,38,1,1
"923403363",78,3615.28177922222,2886.25582696583,40,38,1,1
"923403364",81,3119.80978488737,2908.60658576875,44,37,1,1
"923403365",32,2650.04281406182,2405.71569249515,19,13,1,1
"923403366",47,2789.42557590326,2602.36394728806,26,21,1,1
"923403367",57,3162.59073211909,2707.02236739438,29,28,1,1
"923403368",45,3268.62608943029,2579.33597919865,22,23,1,1
"923403369",73,3698.87010506041,2847.4358582506,40,33,1,1
"923403370",52,3460.88121634951,2656.6981055205,30,22,1,1
"923403371",44,2750.26945751244,2567.51523707907,20,24,1,1
"923403372",65,3303.46665226639,2780.67589681985,36,29,1,1
"923403373",79,3331.75634058135,2893.78092561085,43,36,1,1
"923403374",48,2907.73694377838,2613.58673801098,28,20,1,1
"923403375",48,2908.68400872493,2613.58673801098,24,24,1,1
"923403376",37,2749.6045506267,2478.17471526668,24,13,1,1
"923403377",39,2745.34244859843,2504.98447234734,21,18,1,1
"923403378",42,2501.85950332019,2543.21752514954,23,19,1,1
"923403379",59,3173.1747213889,2726.17127719361,28,31,1,1
"923403380",44,2848.31058450294,2567.51523707907,29,15,1,1
"923403381",35,2950.80126007125,2450.1860183293,21,14,1,1
"923403382",30,2626.85214108818,2374.18906024059,20,10,1,1
"923403383",76,4051.40517552567,2870.97236507783,40,36,1,1
"923403384",61,2773.2545332224,2744.81051624266,32,29,1,1
"923403385",66,3213.14063565791,2789.3669207067,36,30,1,1
"923403386",70,3231.69641709692,2823.11677003184,44,26,1,1
"923403387",81,2672.73720210963,2908.60658576875,42,39,1,1
"923403388",62,3447.66266575643,2753.94837323248,34,28,1,1
"923403389",68,3104.37484007811,2806.43931339586,36,32,1,1
"923403391",63,3102.07383072172,2762.96971264875,33,30,1,1
"923403392",72,3480.14636064089,2839.4193288992,34,38,1,1
"923403393",58,3007.68952838831,2716.66249357165,33,25,1,1
"923403394",36,2527.26908681369,2464.33502634194,21,15,1,1
"923403395",79,2905.19049207326,2893.78092561085,45,34,1,1
"923403396",59,3567.69081550908,2726.17127719361,27,32,1,1
"923403397",34,2702.82453588538,2435.71163614839,19,15,1,1
"923403398",64,3394.95146422599,2771.87783482774,35,29,1,1
"923403399",54,3377.01333883518,2677.2712016452,28,26,1,1
"923403400",38,2607.83086885386,2491.71993967651,20,18,1,1
"923403402",46,3294.18441569994,2590.94954296761,31,15,1,1
"923403403",48,2574.5276400268,2613.58673801098,28,20,1,1
"923403404",61,3029.84436667359,2744.81051624266,30,31,1,1
"923403405",62,3254.32724434649,2753.94837323248,35,27,1,1
"923403406",60,3212.5940792956,2735.5526890818,37,23,1,1
"923403407",53,2646.49210768779,2667.061866114,27,26,1,1
"923403408",71,3928.3560400842,2831.31372136695,39,32,1,1
"923403409",53,3273.53549754142,2667.061866114,29,24,1,1
"923403410",63,3206.08402358765,2762.96971264875,38,25,1,1
"923403411",74,3848.00161507384,2855.36548874306,36,38,1,1
"923403412",42,2803.08112388325,2543.21752514954,23,19,1,1
"923403413",49,2858.00154709076,2624.62502504328,28,21,1,1
"923403414",71,3803.79926135046,2831.31372136695,40,31,1,1
"923403415",88,4128.53140969349,2958.30409156145,48,40,1,1
"923403416",73,2902.38388526377,2847.4358582506,41,32,1,1
"923403417",41,2885.53373937914,2530.72175773865,25,16,1,1
"923403418",79,3157.734205535,2893.78092561085,42,37,1,1
"923403419",72,2772.58409784199,2839.4193288992,43,29,1,1
"923403420",41,2493.41968783346,2530.72175773865,29,12,1,1
"923403421",75,2834.4284479779,2863.21031780169,42,33,1,1
"923403422",70,3171.58355166519,2823.11677003184,42,28,1,1
"923403423",57,2566.38869865586,2707.02236739438,36,21,1,1
"923403424",38,2655.4644455318,2491.71993967651,18,20,1,1
"923403425",67,3113.0901831906,2797.95380131742,42,25,1,1
"923403426",73,3129.88730221165,2847.4358582506,41,32,1,1
"923403427",66,3494.60020881274,2789.3669207067,35,31,1,1
"923403428",43,2858.65446170545,2555.47878346624,26,17,1,1
"923403429",66,3124.35383388312,2789.3669207067,36,30,1,1
"923403430",60,3673.3074645413,2735.5526890818,31,29,1,1
"923403431",51,3090.57801347996,2646.17454577679,25,26,1,1
"923403432",68,3395.67142044265,2806.43931339586,34,34,1,1
"923403433",34,2641.63676828322,2435.71163614839,22,12,1,1
"923403434",67,3515.90831791779,2797.95380131742,39,28,1,1
"923403435",75,2914.35643394382,2863.21031780169,40,35,1,1
"923403436",39,2477.66121282648,2504.98447234734,24,15,1,1
"923403437",87,3445.71132894154,2951.40156710974,45,42,1,1
"923403438",72,3861.21504635409,2839.4193288992,36,36,1,1
"923403439",61,3229.36094034266,2744.81051624266,36,25,1,1
"923403440",76,2931.26818332506,2870.97236507783,39,37,1,1
"923403441",47,3129.34398504214,2602.36394728806,29,18,1,1
"923403442",37,2701.83805099274,2478.17471526668,21,16,1,1
"923403443",76,3863.32256348099,2870.97236507783,36,40,1,1
"923403444",67,3651.77891872032,2797.95380131742,32,35,1,1
"923403445",46,2966.08117270852,2590.94954296761,25,21,1,1
"923403446",62,3820.38507067704,2753.94837323248,35,27,1,1
"923403447",55,3425.09368548924,2687.33120998132,35,20,1,1
"923403448",56,3712.9820729769,2697.24673169728,32,24,1,1
"923403449",75,3425.83520286685,2863.21031780169,41,34,1,1
"923403450",50,3211.27964308773,2635.48551585152,30,20,1,1
"923403451",43,2590.79784083894,2555.47878346624,20,23,1,1
"923403452",42,2681.18446022153,2543.21752514954,21,21,1,1
"923403453",48,3348.66286479402,2613.58673801098,30,18,1,1
"923403454",67,3176.74485097414,2797.95380131742,29,38,1,1
"923403455",47,2792.06992973565,2602.36394728806,28,19,1,1
"923403456",56,3257.95218251756,2697.24673169728,29,27,1,1
"923403457",36,2722.86926626303,2464.33502634194,22,14,1,1
"923403458",45,2655.42951277116,2579.33597919865,26,19,1,1
"923403459",59,2685.29213472345,2726.17127719361,32,27,1,1
"923403460",54,3104.1520071433,2677.2712016452,31,23,1,1
"923403461",41,2600.55397962411,2530.72175773865,22,19,1,1
"923403462",40,2702.84356009604,2517.98110851286,24,16,1,1
"923403463",53,3209.09173708587,2667.061866114,29,24,1,1
"923403464",46,2670.13027143989,2590.94954296761,26,20,1,1
"923403670",19,2164.44660042119,2162.56636020013,10,9,1,1
"923403671",25,2315.03375571891,2287.34065519221,10,15,1,1
"923403672",14,2127.99084422574,2031.70713799962,8,6,1,1
"923403673",21,2354.31726233076,2207.26116887512,12,9,1,1
"923403674",17,2182.93965268045,2113.95669457394,10,7,1,1
"923403675",18,2211.43117623566,2138.79896507223,11,7,1,1
"923403676",24,2089.69746108624,2268.33468283819,12,12,1,1
"923403677",24,2320.62157886192,2268.33468283819,15,9,1,1
"923403679",23,2422.71481080924,2248.68783741607,12,11,1,1
"923403680",30,2732.11009909089,2374.18906024059,16,14,1,1
"923403681",31,2589.68452468011,2390.15469389133,14,17,1,1
"923403682",32,2617.4550503054,2405.71569249515,14,18,1,1
"923403683",21,2440.68140705201,2207.26116887512,11,10,1,1
"923403684",38,2548.73070658235,2491.71993967651,23,15,1,1
"923403685",37,2841.13963653263,2478.17471526668,21,16,1,1
"923403686",26,2504.83238626935,2305.75108410937,15,11,1,1
"923403687",31,2834.83887461815,2390.15469389133,13,18,1,1
"923403688",27,2599.11828103493,2323.60649590586,16,11,1,1
"923403701",48,2990.93640826353,2613.58673801098,19,29,1,1
"923403702",47,2902.53013593209,2602.36394728806,20,27,1,1
"923403703",38,2986.83866722843,2491.71993967651,16,22,1,1
"923403704",27,2537.98103083004,2323.60649590586,18,9,1,1
"923403705",42,2716.06266042545,2543.21752514954,24,18,1,1
"923403706",52,3478.52155815192,2656.6981055205,24,28,1,1
"923403707",55,3369.56622204247,2687.33120998132,26,29,1,1
"923403708",13,2029.58946759973,2001.16379457045,4,9,1,1
"923403709",26,2237.42919440628,2305.75108410937,9,17,1,1
"923403710",34,2707.7984633285,2435.71163614839,13,21,1,1
"923403711",30,2223.51357190666,2374.18906024059,12,18,1,1
"923403712",43,3288.15524224404,2555.47878346624,15,28,1,1
"923403713",56,2933.93857200309,2697.24673169728,30,26,1,1
"923403714",69,3485.2551019543,2814.82611826518,28,41,1,1
"923403715",48,3137.65546841875,2613.58673801098,20,28,1,1
"923403716",42,2957.96286927873,2543.21752514954,16,26,1,1
"923403717",55,3505.26146155506,2687.33120998132,24,31,1,1
"923403718",30,2278.24361464947,2374.18906024059,14,16,1,1
"923403720",48,3026.63930126731,2613.58673801098,23,25,1,1
"923403721",52,2959.73506436255,2656.6981055205,24,28,1,1
"923403722",11,1981.46186676024,1933.98659929558,5,6,1,1
"923403723",59,3423.62841824277,2726.17127719361,25,34,1,1
"923403724",14,1884.73065042758,2031.70713799962,7,7,1,1
"923403725",37,2348.32497045102,2478.17471526668,18,19,1,1
"923403726",41,2487.95675842755,2530.72175773865,20,21,1,1
"923403727",64,3080.63658252372,2771.87783482774,32,32,1,1
"923403728",21,2220.15328340815,2207.26116887512,11,10,1,1
"923403729",39,2916.87592793641,2504.98447234734,18,21,1,1
"923403730",46,3390.84440647724,2590.94954296761,18,28,1,1
"923403731",49,3339.77866937913,2624.62502504328,18,31,1,1
"923403732",36,2556.82416964755,2464.33502634194,24,12,1,1
"923403733",47,2855.85235859837,2602.36394728806,25,22,1,1
"923403734",34,2106.63430754,2435.71163614839,22,12,1,1
"923403735",37,2917.53232707243,2478.17471526668,16,21,1,1
"923403736",25,2229.21447143355,2287.34065519221,13,12,1,1
"923403737",39,2962.94676718494,2504.98447234734,15,24,1,1
"923403738",49,2377.37849471438,2624.62502504328,22,27,1,1
"923403739",18,2160.16189848281,2138.79896507223,10,8,1,1
"923403740",39,2962.6427707794,2504.98447234734,15,24,1,1
"923403741",20,2102.25059929356,2185.35845629437,8,12,1,1
"923403743",60,3076.09006907992,2735.5526890818,26,34,1,1
"923403744",50,2949.586534721,2635.48551585152,19,31,1,1
"923403745",28,2337.06975352979,2340.94327947849,18,10,1,1
"923403746",52,3514.6911780161,2656.6981055205,23,29,1,1
"923403747",31,2259.62509376178,2390.15469389133,15,16,1,1
"923403748",20,2124.73472018795,2185.35845629437,14,6,1,1
"923403749",37,2581.61879748543,2478.17471526668,17,20,1,1
"923403750",52,3231.22692012819,2656.6981055205,21,31,1,1
"923403751",31,2262.66758745245,2390.15469389133,18,13,1,1
"923403752",44,2708.03885281545,2567.51523707907,19,25,1,1
"923403753",62,2685.41846266656,2753.94837323248,33,29,1,1
"923403754",65,3126.29002777261,2780.67589681985,33,32,1,1
"923403755",57,3264.49608142384,2707.02236739438,31,26,1,1
"923403756",25,2378.15115183041,2287.34065519221,11,14,1,1
"923403757",18,2278.54386936307,2138.79896507223,9,9,1,1
"923403758",22,2141.07955875317,2228.3491786518,13,9,1,1
"923403759",48,3272.66884882489,2613.58673801098,16,32,1,1
"923403760",21,1949.12855334712,2207.26116887512,7,14,1,1
"923403761",55,3376.99002859996,2687.33120998132,26,29,1,1
"923403762",24,2298.752767476,2268.33468283819,15,9,1,1
"923403763",60,2798.18687790908,2735.5526890818,27,33,1,1
"923403764",20,2121.03625070901,2185.35845629437,10,10,1,1
"923403765",42,2937.24610769886,2543.21752514954,16,26,1,1
"923403766",35,2506.37943288261,2450.1860183293,20,15,1,1
"923403767",47,3252.44999874389,2602.36394728806,17,30,1,1
"923403768",60,3781.45985302547,2735.5526890818,25,35,1,1
"923403769",51,3215.04642375121,2646.17454577679,23,28,1,1
"923403770",54,3444.43313483036,2677.2712016452,28,26,1,1
"923403771",24,2337.43956419175,2268.33468283819,13,11,1,1
"923403772",49,2900.56465889461,2624.62502504328,21,28,1,1
"923403773",55,3604.96360355888,2687.33120998132,23,32,1,1
"923403774",51,3047.24200553929,2646.17454577679,23,28,1,1
"923403775",24,2293.1773331003,2268.33468283819,14,10,1,1
"923403776",52,2356.07252957876,2656.6981055205,18,34,1,1
"923403777",44,2966.48709349316,2567.51523707907,21,23,1,1
"923403778",43,3261.46357579222,2555.47878346624,20,23,1,1
"923403779",30,2287.0485667319,2374.18906024059,15,15,1,1
"923403780",53,3311.97058165486,2667.061866114,25,28,1,1
"923403781",39,2695.15443498951,2504.98447234734,16,23,1,1
"923403782",59,2712.81195475916,2726.17127719361,25,34,1,1
"923403783",51,3103.45139876514,2646.17454577679,20,31,1,1
"923403784",38,2621.10353892361,2491.71993967651,18,20,1,1
"923403785",57,3156.7448153424,2707.02236739438,28,29,1,1
"923403786",34,2461.23674927349,2435.71163614839,14,20,1,1
"923403787",69,3320.76306601902,2814.82611826518,29,40,1,1
"923403788",22,2252.43692717919,2228.3491786518,11,11,1,1
"923403789",37,2476.15335263557,2478.17471526668,19,18,1,1
"923403790",58,2514.70646142311,2716.66249357165,30,28,1,1
"923403791",69,3063.40914889857,2814.82611826518,35,34,1,1
"923403792",12,1885.31883749026,1968.69006049611,5,7,1,1
"923403793",55,3292.5243425313,2687.33120998132,24,31,1,1
"923403795",67,2828.09684398313,2797.95380131742,37,30,1,1
"923403796",46,3033.25067973893,2590.94954296761,23,23,1,1
"923403797",32,2926.71749884206,2405.71569249515,16,16,1,1
"923403798",56,3295.74997866965,2697.24673169728,27,29,1,1
"923403799",56,3168.63206853575,2697.24673169728,23,33,1,1
"923403800",9,1874.90677641148,1856.26587460569,3,6,1,1
"923403801",64,3288.798643665,2771.87783482774,32,32,1,1
"923403802",40,2284.07363947862,2517.98110851286,21,19,1,1
"923403803",60,2982.38479742992,2735.5526890818,22,38,1,1
"923403804",15,1930.03871164009,2060.56118614118,4,11,1,1
"923403805",17,2202.29893023328,2113.95669457394,9,8,1,1
"923403806",23,2238.70953134161,2248.68783741607,12,11,1,1
"923403807",43,2892.44540601398,2555.47878346624,19,24,1,1
"923403808",40,2978.47816965546,2517.98110851286,17,23,1,1
"923403809",27,2148.21604041925,2323.60649590586,14,13,1,1
"923403810",30,2417.11872870702,2374.18906024059,18,12,1,1
"923403811",17,1943.7729728694,2113.95669457394,5,12,1,1
"923403812",72,3325.38580074394,2839.4193288992,33,39,1,1
"923403813",43,2669.48708976532,2555.47878346624,20,23,1,1
"923403814",44,3130.39503093952,2567.51523707907,18,26,1,1
"923403815",38,3029.51330873662,2491.71993967651,16,22,1,1
"923403816",28,2043.6979969854,2340.94327947849,13,15,1,1
"923403817",58,2615.02204209234,2716.66249357165,33,25,1,1
"923403818",31,2666.82042849145,2390.15469389133,17,14,1,1
"923403819",21,2225.67106085539,2207.26116887512,13,8,1,1
"923403820",41,3133.04947687552,2530.72175773865,20,21,1,1
"923403821",15,2046.52747393938,2060.56118614118,7,8,1,1
"923403822",46,2999.70537952383,2590.94954296761,25,21,1,1
"923403823",38,2130.19777780153,2491.71993967651,19,19,1,1
"923403824",51,2451.26624064838,2646.17454577679,28,23,1,1
"923403825",31,2395.28048771436,2390.15469389133,16,15,1,1
"923403826",47,3143.17243024394,2602.36394728806,21,26,1,1
"923403827",41,2696.5078645651,2530.72175773865,26,15,1,1
"923403828",41,2522.4030605734,2530.72175773865,19,22,1,1
"923403829",42,2957.31034829289,2543.21752514954,23,19,1,1
"923403830",43,2961.28518734205,2555.47878346624,20,23,1,1
"923403831",10,1821.48520519819,1896.67490607898,2,8,1,1
"923403832",62,3402.02256311845,2753.94837323248,27,35,1,1
"923403833",53,3128.5281058188,2667.061866114,25,28,1,1
"923403834",40,2472.92747155201,2517.98110851286,19,21,1,1
"923403835",34,2478.36066687389,2435.71163614839,15,19,1,1
"923403836",54,2719.68866311562,2677.2712016452,30,24,1,1
"923403837",47,3310.27382243698,2602.36394728806,23,24,1,1
"923403838",41,2586.40980772744,2530.72175773865,19,22,1,1
"923403839",31,2426.94532064294,2390.15469389133,12,19,1,1
"923403840",58,2713.41575561337,2716.66249357165,26,32,1,1
"923403841",73,3483.92372462751,2847.4358582506,31,42,1,1
"923403842",32,2332.43426085462,2405.71569249515,19,13,1,1
"923403843",46,3426.72827634983,2590.94954296761,17,29,1,1
"923403844",60,3460.82819425995,2735.5526890818,28,32,1,1
"923403845",15,2225.02274559565,2060.56118614118,4,11,1,1
"923403846",15,2232.85934530534,2060.56118614118,8,7,1,1
"923403847",36,2743.39494357665,2464.33502634194,16,20,1,1
"923403848",30,2415.20106827825,2374.18906024059,15,15,1,1
"923403849",56,3107.17006708546,2697.24673169728,19,37,1,1
"923403850",43,2763.84782551556,2555.47878346624,18,25,1,1
"923403851",58,2941.38705483899,2716.66249357165,26,32,1,1
"923403852",60,2573.44728916538,2735.5526890818,30,30,1,1
"923403853",12,1802.36698347703,1968.69006049611,5,7,1,1
"923403854",57,3607.99026752846,2707.02236739438,24,33,1,1
"923403855",13,1937.13160016453,2001.16379457045,6,7,1,1
"923403856",43,2734.67198750704,2555.47878346624,20,23,1,1
"923403857",47,2792.85703264143,2602.36394728806,20,27,1,1
"923403858",31,2517.4336530217,2390.15469389133,15,16,1,1
"923403859",46,3079.40735220721,2590.94954296761,20,26,1,1
"923403860",49,2920.70225554471,2624.62502504328,23,26,1,1
"923403861",34,2957.13468355391,2435.71163614839,13,21,1,1
"923403862",85,3384.85823621672,2937.40494579778,31,54,1,1
"923403863",39,3077.73505380284,2504.98447234734,16,23,1,1
"923403864",48,3192.14262289787,2613.58673801098,25,23,1,1
"923403865",48,2694.259110788,2613.58673801098,22,26,1,1
"923403866",38,2861.69051155269,2491.71993967651,20,18,1,1
"923403867",59,2812.36157139361,2726.17127719361,30,29,1,1
"923403868",36,2696.04063815133,2464.33502634194,16,20,1,1
"923403869",33,2132.44764270112,2420.89448855093,18,15,1,1
"923403870",47,3404.40865365016,2602.36394728806,19,28,1,1
"923403871",22,2216.54627070578,2228.3491786518,12,10,1,1
"923403872",47,3382.83966880783,2602.36394728806,15,32,1,1
"923403873",44,3151.57673319119,2567.51523707907,22,22,1,1
"923403874",38,2763.86302648593,2491.71993967651,18,20,1,1
"923403875",13,1819.18917428619,2001.16379457045,7,6,1,1
"923403876",47,2854.50483879191,2602.36394728806,23,24,1,1
"923403877",40,2784.26387029448,2517.98110851286,20,20,1,1
"923403878",30,2460.42001291911,2374.18906024059,12,18,1,1
"923403879",47,3226.68807513042,2602.36394728806,20,27,1,1
"923403880",65,3832.11808901022,2780.67589681985,27,38,1,1
"923403881",48,3311.21580926052,2613.58673801098,23,25,1,1
"923403882",31,2410.1311911814,2390.15469389133,17,14,1,1
"923403883",31,2294.83909112764,2390.15469389133,17,14,1,1
"923403884",23,2240.80339741708,2248.68783741607,12,11,1,1
"923403885",62,3256.22421108103,2753.94837323248,30,32,1,1
"923403886",24,2266.4400428273,2268.33468283819,13,11,1,1
"923403887",11,1839.22530680128,1933.98659929558,6,5,1,1
"923403888",55,3318.94697172184,2687.33120998132,20,35,1,1
"923403889",36,2600.36580407448,2464.33502634194,15,21,1,1
"923403890",39,2631.01610725259,2504.98447234734,19,20,1,1
"923403891",44,2570.35634524994,2567.51523707907,20,24,1,1
"923403892",29,2224.15541143698,2357.79423966008,14,15,1,1
"923403893",45,3301.67747975574,2579.33597919865,18,27,1,1
"923403894",33,2865.87976855712,2420.89448855093,11,22,1,1
"923403895",54,3296.66701190973,2677.2712016452,25,29,1,1
"923403896",55,3264.89674933669,2687.33120998132,23,32,1,1
"923403897",68,3247.54754669415,2806.43931339586,26,42,1,1
"923403898",27,2379.22377799986,2323.60649590586,13,14,1,1
"923403899",43,2798.67419412809,2555.47878346624,21,22,1,1
"923403900",45,2693.87619336858,2579.33597919865,19,26,1,1
"923403901",53,3141.98203895807,2667.061866114,22,31,1,1
"923403902",15,1870.27500801944,2060.56118614118,7,8,1,1
"923403903",65,3205.55924290336,2780.67589681985,31,34,1,1
"923403904",35,2645.86554737418,2450.1860183293,15,20,1,1
"923403905",53,2981.89603936715,2667.061866114,23,30,1,1
"923403906",41,3282.73495259631,2530.72175773865,20,21,1,1
"923403907",23,2229.49462048388,2248.68783741607,13,10,1,1
"923403908",31,2807.45795382198,2390.15469389133,13,18,1,1
"923403909",33,2703.18895660703,2420.89448855093,14,19,1,1
"923403910",39,2793.11626517867,2504.98447234734,17,22,1,1
"923403911",28,2186.63885080999,2340.94327947849,15,13,1,1
"923403912",58,3330.31009495297,2716.66249357165,27,31,1,1
"923403913",45,3105.18673396453,2579.33597919865,19,26,1,1
"923403914",38,2675.90291477162,2491.71993967651,13,25,1,1
"923403915",47,2891.45756766937,2602.36394728806,18,29,1,1
"923403916",55,3752.66779768225,2687.33120998132,25,30,1,1
"923403917",52,3049.39451726991,2656.6981055205,21,31,1,1
"923403918",34,2731.29963214518,2435.71163614839,16,18,1,1
"923403919",69,2808.86579826829,2814.82611826518,33,36,1,1
"923403920",32,2107.89822098367,2405.71569249515,15,17,1,1
"923403921",70,2876.34568720128,2823.11677003184,29,41,1,1
"923403922",15,1888.33518544263,2060.56118614118,5,10,1,1
"923403952",37,3167.72166303769,2478.17471526668,21,16,1,1
"923403953",48,2857.68983162543,2613.58673801098,19,29,1,1
"923403954",61,2721.80167919089,2744.81051624266,27,34,1,1
"923403955",29,2338.19258273299,2357.79423966008,14,15,1,1
"923403956",36,3003.37943787274,2464.33502634194,12,24,1,1
"923403957",40,2681.60195934217,2517.98110851286,19,21,1,1
"923403958",57,3111.13037450912,2707.02236739438,25,32,1,1
"923403959",24,2450.77341583573,2268.33468283819,10,14,1,1
"923403960",52,3649.50600279713,2656.6981055205,25,27,1,1
"923403961",51,3478.1771982682,2646.17454577679,21,30,1,1
"923403962",30,2750.95968591164,2374.18906024059,13,17,1,1
"923403963",56,2813.38901163443,2697.24673169728,23,33,1,1
"923403964",59,3608.86970510968,2726.17127719361,31,28,1,1
"923403965",45,3259.64825463696,2579.33597919865,24,21,1,1
"923403966",59,3439.1685043843,2726.17127719361,28,31,1,1
"923403967",66,3049.17934531875,2789.3669207067,29,37,1,1
"923403968",31,2779.92290117875,2390.15469389133,17,14,1,1
"923403969",27,2492.2431614353,2323.60649590586,16,11,1,1
"923403970",68,3849.58971782366,2806.43931339586,27,41,1,1
"923403971",39,3114.58485871992,2504.98447234734,17,22,1,1
"923403972",42,3394.37071785666,2543.21752514954,21,21,1,1
"923403974",48,3572.18986768533,2613.58673801098,20,28,1,1
"923403975",37,2837.41492288592,2478.17471526668,13,24,1,1
"923403976",52,2970.17777591549,2656.6981055205,22,30,1,1
"923403977",27,2636.65042409828,2323.60649590586,12,15,1,1
"923403978",43,3056.61334116829,2555.47878346624,19,24,1,1
"923403979",41,3310.66574033475,2530.72175773865,17,24,1,1
"923403980",40,2760.11423837468,2517.98110851286,16,24,1,1
"923403981",48,3424.40737852042,2613.58673801098,24,24,1,1
"923403982",26,2543.74766819428,2305.75108410937,16,10,1,1
"923403983",22,2402.2871368594,2228.3491786518,10,12,1,1
"923403984",55,3522.00865250511,2687.33120998132,19,36,1,1
"923403985",33,2509.31149326645,2420.89448855093,18,15,1,1
"923403986",33,2835.15962231468,2420.89448855093,16,17,1,1
"923403987",74,3552.25919050135,2855.36548874306,32,42,1,1
"923403988",50,3635.8862975144,2635.48551585152,25,25,1,1
"923403989",55,3215.78773624618,2687.33120998132,25,30,1,1
"923403990",41,2759.88711615689,2530.72175773865,13,28,1,1
"923403991",62,3143.93203544959,2753.94837323248,26,36,1,1
"923403992",44,3203.29758945476,2567.51523707907,18,26,1,1
"923403993",64,3420.88254591456,2771.87783482774,36,28,1,1
"923403994",34,2754.57571062282,2435.71163614839,14,20,1,1
"923403995",35,2530.48927169637,2450.1860183293,16,19,1,1
"923403996",48,3102.84329063733,2613.58673801098,24,24,1,1
"923403997",49,3145.89638227051,2624.62502504328,25,24,1,1
"923403998",48,3279.94716658908,2613.58673801098,24,24,1,1
"923403999",66,3361.87860523257,2789.3669207067,32,34,1,1
"923404000",55,3452.5524323296,2687.33120998132,19,36,1,1
"923404001",42,3115.16178541955,2543.21752514954,17,25,1,1
"923404002",48,3254.95226913388,2613.58673801098,16,32,1,1
"923404003",28,2783.96778369143,2340.94327947849,10,18,1,1
"923404004",63,3582.24091070932,2762.96971264875,32,31,1,1
"923404005",44,3003.31701546452,2567.51523707907,18,26,1,1
"923404006",53,3344.93424796512,2667.061866114,29,24,1,1
"923404007",32,2665.36957475035,2405.71569249515,12,20,1,1
"923404008",56,3657.60696044985,2697.24673169728,24,32,1,1
"923404009",47,3056.32731759042,2602.36394728806,21,26,1,1
"923404010",76,3585.244408787,2870.97236507783,32,44,1,1
"923404011",41,3247.42776615644,2530.72175773865,16,25,1,1
"923404012",45,2933.67804596834,2579.33597919865,22,23,1,1
"923404013",54,3758.16612095483,2677.2712016452,22,32,1,1
"923404014",40,2674.22461363835,2517.98110851286,16,24,1,1
"923404015",49,3049.85507433214,2624.62502504328,17,32,1,1
"923404016",42,3034.06428235275,2543.21752514954,15,27,1,1
"923404017",51,2786.1868717687,2646.17454577679,20,31,1,1
"923404018",49,2655.86189901465,2624.62502504328,22,27,1,1
"923404019",44,2988.11803070327,2567.51523707907,24,20,1,1
"923404020",48,2991.26292247314,2613.58673801098,28,20,1,1
"923404021",38,2879.79802825275,2491.71993967651,17,21,1,1
"923404022",38,2835.43241890847,2491.71993967651,15,23,1,1
"923404023",43,2713.12968510493,2555.47878346624,16,27,1,1
"923404024",38,3000.91875184494,2491.71993967651,13,25,1,1
"923404025",37,2878.2398748252,2478.17471526668,14,23,1,1
"923404026",40,2874.16892860583,2517.98110851286,19,21,1,1
"923404027",40,2950.07380895987,2517.98110851286,17,23,1,1
"923404028",40,2899.5006995003,2517.98110851286,17,23,1,1
"923404029",53,2867.53998217115,2667.061866114,25,28,1,1
"923404030",58,2997.65044164417,2716.66249357165,26,32,1,1
"923404031",48,2975.56146283156,2613.58673801098,27,21,1,1
"923404032",52,2781.44603258651,2656.6981055205,24,28,1,1
"923404033",38,2963.84557923625,2491.71993967651,16,22,1,1
"923404034",37,3049.87297131068,2478.17471526668,16,21,1,1
"923404035",71,3492.30247352273,2831.31372136695,34,37,1,1
"923404036",53,3201.40687099269,2667.061866114,19,34,1,1
"923404037",60,3726.02267850377,2735.5526890818,26,34,1,1
"923404057",38,2793.2107378681,2491.71993967651,15,23,1,1
"923404058",42,2841.50966126411,2543.21752514954,18,24,1,1
"923404059",26,2753.80342911138,2305.75108410937,13,13,1,1
"923404060",46,3382.25331221228,2590.94954296761,22,24,1,1
"923404061",47,3135.93933121046,2602.36394728806,26,21,1,1
"923404062",32,2470.694000821,2405.71569249515,18,14,1,1
"923404063",33,2581.3008370327,2420.89448855093,12,21,1,1
"923404064",48,3515.07310835968,2613.58673801098,20,28,1,1
"923404065",47,2557.09712663152,2602.36394728806,17,30,1,1
"923404066",31,2346.94050106676,2390.15469389133,14,17,1,1
"923404067",44,2968.24215382778,2567.51523707907,23,21,1,1
"923404068",20,2300.29700822217,2185.35845629437,10,10,1,1
"923404069",36,3111.68373719586,2464.33502634194,18,18,1,1
"923404070",38,2668.02844333354,2491.71993967651,16,22,1,1
"923404071",30,2326.60312428912,2374.18906024059,12,18,1,1
"923404072",15,2050.88950019363,2060.56118614118,9,6,1,1
"923404077",16,1978.10773789307,2087.92318348224,9,7,1,1
"923404078",12,1865.33574407755,1968.69006049611,7,5,1,1
"923404079",19,2016.2081473682,2162.56636020013,12,7,1,1
"923404081",18,2168.2932258849,2138.79896507223,11,7,1,1
"923404082",21,2098.15574539683,2207.26116887512,10,11,1,1
"923404085",18,2012.88363638903,2138.79896507223,8,10,1,1
"923404088",25,2123.51880232027,2287.34065519221,13,12,1,1
"923404089",13,1884.06295487152,2001.16379457045,9,4,1,1
"923404090",18,2085.54097021424,2138.79896507223,11,7,1,1
"923404092",18,2026.96911044904,2138.79896507223,9,9,1,1
"923404094",14,1917.1215738816,2031.70713799962,5,9,1,1
"923404131",30,2502.29923286659,2374.18906024059,13,17,1,1
"923404132",32,2501.81036637891,2405.71569249515,15,17,1,1
"923404133",28,2673.42324506514,2340.94327947849,13,15,1,1
"923404134",39,2728.5610677971,2504.98447234734,19,20,1,1
"923404135",27,2534.02094608777,2323.60649590586,17,10,1,1
"923404136",36,2629.62174616776,2464.33502634194,15,21,1,1
"923404137",39,3053.55766213292,2504.98447234734,22,17,1,1
"923404138",27,2678.27584669205,2323.60649590586,19,8,1,1
"923404139",42,2514.58542792035,2543.21752514954,24,18,1,1
"923404140",43,2807.19443670231,2555.47878346624,22,21,1,1
"923404141",35,2721.29336674419,2450.1860183293,20,15,1,1
"923404142",39,2666.43093760469,2504.98447234734,22,17,1,1
"923404143",41,3017.95163785814,2530.72175773865,23,18,1,1
"923404144",34,2716.44992678796,2435.71163614839,15,19,1,1
"923404145",30,2593.32814854447,2374.18906024059,14,16,1,1
"923404146",27,2475.37859378197,2323.60649590586,13,14,1,1
"923404147",36,3224.58988631132,2464.33502634194,17,19,1,1
"923404148",49,3438.56418219025,2624.62502504328,22,27,1,1
"923404149",37,3044.34394117098,2478.17471526668,15,22,1,1
"923404150",32,2981.59545481529,2405.71569249515,10,22,1,1
"923404151",38,3017.64505006584,2491.71993967651,15,23,1,1
"923404152",45,3146.04757095544,2579.33597919865,20,25,1,1
"923404153",53,3468.56864291682,2667.061866114,28,25,1,1
"923404154",61,3206.69344855568,2744.81051624266,26,35,1,1
"923404155",45,3004.0748984373,2579.33597919865,18,27,1,1
"923404156",52,3312.38187501142,2656.6981055205,17,35,1,1
"923404157",52,3174.27175022725,2656.6981055205,19,33,1,1
"923404158",48,3265.525486076,2613.58673801098,20,28,1,1
"923404159",60,3467.26039047971,2735.5526890818,25,35,1,1
"923404160",56,3263.35804042129,2697.24673169728,20,36,1,1
"923404161",53,2958.13606248251,2667.061866114,18,35,1,1
"923404162",33,2789.13742205003,2420.89448855093,13,20,1,1
"923404163",52,3249.81175416587,2656.6981055205,21,31,1,1
"923404164",36,3014.07855803855,2464.33502634194,14,22,1,1
"923404165",55,3436.23190194887,2687.33120998132,22,33,1,1
"923404166",38,2795.70897173597,2491.71993967651,13,25,1,1
"923404167",63,3825.90995185137,2762.96971264875,28,35,1,1
"923404168",39,2811.19269206595,2504.98447234734,16,23,1,1
"923404169",27,2973.04335385696,2323.60649590586,7,20,1,1
"923404170",55,3142.44046021909,2687.33120998132,21,34,1,1
"923404171",24,2461.06723980669,2268.33468283819,10,14,1,1
"923404172",52,3802.35249053812,2656.6981055205,23,29,1,1
"923404173",49,3526.52950196467,2624.62502504328,21,28,1,1
"923404174",40,3059.65846738712,2517.98110851286,14,26,1,1
"923404175",50,3101.76828035673,2635.48551585152,20,30,1,1
"923404176",39,3222.74008070545,2504.98447234734,18,21,1,1
"923404177",34,2925.60644475381,2435.71163614839,11,23,1,1
"923404178",41,3049.69244993741,2530.72175773865,17,24,1,1
"923404179",56,3212.80327783495,2697.24673169728,20,36,1,1
"923404180",53,3235.37197177142,2667.061866114,23,30,1,1
"923404181",42,3352.40171049663,2543.21752514954,15,27,1,1
"923404182",60,4042.42007802805,2735.5526890818,19,41,1,1
"923404183",23,2796.5449090929,2248.68783741607,8,15,1,1
"923404184",53,3154.04689565476,2667.061866114,23,30,1,1
"923404185",44,2974.60334397732,2567.51523707907,17,27,1,1
"923404186",47,3144.77699489643,2602.36394728806,19,28,1,1
"923404187",35,3226.23876187045,2450.1860183293,15,20,1,1
"923404188",47,3094.4379472204,2602.36394728806,15,32,1,1
"923404189",49,3486.86393569691,2624.62502504328,22,27,1,1
"923404190",38,2894.63072646774,2491.71993967651,14,24,1,1
"923404191",55,3628.16910580714,2687.33120998132,23,32,1,1
"923404192",64,3856.13203752924,2771.87783482774,28,36,1,1
"923404193",39,2973.36525967389,2504.98447234734,13,26,1,1
"923404194",35,3095.29202149634,2450.1860183293,15,20,1,1
"923404195",56,3763.36175979246,2697.24673169728,27,29,1,1
"923404196",52,3560.15959320515,2656.6981055205,27,25,1,1
"923404197",33,3075.90100683523,2420.89448855093,11,22,1,1
"923404198",38,2965.15075374153,2491.71993967651,14,24,1,1
"923404199",34,2986.32677692377,2435.71163614839,11,23,1,1
"923404200",54,3151.30504827304,2677.2712016452,23,31,1,1
"923404201",49,3323.49074334749,2624.62502504328,20,29,1,1
"923404202",37,2668.36724011455,2478.17471526668,14,23,1,1
"923404203",58,3553.2255826496,2716.66249357165,22,36,1,1
"923404204",48,3257.42969532374,2613.58673801098,19,29,1,1
"923404205",60,3714.01196216924,2735.5526890818,27,33,1,1
"923404206",44,3164.64092775711,2567.51523707907,20,24,1,1
"923404207",39,3268.87003630889,2504.98447234734,15,24,1,1
"923404208",51,3276.8932305691,2646.17454577679,16,35,1,1
"923404209",52,3327.86447799645,2656.6981055205,16,36,1,1
"923404210",46,2837.78596811615,2590.94954296761,17,29,1,1
"923404211",40,2894.62242700063,2517.98110851286,14,26,1,1
"923404212",50,3648.97814353336,2635.48551585152,20,30,1,1
"923404213",44,3140.32107147042,2567.51523707907,17,27,1,1
"923404214",41,3313.48138977977,2530.72175773865,15,26,1,1
"923404215",42,3225.1523369617,2543.21752514954,15,27,1,1
"923404216",47,3256.07201045958,2602.36394728806,20,27,1,1
"923404217",52,2960.92746850451,2656.6981055205,23,29,1,1
"923404218",35,2690.98813201734,2450.1860183293,13,22,1,1
"923404219",40,3047.40831695338,2517.98110851286,17,23,1,1
"923404220",34,2692.67540184252,2435.71163614839,18,16,1,1
"923404221",37,2815.72765158194,2478.17471526668,16,21,1,1
"923404222",42,3099.58893607276,2543.21752514954,16,26,1,1
"923404223",57,3237.64303661088,2707.02236739438,20,37,1,1
"923404224",47,3087.5874829439,2602.36394728806,18,29,1,1
"923404225",44,3272.20951625692,2567.51523707907,21,23,1,1
"923404226",55,3388.11020113028,2687.33120998132,18,37,1,1
"923404227",64,4238.66645617666,2771.87783482774,34,30,1,1
"923404228",33,3029.63025460507,2420.89448855093,13,20,1,1
"923404229",41,3085.24461979712,2530.72175773865,20,21,1,1
"923404230",49,3080.90734283001,2624.62502504328,18,31,1,1
"923404232",54,2952.02746917499,2677.2712016452,18,36,1,1
"923404233",55,3401.75868598132,2687.33120998132,16,39,1,1
"923404234",25,2548.1982227531,2287.34065519221,9,16,1,1
"923404235",47,3257.47102662554,2602.36394728806,16,31,1,1
"923404236",45,2864.54903523208,2579.33597919865,12,33,1,1
"923404237",40,2910.57267112743,2517.98110851286,12,28,1,1
"923404238",42,3154.09871601138,2543.21752514954,15,27,1,1
"923404239",42,2490.66632546464,2543.21752514954,15,27,1,1
"923404240",64,3337.40196688773,2771.87783482774,18,46,1,1
"923404241",57,3198.38740230614,2707.02236739438,22,35,1,1
"923404242",50,2895.75250305782,2635.48551585152,16,34,1,1
"923404243",49,3182.10100270943,2624.62502504328,18,31,1,1
"923404244",44,3119.59971127182,2567.51523707907,14,30,1,1
"923404245",32,2866.45919596169,2405.71569249515,15,17,1,1
"923404246",45,2972.51132800183,2579.33597919865,15,30,1,1
"923404247",18,2304.20456946721,2138.79896507223,5,13,1,1
"923404248",70,3264.54203678283,2823.11677003184,27,43,1,1
"923404249",32,2699.41777769197,2405.71569249515,9,23,1,1
"923404250",31,2745.54751004624,2390.15469389133,9,22,1,1
"923404251",57,2994.03572420711,2707.02236739438,21,36,1,1
"923404252",44,2920.29150399202,2567.51523707907,15,29,1,1
"923404253",44,3193.48526103891,2567.51523707907,16,28,1,1
"923404254",41,3044.21557907951,2530.72175773865,14,27,1,1
"923404255",42,3249.98380652138,2543.21752514954,15,27,1,1
"923404256",53,3377.30306619872,2667.061866114,20,33,1,1
"923404257",47,3108.13865999522,2602.36394728806,13,34,1,1
"923404258",34,2898.82530538361,2435.71163614839,12,22,1,1
"923404259",70,3327.43575244307,2823.11677003184,23,47,1,1
"923404260",30,2807.05539764999,2374.18906024059,11,19,1,1
"923404261",40,2840.25154670931,2517.98110851286,13,27,1,1
"923404262",57,3286.76954145191,2707.02236739438,21,36,1,1
"923404263",58,3003.75199828798,2716.66249357165,18,40,1,1
"923404264",59,3157.9539707633,2726.17127719361,20,39,1,1
"923404265",77,3433.01469280645,2878.65357631343,26,51,1,1
"923404266",54,3127.71876679965,2677.2712016452,16,38,1,1
"923404267",52,3080.29063090614,2656.6981055205,18,34,1,1
"923404268",51,3563.17767930706,2646.17454577679,14,37,1,1
"923404269",24,2631.35975768065,2268.33468283819,8,16,1,1
"923404270",44,2944.6564914612,2567.51523707907,11,33,1,1
"923404271",52,2923.4641966934,2656.6981055205,17,35,1,1
"923404272",48,3098.62647370885,2613.58673801098,12,36,1,1
"923404273",43,2845.01574927944,2555.47878346624,15,28,1,1
"923404274",40,3032.85749542248,2517.98110851286,11,29,1,1
"923404275",49,3229.82359626332,2624.62502504328,17,32,1,1
"923404276",38,2618.77626041286,2491.71993967651,11,27,1,1
"923404277",45,2994.93551133122,2579.33597919865,15,30,1,1
"923404278",58,3600.2015860359,2716.66249357165,24,34,1,1
"923404279",72,3654.13049586607,2839.4193288992,36,36,1,1
"923404280",88,3802.85749646737,2958.30409156145,41,47,1,1
"923404281",83,3492.25042089869,2923.1438046077,41,42,1,1
"923404282",62,2931.75697487547,2753.94837323248,28,34,1,1
"923404283",48,3072.00426801183,2613.58673801098,24,24,1,1
"923404284",68,3977.45706897399,2806.43931339586,32,36,1,1
"923404285",40,2920.72577748776,2517.98110851286,20,20,1,1
"923404286",67,3774.09077582241,2797.95380131742,35,32,1,1
"923404287",66,3489.39039692271,2789.3669207067,33,33,1,1
"923404288",84,3847.38568414147,2930.30814451558,42,42,1,1
"923404289",78,4626.28280355699,2886.25582696583,37,41,1,1
"923404290",63,3185.11932172878,2762.96971264875,39,24,1,1
"923404291",66,3576.31734546154,2789.3669207067,28,38,1,1
"923404292",75,3706.17854551887,2863.21031780169,31,44,1,1
"923404293",82,4544.65809817605,2915.91045786314,37,45,1,1
"923404294",65,3609.2779547608,2780.67589681985,28,37,1,1
"923404295",45,3180.23830592207,2579.33597919865,20,25,1,1
"923404296",47,3077.34887386574,2602.36394728806,23,24,1,1
"923404297",93,3977.0734547553,2991.90921350397,40,53,1,1
"923404298",69,3803.95320719712,2814.82611826518,34,35,1,1
"923404299",89,3817.96431630934,2965.14449011489,44,45,1,1
"923404300",60,3841.09241794911,2735.5526890818,25,35,1,1
"923404301",54,3493.96238993663,2677.2712016452,24,30,1,1
"923404302",74,3399.56317563391,2855.36548874306,30,44,1,1
"923404303",65,3583.15484506452,2780.67589681985,30,35,1,1
"923404304",54,3197.55424417219,2677.2712016452,23,31,1,1
"923404305",56,3465.89368961935,2697.24673169728,27,29,1,1
"923404306",77,3944.69406862324,2878.65357631343,40,37,1,1
"923404307",88,3559.79427278778,2958.30409156145,45,43,1,1
"923404308",42,2973.7215604661,2543.21752514954,22,20,1,1
"923404309",84,4060.51433387627,2930.30814451558,44,40,1,1
"923404310",34,2617.10980380759,2435.71163614839,17,17,1,1
"923404311",64,3861.19299308853,2771.87783482774,31,33,1,1
"923404312",57,3473.80519026694,2707.02236739438,28,29,1,1
"923404313",79,3775.41389914693,2893.78092561085,35,44,1,1
"923404314",69,3689.6729262185,2814.82611826518,31,38,1,1
"923404315",61,3104.23146797293,2744.81051624266,28,33,1,1
